Rk,Tm,Year,Date,Time,LTime,,Opp,Week,G#,Day,Result,OT,Pen,Yds,OppPen,OppYds,CombPen,CombPenYds
1,OAK,2016,2016-10-30,1:02,1:02,@,TAM,8,8,Sun,W 30-24,OT,23,200,6,64,29,264
2,BAL,2005,2005-10-09,1:02,1:02,@,DET,5,4,Sun,L 17-35,,21,147,7,46,28,193
3,NYJ,2013,2013-09-22,4:25,4:25,,BUF,3,3,Sun,W 27-20,,20,168,7,87,27,255
4,BUF,2001,2001-09-23,1:00,12:00,@,IND,2,2,Sun,L 26-42,,19,133,8,59,27,192
5,OAK,2003,2003-10-12,1:03,1:03,@,CLE,6,6,Sun,L 7-13,,19,128,6,55,25,183
6,CLE,2019,2019-09-08,1:00,1:00,,TEN,1,1,Sun,L 13-43,,18,182,6,54,24,236
7,DAL,2015,2015-09-20,4:25,4:25,@,PHI,2,2,Sun,W 20-10,,18,142,8,60,26,202
8,GNB,2010,2010-09-27,8:40,7:40,@,CHI,3,3,Mon,L 17-20,,18,152,5,38,23,190
9,MIA,2005,2005-10-09,1:02,1:02,@,BUF,5,4,Sun,L 14-20,,18,102,7,63,25,165
10,TEN,2005,2006-01-01,4:05,4:05,@,JAX,17,16,Sun,L 13-40,,18,140,7,50,25,190
11,BUF,2015,2015-10-04,1:02,1:02,,NYG,4,4,Sun,L 10-24,,17,135,11,85,28,220
12,CIN,2005,2005-09-18,1:03,1:03,,MIN,2,2,Sun,W 37-8,,17,115,7,49,24,164
13,DET,2005,2005-11-20,1:02,12:02,@,DAL,11,10,Sun,L 7-20,,17,129,5,40,22,169
14,DET,2016,2016-09-18,1:02,1:02,,TEN,2,2,Sun,L 15-16,,17,138,12,83,29,221
15,MIA,2017,2017-11-19,1:00,1:00,,TAM,11,10,Sun,L 20-30,,17,123,9,82,26,205
16,NOR,2000,2000-11-26,1:02,12:02,@,STL,13,12,Sun,W 31-24,,17,116,14,132,31,248
17,OAK,2003,2003-09-07,8:51,7:51,@,TEN,1,1,Sun,L 20-25,,17,173,11,111,28,284
18,TAM,2003,2003-09-14,4:05,4:05,,CAR,2,2,Sun,L 9-12,OT,17,168,16,120,33,288
19,WAS,2003,2003-09-21,4:05,4:05,,NYG,3,3,Sun,L 21-24,OT,17,142,15,124,32,266
20,ATL,2019,2019-09-22,1:00,1:00,@,IND,3,3,Sun,L 24-27,,16,128,4,39,20,167
21,CAR,2003,2003-09-14,4:05,4:05,@,TAM,2,2,Sun,W 12-9,OT,16,120,17,168,33,288
22,DET,2012,2012-10-14,1:03,1:03,@,PHI,6,5,Sun,W 26-23,OT,16,132,9,60,25,192
23,JAX,2019,2019-12-01,1:00,1:00,,TAM,13,12,Sun,L 11-28,,16,121,8,44,24,165
24,NOR,2001,2001-12-17,9:09,8:09,,STL,14,13,Mon,L 21-34,,16,132,11,85,27,217
25,NOR,2002,2002-11-17,1:05,1:05,@,ATL,11,10,Sun,L 17-24,,16,133,9,69,25,202
26,NYG,2005,2005-11-27,4:16,1:16,@,SEA,12,11,Sun,L 21-24,OT,16,114,8,65,24,179
27,NYJ,2018,2018-12-23,1:00,1:00,,GNB,16,15,Sun,L 38-44,OT,16,172,10,86,26,258
28,OAK,2005,2005-09-08,9:07,9:07,@,NWE,1,1,Thu,L 20-30,,16,149,7,46,23,195
29,OAK,2015,2015-09-20,4:05,1:05,,BAL,2,2,Sun,W 37-33,,16,106,10,109,26,215
30,OAK,2015,2015-12-24,8:26,5:26,,SDG,16,15,Thu,W 23-20,OT,16,121,9,75,25,196
31,SEA,2017,2017-11-05,4:05,1:05,,WAS,9,8,Sun,L 14-17,,16,138,7,62,23,200
32,SFO,2014,2014-09-14,8:31,5:31,,CHI,2,2,Sun,L 20-28,,16,118,10,58,26,176
33,TAM,2015,2015-10-25,1:04,1:04,@,WAS,7,6,Sun,L 30-31,,16,142,4,20,20,162
34,ATL,2018,2018-09-06,8:20,8:20,@,PHI,1,1,Thu,L 12-18,,15,135,11,101,26,236
35,BUF,2004,2004-11-21,1:02,1:02,,STL,11,10,Sun,W 37-17,,15,123,11,84,26,207
36,BUF,2006,2006-10-01,1:02,1:02,,MIN,4,4,Sun,W 17-12,,15,104,12,78,27,182
37,BUF,2015,2015-12-13,1:01,1:01,@,PHI,14,13,Sun,L 20-23,,15,101,5,55,20,156
38,DEN,2016,2016-11-27,8:30,6:30,,KAN,12,11,Sun,L 27-30,OT,15,97,9,71,24,168
39,DET,2001,2001-09-23,1:13,1:13,@,CLE,2,2,Sun,L 14-24,,15,115,9,50,24,165
40,JAX,2005,2005-10-02,1:02,1:02,,DEN,4,4,Sun,L 7-20,,15,119,5,30,20,149
41,KAN,2017,2017-09-07,8:30,8:30,@,NWE,1,1,Thu,W 42-27,,15,139,6,55,21,194
42,NWE,2014,2014-09-14,1:05,12:05,@,MIN,2,2,Sun,W 30-7,,15,163,7,58,22,221
43,NYG,2001,2001-11-19,9:10,8:10,@,MIN,10,10,Mon,L 16-28,,15,150,9,75,24,225
44,NYG,2003,2003-09-21,4:05,4:05,@,WAS,3,3,Sun,W 24-21,OT,15,124,17,142,32,266
45,PHI,2007,2007-09-30,8:23,8:23,@,NYG,4,4,Sun,L 3-16,,15,132,4,27,19,159
46,OAK,2010,2010-11-07,4:15,1:15,,KAN,9,9,Sun,W 23-20,OT,15,140,12,100,27,240
47,OAK,2011,2011-09-12,10:26,8:26,@,DEN,1,1,Mon,W 23-20,,15,131,10,91,25,222
48,OAK,2011,2011-11-06,4:05,1:05,,DEN,9,8,Sun,L 24-38,,15,130,11,93,26,223
49,OAK,2011,2011-12-24,1:03,12:03,@,KAN,16,15,Sat,W 16-13,OT,15,92,11,88,26,180
50,STL,2005,2005-12-18,1:02,12:02,,PHI,15,14,Sun,L 16-17,,15,115,13,115,28,230
51,BAL,2016,2016-10-16,1:02,1:02,@,NYG,6,6,Sun,L 23-27,,15,111,7,119,22,230
52,SEA,2017,2017-10-22,4:25,4:25,@,NYG,7,6,Sun,W 24-7,,15,110,7,28,22,138
53,SFO,2011,2011-10-16,1:03,1:03,@,DET,6,6,Sun,W 25-19,,15,120,6,54,21,174
54,TAM,2014,2014-10-05,1:03,12:03,@,NOR,5,5,Sun,L 31-37,OT,15,113,6,50,21,163
55,WAS,2016,2016-10-30,8:36,1:36,@,CIN,8,8,Sun,T 27-27,OT,15,106,7,85,22,191
56,WAS,2018,2018-12-09,1:00,1:00,,NYG,14,13,Sun,L 16-40,,15,135,2,18,17,153
57,BUF,2012,2012-11-11,1:02,1:02,@,NWE,10,9,Sun,L 31-37,,14,148,7,73,21,221
58,BUF,2015,2015-09-20,1:02,1:02,,NWE,2,2,Sun,L 32-40,,14,140,11,119,25,259
59,CAR,2002,2002-10-13,1:03,12:03,@,DAL,6,6,Sun,L 13-14,,14,106,9,71,23,177
60,CHI,2004,2004-09-26,1:00,12:00,@,MIN,3,3,Sun,L 22-27,,14,101,11,70,25,171
61,CHI,2007,2007-09-30,1:03,1:03,@,DET,4,4,Sun,L 27-37,,14,102,9,59,23,161
62,CHI,2011,2011-10-10,8:40,8:40,@,DET,5,5,Mon,L 13-24,,14,104,12,94,26,198
63,CHI,2015,2015-09-20,1:00,12:00,,ARI,2,2,Sun,L 23-48,,14,170,8,58,22,228
64,CHI,2018,2018-11-04,1:00,1:00,@,BUF,9,8,Sun,W 41-9,,14,129,10,163,24,292
65,CIN,2005,2005-10-02,1:02,1:02,,HOU,4,4,Sun,W 16-10,,14,117,9,90,23,207
66,CLE,2007,2007-10-28,1:00,12:00,@,STL,8,7,Sun,W 27-20,,14,102,4,30,18,132
67,CLE,2018,2018-10-21,1:00,1:00,@,TAM,7,7,Sun,L 23-26,OT,14,114,8,65,22,179
68,ARI,2004,2004-10-31,1:02,1:02,@,BUF,8,7,Sun,L 14-38,,14,101,7,55,21,156
69,ARI,2014,2014-10-12,4:25,1:25,,WAS,6,5,Sun,W 30-20,,14,108,6,62,20,170
70,DAL,2021,2021-11-25,4:30,3:30,,LVR,12,11,Thu,L 33-36,OT,14,166,14,110,28,276
71,DEN,2017,2017-11-05,1:00,1:00,@,PHI,9,8,Sun,L 23-51,,14,105,5,35,19,140
72,DET,2006,2006-09-17,1:03,12:03,@,CHI,2,2,Sun,L 7-34,,14,104,6,93,20,197
73,GNB,2005,2005-09-11,4:19,4:19,@,DET,1,1,Sun,L 3-17,,14,100,4,38,18,138
74,HOU,2002,2002-12-01,4:00,4:00,@,IND,13,12,Sun,L 3-19,,14,92,9,75,23,167
75,HOU,2013,2013-09-22,1:03,1:03,@,BAL,3,3,Sun,L 9-30,,14,113,10,87,24,200
76,HOU,2013,2013-12-05,8:29,8:29,@,JAX,14,13,Thu,L 20-27,,14,177,8,57,22,234
77,HOU,2013,2013-12-15,1:02,1:02,@,IND,15,14,Sun,L 3-25,,14,114,4,36,18,150
78,HOU,2017,2017-12-17,1:00,1:00,@,JAX,15,14,Sun,L 7-45,,14,127,8,54,22,181
79,JAX,2016,2016-09-18,4:25,1:25,@,SDG,2,2,Sun,L 14-38,,14,93,3,23,17,116
80,JAX,2016,2016-12-11,1:00,1:00,,MIN,14,13,Sun,L 16-25,,14,114,7,93,21,207
81,MIA,2016,2016-12-11,1:00,1:00,,ARI,14,13,Sun,W 26-23,,14,118,7,54,21,172
82,MIA,2017,2017-12-31,4:25,1:00,,BUF,17,16,Sun,L 16-22,,14,145,6,45,20,190
83,MIN,2003,2003-10-19,1:00,12:00,,DEN,7,6,Sun,W 28-20,,14,108,5,40,19,148
84,MIN,2005,2005-10-16,1:03,12:03,@,CHI,6,5,Sun,L 3-28,,14,91,8,58,22,149
85,NOR,2001,2001-09-30,1:06,1:06,@,NYG,3,2,Sun,L 13-21,,14,92,11,100,25,192
86,NOR,2005,2005-09-25,1:00,12:00,@,MIN,3,3,Sun,L 16-33,,14,84,8,60,22,144
87,NWE,2003,2003-11-03,9:09,7:09,@,DEN,9,9,Mon,W 30-26,,14,85,4,30,18,115
88,NWE,2018,2018-12-16,4:25,4:25,@,PIT,15,14,Sun,L 10-17,,14,106,4,40,18,146
89,NYG,2004,2004-11-07,4:06,4:06,,CHI,9,8,Sun,L 21-28,,14,109,11,70,25,179
90,NYJ,2009,2009-10-18,4:15,4:15,,BUF,6,6,Sun,L 13-16,OT,14,96,8,64,22,160
91,NYJ,2010,2010-09-13,7:26,7:26,,BAL,1,1,Mon,L 9-10,,14,125,5,38,19,163
92,NYJ,2015,2015-10-04,9:37,2:37,@,MIA,4,4,Sun,W 27-14,,14,163,9,80,23,243
93,TEN,2000,2000-11-05,1:03,12:03,,PIT,10,9,Sun,W 9-7,,14,115,4,25,18,140
94,TEN,2012,2012-12-17,8:40,7:40,,NYJ,15,14,Mon,W 14-10,,14,111,4,23,18,134
95,PHI,2003,2003-11-23,1:02,1:02,,NOR,12,11,Sun,W 33-20,,14,171,12,101,26,272
96,PHI,2005,2005-11-14,9:08,9:08,,DAL,10,9,Mon,L 20-21,,14,95,4,31,18,126
97,PHI,2010,2010-11-07,4:16,4:16,,IND,9,8,Sun,W 26-24,,14,125,7,59,21,184
98,PHI,2016,2016-10-09,1:02,1:02,@,DET,5,4,Sun,L 23-24,,14,111,2,18,16,129
99,PHI,2021,2021-09-12,1:00,1:00,@,ATL,1,1,Sun,W 32-6,,14,89,12,99,26,188
100,PIT,2010,2010-11-21,1:02,1:02,,OAK,11,10,Sun,W 35-3,,14,163,7,55,21,218
101,OAK,2002,2002-10-13,4:15,3:15,@,STL,6,5,Sun,L 13-28,,14,107,11,82,25,189
102,OAK,2007,2007-10-28,1:02,12:02,@,TEN,8,7,Sun,L 9-13,,14,100,7,62,21,162
103,OAK,2008,2008-10-19,4:15,1:15,,NYJ,7,6,Sun,W 16-13,OT,14,85,7,60,21,145
104,OAK,2009,2009-12-13,4:05,1:05,,WAS,14,13,Sun,L 13-34,,14,118,7,45,21,163
105,OAK,2011,2011-10-23,7:05,4:05,,KAN,7,7,Sun,L 0-28,,14,120,10,98,24,218
106,OAK,2015,2015-10-25,4:05,1:05,@,SDG,7,6,Sun,W 37-29,,14,136,9,86,23,222
107,OAK,2016,2016-09-11,1:05,12:05,@,NOR,1,1,Sun,W 35-34,,14,141,7,53,21,194
108,OAK,2017,2017-12-17,8:30,5:30,,DAL,15,14,Sun,L 17-20,,14,105,7,100,21,205
109,LVR,2020,2021-01-03,4:25,2:25,@,DEN,17,16,Sun,W 32-31,,14,111,4,28,18,139
110,LVR,2021,2021-11-25,4:30,3:30,@,DAL,12,11,Thu,W 36-33,OT,14,110,14,166,28,276
111,STL,2000,2000-11-26,1:02,12:02,,NOR,13,12,Sun,L 24-31,,14,132,17,116,31,248
112,STL,2012,2012-12-30,4:26,1:26,@,SEA,17,16,Sun,L 13-20,,14,98,10,80,24,178
113,BAL,2003,2003-11-23,1:02,1:02,,SEA,12,11,Sun,W 44-41,OT,14,112,6,89,20,201
114,BAL,2012,2012-09-23,8:31,8:31,,NWE,3,3,Sun,W 31-30,,14,135,10,83,24,218
115,BAL,2014,2014-11-30,1:02,1:02,,SDG,13,12,Sun,L 33-34,,14,98,8,91,22,189
116,SDG,2008,2008-10-26,1:06,5:06,@,NOR,8,8,Sun,L 32-37,,14,134,6,60,20,194
117,SDG,2016,2016-11-06,4:25,1:25,,TEN,9,9,Sun,W 43-35,,14,107,8,57,22,164
118,LAC,2018,2018-11-18,4:05,1:05,,DEN,11,10,Sun,L 22-23,,14,120,7,43,21,163
119,SEA,2012,2012-09-24,8:41,5:41,,GNB,3,3,Mon,W 14-12,,14,118,10,127,24,245
120,SEA,2014,2014-11-27,8:31,5:31,@,SFO,13,12,Thu,W 19-3,,14,105,3,20,17,125
121,SEA,2015,2015-11-15,8:35,5:35,,ARI,10,9,Sun,L 32-39,,14,131,9,66,23,197
122,SEA,2018,2018-12-16,4:05,1:05,@,SFO,15,14,Sun,L 23-26,OT,14,148,8,66,22,214
123,SFO,2000,2000-11-05,1:02,12:02,@,NOR,10,10,Sun,L 15-31,,14,97,10,54,24,151
124,SFO,2010,2010-11-14,4:15,1:15,,STL,10,9,Sun,W 23-20,OT,14,105,12,135,26,240
125,SFO,2018,2018-09-23,1:00,12:00,@,KAN,3,3,Sun,L 27-38,,14,147,6,48,20,195
126,TAM,2011,2011-10-03,8:40,8:40,,IND,4,4,Mon,W 24-17,,14,106,6,50,20,156
127,TAM,2012,2012-11-04,4:05,1:05,@,OAK,9,8,Sun,W 42-32,,14,116,9,80,23,196
128,ATL,2018,2018-12-09,1:00,12:00,@,GNB,14,13,Sun,L 20-34,,13,101,6,37,19,138
129,BUF,2002,2002-10-13,1:02,12:02,@,HOU,6,6,Sun,W 31-24,,13,128,11,75,24,203
130,BUF,2002,2002-11-17,1:00,12:00,@,KAN,11,10,Sun,L 16-17,,13,139,5,39,18,178
131,BUF,2005,2005-10-16,4:15,4:15,,NYJ,6,6,Sun,W 27-17,,13,99,7,50,20,149
132,BUF,2009,2009-10-11,1:01,1:01,,CLE,5,5,Sun,L 3-6,,13,75,3,29,16,104
133,BUF,2015,2015-11-08,1:02,1:02,,MIA,9,8,Sun,W 33-17,,13,94,8,62,21,156
134,BUF,2018,2018-11-25,1:00,1:00,,JAX,12,11,Sun,W 24-21,,13,80,10,90,23,170
135,BUF,2018,2018-12-02,1:00,1:00,@,MIA,13,12,Sun,L 17-21,,13,120,8,89,21,209
136,CAR,2011,2011-10-23,1:05,1:05,,WAS,7,7,Sun,W 33-20,,13,105,3,26,16,131
137,CHI,2004,2004-12-12,1:03,1:03,@,JAX,14,13,Sun,L 3-22,,13,104,8,75,21,179
138,CHI,2009,2009-12-13,1:02,12:02,,GNB,14,13,Sun,L 14-21,,13,109,4,30,17,139
139,CHI,2013,2013-11-17,1:02,12:02,,BAL,11,10,Sun,W 23-20,OT,13,111,5,46,18,157
140,CHI,2017,2017-12-16,4:30,4:30,@,DET,15,14,Sat,L 10-20,,13,97,8,58,21,155
141,CIN,2009,2009-09-20,1:02,12:02,@,GNB,2,2,Sun,W 31-24,,13,100,11,76,24,176
142,CIN,2014,2014-10-12,1:03,1:03,,CAR,6,5,Sun,T 37-37,OT,13,119,8,60,21,179
143,CIN,2017,2017-12-04,8:30,8:30,,PIT,13,12,Mon,L 20-23,,13,173,7,66,20,239
144,CIN,2018,2018-11-25,1:00,1:00,,CLE,12,11,Sun,L 20-35,,13,96,7,61,20,157
145,CLE,2016,2016-09-25,1:02,1:02,@,MIA,3,3,Sun,L 24-30,OT,13,91,8,67,21,158
146,CLE,2019,2019-10-27,4:25,4:25,@,NWE,8,7,Sun,L 13-27,,13,85,4,32,17,117
147,CLE,2020,2020-12-06,1:00,12:00,@,TEN,13,12,Sun,W 41-35,,13,92,5,52,18,144
148,DAL,2000,2000-11-12,1:00,12:00,,CIN,11,10,Sun,W 23-6,,13,100,7,94,20,194
149,DAL,2009,2009-10-11,1:00,12:00,@,KAN,5,5,Sun,W 26-20,OT,13,90,7,50,20,140
150,DAL,2012,2012-09-05,8:41,8:41,@,NYG,1,1,Wed,W 24-17,,13,86,4,33,17,119
151,DAL,2012,2012-09-23,1:05,12:05,,TAM,3,3,Sun,W 16-10,,13,105,10,69,23,174
152,DAL,2012,2012-10-14,1:02,1:02,@,BAL,6,5,Sun,L 29-31,,13,82,10,76,23,158
153,DAL,2012,2012-11-11,4:25,4:25,@,PHI,10,9,Sun,W 38-23,,13,75,6,50,19,125
154,DEN,2013,2013-09-15,4:25,4:25,@,NYG,2,2,Sun,W 41-23,,13,132,4,16,17,148
155,DEN,2013,2013-11-17,8:30,6:30,,KAN,11,10,Sun,W 27-17,,13,82,9,53,22,135
156,DEN,2018,2018-09-23,1:00,1:00,@,BAL,3,3,Sun,L 14-27,,13,120,7,52,20,172
157,DET,2001,2001-12-16,1:02,1:02,,MIN,14,13,Sun,W 27-24,,13,123,6,40,19,163
158,DET,2010,2010-10-03,1:02,12:02,@,GNB,4,4,Sun,L 26-28,,13,102,3,31,16,133
159,GNB,2002,2002-11-17,12:00,12:00,@,MIN,11,10,Sun,L 21-31,,13,118,12,105,25,223
160,GNB,2007,2007-10-29,8:40,6:40,@,DEN,8,7,Mon,W 19-13,OT,13,103,9,63,22,166
161,GNB,2007,2007-11-04,1:00,12:00,@,KAN,9,8,Sun,W 33-22,,13,112,6,55,19,167
162,GNB,2009,2009-10-18,1:02,12:02,,DET,6,5,Sun,W 26-0,,13,130,6,40,19,170
163,HOU,2005,2005-10-16,8:38,5:38,@,SEA,6,5,Sun,L 10-42,,13,95,6,45,19,140
164,HOU,2009,2009-11-08,1:02,1:02,@,IND,9,9,Sun,L 17-20,,13,103,4,40,17,143
165,HOU,2015,2015-10-08,8:26,7:26,,IND,5,5,Thu,L 20-27,,13,125,7,65,20,190
166,JAX,2001,2001-12-03,9:07,9:07,,GNB,12,11,Mon,L 21-28,,13,111,9,81,22,192
167,JAX,2015,2015-10-04,1:02,1:02,@,IND,4,4,Sun,L 13-16,OT,13,92,4,45,17,137
168,JAX,2016,2016-10-23,1:02,1:02,,OAK,7,6,Sun,L 16-33,,13,122,11,117,24,239
169,KAN,2005,2005-09-26,9:07,7:07,@,DEN,3,3,Mon,L 10-30,,13,118,4,30,17,148
170,KAN,2016,2016-12-04,1:00,1:00,@,ATL,13,12,Sun,W 29-28,,13,128,5,30,18,158
171,KAN,2017,2017-09-24,4:25,1:25,@,LAC,3,3,Sun,W 24-10,,13,122,8,61,21,183
172,KAN,2018,2018-11-19,8:15,7:15,@,LAR,11,11,Mon,L 51-54,,13,135,8,60,21,195
173,MIA,2000,2000-10-23,9:10,9:10,@,NYJ,8,7,Mon,L 37-40,OT,13,95,3,30,16,125
174,MIA,2004,2004-09-11,1:07,1:07,,TEN,1,1,Sat,L 7-17,,13,71,7,55,20,126
175,MIA,2005,2005-09-25,1:02,1:02,,CAR,3,3,Sun,W 27-24,,13,138,4,39,17,177
176,MIA,2005,2005-12-04,1:03,1:03,,BUF,13,12,Sun,W 24-23,,13,81,7,55,20,136
177,MIA,2015,2015-09-20,4:05,4:05,@,JAX,2,2,Sun,L 20-23,,13,112,9,93,22,205
178,MIA,2016,2016-10-23,1:02,1:02,,BUF,7,7,Sun,W 28-25,,13,116,6,45,19,161
179,MIN,2005,2005-12-18,1:05,12:05,,PIT,15,14,Sun,L 3-18,,13,95,12,129,25,224
180,MIN,2009,2009-11-15,1:05,12:05,,DET,10,9,Sun,W 27-10,,13,91,4,40,17,131
181,MIN,2016,2016-09-18,8:32,7:32,,GNB,2,2,Sun,W 17-14,,13,137,6,72,19,209
182,NOR,2005,2005-09-19,7:36,7:36,,NYG,2,2,Mon,L 10-27,,13,92,9,86,22,178
183,NOR,2008,2008-09-28,1:03,12:03,,SFO,4,4,Sun,W 31-17,,13,123,9,63,22,186
184,NOR,2016,2016-12-11,4:25,4:25,@,TAM,14,13,Sun,L 11-16,,13,104,7,65,20,169
185,NOR,2017,2017-10-15,1:00,12:00,,DET,6,5,Sun,W 52-38,,13,118,7,46,20,164
186,NYG,2009,2010-01-03,1:05,12:05,@,MIN,17,16,Sun,L 7-44,,13,95,8,45,21,140
187,TEN,2002,2002-09-22,1:03,12:03,,CLE,3,3,Sun,L 28-31,OT,13,96,7,57,20,153
188,TEN,2004,2004-12-13,9:08,8:08,,KAN,14,13,Mon,L 38-49,,13,104,7,58,20,162
189,TEN,2008,2008-12-07,1:04,12:04,,CLE,14,13,Sun,W 28-9,,13,131,8,68,21,199
190,PHI,2004,2004-12-27,9:09,8:09,@,STL,16,15,Mon,L 7-20,,13,95,7,55,20,150
191,PHI,2005,2005-12-18,1:02,12:02,@,STL,15,14,Sun,W 17-16,,13,115,15,115,28,230
192,PHI,2014,2014-12-20,4:30,4:30,@,WAS,16,15,Sat,L 24-27,,13,102,3,15,16,117
193,PHI,2016,2016-10-16,1:03,1:03,@,WAS,6,5,Sun,L 20-27,,13,114,9,75,22,189
194,PHI,2021,2021-09-27,8:15,7:15,@,DAL,3,3,Mon,L 21-41,,13,86,4,37,17,123
195,PIT,2000,2000-11-12,1:01,1:01,,PHI,11,10,Sun,L 23-26,OT,13,141,9,61,22,202
196,PIT,2002,2002-09-09,9:12,9:12,@,NWE,1,1,Mon,L 14-30,,13,112,7,88,20,200
197,PIT,2008,2008-11-16,4:16,4:16,,SDG,11,10,Sun,W 11-10,,13,115,2,5,15,120
198,PIT,2014,2014-09-28,1:03,1:03,,TAM,4,4,Sun,L 24-27,,13,125,9,50,22,175
199,PIT,2016,2016-11-06,1:00,1:00,@,BAL,9,8,Sun,L 14-21,,13,99,10,94,23,193
200,PIT,2017,2017-09-10,1:00,1:00,@,CLE,1,1,Sun,W 21-18,,13,144,4,61,17,205
201,PIT,2018,2018-09-24,8:15,8:15,@,TAM,3,3,Mon,W 30-27,,13,155,9,80,22,235
202,PIT,2019,2019-11-10,4:25,4:25,,LAR,10,9,Sun,W 17-12,,13,107,10,95,23,202
203,OAK,2002,2002-11-24,4:05,2:05,@,ARI,12,11,Sun,W 41-20,,13,105,5,35,18,140
204,OAK,2003,2003-09-22,9:09,7:09,@,DEN,3,3,Mon,L 10-31,,13,98,6,35,19,133
205,OAK,2004,2004-10-03,1:02,12:02,@,HOU,4,4,Sun,L 17-30,,13,75,4,25,17,100
206,OAK,2005,2005-09-25,1:03,1:03,@,PHI,3,3,Sun,L 20-23,,13,94,9,70,22,164
207,OAK,2005,2005-10-02,4:15,1:15,,DAL,4,4,Sun,W 19-13,,13,85,6,35,19,120
208,OAK,2005,2005-11-27,4:05,1:05,,MIA,12,11,Sun,L 21-33,,13,90,7,70,20,160
209,OAK,2005,2005-12-11,1:02,1:02,@,NYJ,14,13,Sun,L 10-26,,13,88,5,69,18,157
210,OAK,2006,2006-10-15,8:21,6:21,@,DEN,6,5,Sun,L 3-13,,13,95,5,39,18,134
211,OAK,2009,2009-12-27,1:01,1:01,@,CLE,16,15,Sun,L 9-23,,13,126,6,64,19,190
212,OAK,2010,2010-12-05,4:05,1:05,@,SDG,13,12,Sun,W 28-13,,13,105,3,19,16,124
213,OAK,2016,2017-01-01,4:25,2:25,@,DEN,17,16,Sun,L 6-24,,13,125,5,43,18,168
214,OAK,2018,2018-12-09,4:25,1:25,,PIT,14,13,Sun,W 24-21,,13,130,2,14,15,144
215,STL,2007,2007-12-16,1:00,12:00,,GNB,15,14,Sun,L 14-33,,13,93,6,35,19,128
216,STL,2012,2012-11-11,4:25,1:25,@,SFO,10,9,Sun,T 24-24,OT,13,85,7,66,20,151
217,STL,2014,2014-09-07,1:00,12:00,,MIN,1,1,Sun,L 6-34,,13,121,7,60,20,181
218,LAR,2019,2019-09-29,4:05,1:05,,TAM,4,4,Sun,L 40-55,,13,106,12,99,25,205
219,BAL,2002,2002-10-27,1:02,1:02,,PIT,8,7,Sun,L 18-31,,13,100,7,51,20,151
220,BAL,2003,2003-10-19,1:02,1:02,@,CIN,7,6,Sun,L 26-34,,13,113,8,65,21,178
221,BAL,2007,2007-12-03,8:41,8:41,,NWE,13,12,Mon,L 24-27,,13,100,4,30,17,130
222,BAL,2015,2015-09-27,1:02,1:02,,CIN,3,3,Sun,L 24-28,,13,116,9,67,22,183
223,SDG,2011,2011-10-23,1:03,1:03,@,NYJ,7,6,Sun,L 21-27,,13,95,8,60,21,155
224,SEA,2002,2002-09-08,4:17,1:17,@,OAK,1,1,Sun,L 17-31,,13,105,5,45,18,150
225,SEA,2011,2011-11-13,4:06,1:06,,BAL,10,9,Sun,W 22-17,,13,100,4,34,17,134
226,SEA,2011,2011-11-20,4:05,3:05,@,STL,11,10,Sun,W 24-7,,13,100,5,50,18,150
227,SEA,2012,2012-09-09,4:25,1:25,@,ARI,1,1,Sun,L 16-20,,13,90,10,102,23,192
228,SEA,2014,2014-10-06,8:30,8:30,@,WAS,5,4,Mon,W 27-17,,13,90,3,30,16,120
229,SEA,2016,2016-12-15,8:25,5:25,,LAR,15,14,Thu,W 24-3,,13,86,8,76,21,162
230,SFO,2000,2000-10-08,4:00,1:00,,OAK,6,6,Sun,L 28-34,OT,13,124,10,74,23,198
231,SFO,2000,2000-10-22,1:02,1:02,@,CAR,8,8,Sun,L 16-34,,13,82,6,63,19,145
232,SFO,2003,2003-09-14,1:02,12:02,@,STL,2,2,Sun,L 24-27,OT,13,121,4,43,17,164
233,SFO,2007,2007-10-21,1:03,1:03,@,NYG,7,6,Sun,L 15-33,,13,82,8,67,21,149
234,SFO,2008,2008-10-19,1:02,1:02,@,NYG,7,7,Sun,L 17-29,,13,134,11,80,24,214
235,SFO,2015,2015-11-01,1:00,12:00,@,STL,8,8,Sun,L 6-27,,13,93,12,93,25,186
236,SFO,2015,2015-11-29,4:05,1:05,,ARI,12,11,Sun,L 13-19,,13,81,7,47,20,128
237,SFO,2017,2017-10-01,4:05,2:05,@,ARI,4,4,Sun,L 15-18,OT,13,113,10,80,23,193
238,SFO,2018,2018-12-02,4:25,1:25,@,SEA,13,12,Sun,L 16-43,,13,128,10,100,23,228
239,TAM,2004,2004-11-14,1:05,1:05,@,ATL,10,9,Sun,L 14-24,,13,83,6,45,19,128
240,TAM,2005,2005-09-11,1:05,12:05,@,MIN,1,1,Sun,W 24-13,,13,99,9,70,22,169
241,TAM,2005,2005-09-18,1:02,1:02,,BUF,2,2,Sun,W 19-3,,13,99,3,20,16,119
242,TAM,2009,2009-09-20,4:05,4:05,@,BUF,2,2,Sun,L 20-33,,13,112,7,55,20,167
243,TAM,2013,2013-09-08,1:03,1:03,@,NYJ,1,1,Sun,L 17-18,,13,102,6,45,19,147
244,TAM,2014,2014-11-30,1:02,1:02,,CIN,13,12,Sun,L 13-14,,13,94,10,73,23,167
245,WAS,2001,2001-12-09,4:04,2:04,@,ARI,13,12,Sun,W 20-10,,13,99,8,49,21,148
246,WAS,2012,2012-11-04,1:05,1:05,,CAR,9,9,Sun,L 13-21,,13,97,7,60,20,157
247,WAS,2012,2012-11-18,1:03,1:03,,PHI,11,10,Sun,W 31-6,,13,80,9,70,22,150
248,ATL,2004,2004-11-21,4:15,4:15,@,NYG,11,10,Sun,W 14-10,,12,94,6,50,18,144
249,ATL,2021,2021-09-12,1:00,1:00,,PHI,1,1,Sun,L 6-32,,12,99,14,89,26,188
250,BUF,2001,2001-12-23,1:05,1:05,@,ATL,15,14,Sun,L 30-33,,12,95,5,43,17,138
251,BUF,2004,2005-01-02,1:02,1:02,,PIT,17,16,Sun,L 24-29,,12,108,7,40,19,148
252,BUF,2005,2005-10-02,1:03,12:03,@,NOR,4,4,Sun,L 7-19,,12,79,4,26,16,105
253,BUF,2005,2005-10-30,8:37,8:37,@,NWE,8,8,Sun,L 16-21,,12,74,7,57,19,131
254,BUF,2005,2005-12-17,8:36,8:36,,DEN,15,14,Sat,L 17-28,,12,82,9,90,21,172
255,BUF,2009,2009-09-27,4:05,4:05,,NOR,3,3,Sun,L 7-27,,12,116,9,97,21,213
256,BUF,2016,2016-10-30,1:02,1:02,,NWE,8,8,Sun,L 25-41,,12,84,10,116,22,200
257,BUF,2018,2018-09-23,1:00,3:00,@,MIN,3,3,Sun,W 27-6,,12,84,6,59,18,143
258,BUF,2018,2018-10-14,1:00,12:00,@,HOU,6,6,Sun,L 13-20,,12,104,6,50,18,154
259,BUF,2019,2019-11-24,1:00,1:00,,DEN,12,11,Sun,W 20-3,,12,90,7,70,19,160
260,BUF,2021,2021-11-07,1:00,1:00,@,JAX,9,8,Sun,L 6-9,,12,118,8,54,20,172
261,CAR,2004,2004-11-21,1:04,1:04,,ARI,11,10,Sun,W 35-10,,12,85,12,105,24,190
262,CAR,2008,2008-09-21,1:05,12:05,@,MIN,3,3,Sun,L 10-20,,12,67,9,100,21,167
263,CAR,2011,2011-11-13,1:04,1:04,,TEN,10,9,Sun,L 3-30,,12,99,9,92,21,191
264,CAR,2020,2020-11-08,1:00,12:00,@,KAN,9,9,Sun,L 31-33,,12,82,8,75,20,157
265,CHI,2002,2002-11-03,1:05,12:05,,PHI,9,8,Sun,L 13-19,,12,121,6,54,18,175
266,CHI,2008,2008-09-14,1:03,1:03,@,CAR,2,2,Sun,L 17-20,,12,86,10,65,22,151
267,CHI,2012,2012-10-07,4:05,4:05,@,JAX,5,5,Sun,W 41-3,,12,80,6,49,18,129
268,CHI,2015,2015-11-26,8:30,7:30,@,GNB,12,11,Thu,W 17-13,,12,95,3,38,15,133
269,CHI,2021,2021-11-08,8:15,8:15,@,PIT,9,9,Mon,L 27-29,,12,115,5,30,17,145
270,CIN,2005,2005-10-09,8:36,8:36,@,JAX,5,5,Sun,L 20-23,,12,94,10,98,22,192
271,CIN,2017,2017-11-12,1:00,12:00,@,TEN,10,9,Sun,L 20-24,,12,84,5,55,17,139
272,CIN,2018,2018-12-02,1:00,1:00,,DEN,13,12,Sun,L 10-24,,12,100,7,60,19,160
273,CLE,2001,2001-10-21,1:02,1:02,,BAL,6,6,Sun,W 24-14,,12,78,6,49,18,127
274,CLE,2002,2002-09-15,1:03,1:03,,CIN,2,2,Sun,W 20-7,,12,87,3,30,15,117
275,CLE,2004,2004-11-28,1:02,1:02,@,CIN,12,11,Sun,L 48-58,,12,87,8,63,20,150
276,CLE,2007,2007-11-18,1:02,1:02,@,BAL,11,10,Sun,W 33-30,OT,12,104,2,15,14,119
277,CLE,2012,2012-11-18,1:04,12:04,@,DAL,11,10,Sun,L 20-23,OT,12,129,9,92,21,221
278,CLE,2013,2013-10-20,4:25,3:25,@,GNB,7,7,Sun,L 13-31,,12,106,10,97,22,203
279,CLE,2014,2014-09-21,1:02,1:02,,BAL,3,3,Sun,L 21-23,,12,94,5,32,17,126
280,CLE,2015,2015-09-13,1:04,1:04,@,NYJ,1,1,Sun,L 10-31,,12,109,4,30,16,139
281,CLE,2015,2015-10-04,4:05,1:05,@,SDG,4,4,Sun,L 27-30,,12,91,6,31,18,122
282,CLE,2015,2015-11-15,1:04,1:04,@,PIT,10,10,Sun,L 9-30,,12,188,5,50,17,238
283,CLE,2017,2017-10-22,1:00,1:00,,TEN,7,7,Sun,L 9-12,OT,12,81,5,35,17,116
284,IND,2004,2004-10-24,1:00,12:00,,JAX,7,6,Sun,L 24-27,,12,62,6,48,18,110
285,IND,2005,2005-11-28,9:08,9:08,,PIT,12,11,Mon,W 26-7,,12,106,10,62,22,168
286,IND,2008,2008-10-19,4:15,3:15,@,GNB,7,6,Sun,L 14-34,,12,110,9,70,21,180
287,IND,2016,2016-10-23,1:02,12:02,@,TEN,7,7,Sun,W 34-26,,12,131,6,38,18,169
288,IND,2018,2018-12-30,8:20,12:00,@,TEN,17,16,Sun,W 33-17,,12,96,9,75,21,171
289,ARI,2000,2000-11-26,8:35,6:35,,NYG,13,12,Sun,L 7-31,,12,99,4,45,16,144
290,ARI,2003,2003-09-07,1:06,1:06,@,DET,1,1,Sun,L 24-42,,12,80,6,36,18,116
291,ARI,2004,2004-11-21,1:04,1:04,@,CAR,11,10,Sun,L 10-35,,12,105,12,85,24,190
292,ARI,2005,2005-09-25,4:06,1:06,@,SEA,3,3,Sun,L 12-37,,12,71,3,25,15,96
293,ARI,2005,2006-01-01,1:02,1:02,@,IND,17,16,Sun,L 13-17,,12,98,7,50,19,148
294,ARI,2008,2008-10-12,4:15,1:15,,DAL,6,6,Sun,W 30-24,OT,12,70,12,93,24,163
295,ARI,2009,2009-09-13,1:15,1:15,,SFO,1,1,Sun,L 16-20,,12,82,4,31,16,113
296,ARI,2011,2011-10-30,1:02,1:02,@,BAL,8,7,Sun,L 27-30,,12,92,11,99,23,191
297,ARI,2019,2019-10-06,1:00,1:00,@,CIN,5,5,Sun,W 26-23,,12,96,7,60,19,156
298,DAL,2000,2000-11-05,1:03,1:03,@,PHI,10,9,Sun,L 13-16,OT,12,97,7,91,19,188
299,DAL,2007,2007-09-23,8:24,7:24,@,CHI,3,3,Sun,W 34-10,,12,100,5,28,17,128
300,DAL,2007,2007-10-14,4:17,3:17,,NWE,6,6,Sun,L 27-48,,12,100,5,50,17,150
301,DAL,2008,2008-10-12,4:15,1:15,@,ARI,6,6,Sun,L 24-30,OT,12,93,12,70,24,163
302,DAL,2010,2010-09-12,8:31,8:31,@,WAS,1,1,Sun,L 7-13,,12,81,5,42,17,123
303,DAL,2010,2010-10-10,4:16,3:16,,TEN,5,4,Sun,L 27-34,,12,133,4,40,16,173
304,DAL,2013,2013-10-20,1:02,1:02,@,PHI,7,7,Sun,W 17-3,,12,75,5,33,17,108
305,DAL,2021,2021-10-17,4:25,4:25,@,NWE,6,6,Sun,W 35-29,OT,12,115,5,47,17,162
306,DEN,2001,2001-10-14,4:16,1:16,@,SEA,5,5,Sun,L 21-34,,12,148,8,84,20,232
307,DEN,2007,2007-11-04,1:02,1:02,@,DET,9,8,Sun,L 7-44,,12,84,2,32,14,116
308,DEN,2007,2007-11-11,1:00,12:00,@,KAN,10,9,Sun,W 27-11,,12,64,4,20,16,84
309,DEN,2013,2013-10-20,8:31,8:31,@,IND,7,7,Sun,L 33-39,,12,103,6,52,18,155
310,DEN,2014,2014-11-09,4:05,1:05,@,OAK,10,9,Sun,W 41-17,,12,95,4,37,16,132
311,DEN,2015,2015-12-20,4:25,4:25,@,PIT,15,14,Sun,L 27-34,,12,127,9,63,21,190
312,DEN,2016,2016-10-13,8:25,5:25,@,SDG,6,6,Thu,L 13-21,,12,103,3,20,15,123
313,DEN,2016,2016-11-06,8:30,5:30,@,OAK,9,9,Sun,L 20-30,,12,104,8,72,20,176
314,DEN,2017,2017-12-14,8:25,8:25,@,IND,15,14,Thu,W 25-13,,12,80,4,39,16,119
315,DEN,2019,2019-10-06,4:05,1:05,@,LAC,5,5,Sun,W 20-13,,12,122,4,43,16,165
316,DET,2004,2004-10-10,1:05,1:05,@,ATL,5,4,Sun,W 17-10,,12,80,8,74,20,154
317,DET,2011,2011-10-10,8:40,8:40,,CHI,5,5,Mon,W 24-13,,12,94,14,104,26,198
318,GNB,2002,2002-09-22,4:17,4:17,@,DET,3,3,Sun,W 37-31,,12,88,4,24,16,112
319,GNB,2004,2004-12-05,4:15,4:15,@,PHI,13,12,Sun,L 17-47,,12,99,8,89,20,188
320,GNB,2004,2004-12-19,4:15,3:15,,JAX,15,14,Sun,L 25-28,,12,101,7,85,19,186
321,GNB,2007,2007-10-07,8:24,7:24,,CHI,5,5,Sun,L 20-27,,12,93,6,40,18,133
322,GNB,2008,2008-09-08,7:10,6:10,,MIN,1,1,Mon,W 24-19,,12,118,9,42,21,160
323,GNB,2009,2009-11-15,4:15,3:15,,DAL,10,9,Sun,W 17-7,,12,100,10,67,22,167
324,GNB,2015,2015-09-28,8:30,7:30,,KAN,3,3,Mon,W 38-28,,12,89,7,38,19,127
325,GNB,2016,2016-11-13,1:00,12:00,@,TEN,10,9,Sun,L 25-47,,12,107,7,65,19,172
326,GNB,2018,2018-10-07,1:00,1:00,@,DET,5,5,Sun,L 23-31,,12,112,8,71,20,183
327,GNB,2020,2020-12-13,4:25,4:25,@,DET,14,13,Sun,W 31-24,,12,68,4,30,16,98
328,HOU,2002,2002-09-15,4:15,1:15,@,SDG,2,2,Sun,L 3-24,,12,73,4,35,16,108
329,JAX,2008,2008-11-02,1:02,1:02,@,CIN,9,8,Sun,L 19-21,,12,86,5,39,17,125
330,JAX,2016,2016-12-18,1:00,12:00,@,HOU,15,14,Sun,L 20-21,,12,91,6,71,18,162
331,JAX,2017,2017-12-24,4:05,1:05,@,SFO,16,15,Sun,L 33-44,,12,99,8,68,20,167
332,JAX,2019,2019-09-29,4:25,2:25,@,DEN,4,4,Sun,W 26-24,,12,104,5,48,17,152
333,JAX,2021,2021-10-31,4:05,1:05,@,SEA,8,7,Sun,L 7-31,,12,93,5,40,17,133
334,KAN,2000,2000-10-02,9:00,8:00,,SEA,5,5,Mon,W 24-17,,12,77,7,45,19,122
335,KAN,2004,2004-11-14,1:02,12:02,@,NOR,10,9,Sun,L 20-27,,12,94,8,57,20,151
336,KAN,2010,2010-11-07,4:15,1:15,@,OAK,9,8,Sun,L 20-23,OT,12,100,15,140,27,240
337,KAN,2018,2018-09-16,1:00,1:00,@,PIT,2,2,Sun,W 42-37,,12,76,12,90,24,166
338,KAN,2021,2021-11-01,8:15,7:15,,NYG,8,8,Mon,W 20-17,,12,103,10,88,22,191
339,MIA,2003,2003-12-21,1:02,1:02,@,BUF,16,15,Sun,W 20-3,,12,106,7,59,19,165
340,MIA,2004,2004-10-10,1:02,1:02,@,NWE,5,5,Sun,L 10-24,,12,86,7,55,19,141
341,MIA,2004,2004-11-07,1:02,1:02,,ARI,9,9,Sun,L 23-24,,12,99,9,45,21,144
342,MIA,2015,2015-12-14,8:30,8:30,,NYG,14,13,Mon,L 24-31,,12,123,3,25,15,148
343,MIN,2001,2001-10-07,12:05,12:05,@,NOR,4,4,Sun,L 15-28,,12,116,8,65,20,181
344,MIN,2002,2002-11-03,1:01,1:01,@,TAM,9,8,Sun,L 24-38,,12,83,7,52,19,135
345,MIN,2002,2002-11-17,12:00,12:00,,GNB,11,10,Sun,W 31-21,,12,105,13,118,25,223
346,MIN,2006,2006-10-01,1:02,1:02,@,BUF,4,4,Sun,L 12-17,,12,78,15,104,27,182
347,MIN,2006,2006-12-03,1:03,12:03,@,CHI,13,12,Sun,L 13-23,,12,69,9,65,21,134
348,MIN,2007,2007-09-16,4:05,4:05,@,DET,2,2,Sun,L 17-20,OT,12,96,7,44,19,140
349,MIN,2010,2010-09-26,1:05,12:05,,DET,3,3,Sun,W 24-10,,12,100,8,67,20,167
350,MIN,2017,2017-12-31,1:00,3:00,,CHI,17,16,Sun,W 23-10,,12,103,10,116,22,219
351,MIN,2019,2019-10-06,1:00,1:00,@,NYG,5,5,Sun,W 28-10,,12,112,5,45,17,157
352,MIN,2021,2021-09-12,1:00,1:00,@,CIN,1,1,Sun,L 24-27,OT,12,116,3,15,15,131
353,NOR,2000,2000-09-03,1:03,12:03,,DET,1,1,Sun,L 10-14,,12,89,8,74,20,163
354,NOR,2000,2000-11-19,1:02,12:02,,OAK,12,11,Sun,L 22-31,,12,93,5,32,17,125
355,NOR,2002,2002-10-13,1:01,1:01,@,WAS,6,6,Sun,W 43-27,,12,90,11,87,23,177
356,NOR,2003,2003-11-23,1:02,1:02,@,PHI,12,11,Sun,L 20-33,,12,101,14,171,26,272
357,NOR,2004,2004-10-03,4:05,1:05,@,ARI,4,4,Sun,L 10-34,,12,104,7,65,19,169
358,NOR,2012,2012-09-09,1:03,12:03,,WAS,1,1,Sun,L 32-40,,12,107,12,127,24,234
359,NOR,2014,2014-10-19,1:02,1:02,@,DET,7,6,Sun,L 23-24,,12,134,9,71,21,205
360,NOR,2015,2015-10-25,1:03,1:03,@,IND,7,7,Sun,W 27-21,,12,100,7,42,19,142
361,NOR,2015,2015-11-01,1:02,12:02,,NYG,8,8,Sun,W 52-49,,12,93,6,53,18,146
362,NOR,2015,2015-12-13,1:02,1:02,@,TAM,14,13,Sun,W 24-17,,12,95,8,80,20,175
363,NOR,2019,2019-11-10,1:00,12:00,,ATL,10,9,Sun,L 9-26,,12,90,7,48,19,138
364,NOR,2019,2019-11-24,1:00,12:00,,CAR,12,11,Sun,W 34-31,,12,123,3,25,15,148
365,NWE,2002,2002-09-22,1:02,1:02,,KAN,3,3,Sun,W 41-38,OT,12,100,1,5,13,105
366,NWE,2002,2002-10-13,1:02,1:02,,GNB,6,6,Sun,L 10-28,,12,126,5,60,17,186
367,NWE,2003,2003-09-07,1:04,1:04,@,BUF,1,1,Sun,L 0-31,,12,121,10,119,22,240
368,NWE,2004,2004-09-19,4:16,1:16,@,ARI,2,2,Sun,W 23-12,,12,79,6,43,18,122
369,NWE,2005,2005-09-18,1:02,1:02,@,CAR,2,2,Sun,L 17-27,,12,86,6,45,18,131
370,NWE,2014,2014-10-05,8:43,8:43,,CIN,5,5,Sun,W 43-17,,12,114,4,37,16,151
371,NWE,2017,2017-10-05,8:25,8:25,@,TAM,5,5,Thu,W 19-14,,12,108,9,70,21,178
372,NYG,2001,2001-10-14,12:02,12:02,@,STL,5,5,Sun,L 14-15,,12,125,12,89,24,214
373,NYG,2005,2005-09-25,8:30,5:30,@,SDG,3,3,Sun,L 23-45,,12,83,7,50,19,133
374,NYG,2013,2013-10-06,1:02,1:02,,PHI,5,5,Sun,L 21-36,,12,136,8,88,20,224
375,NYG,2014,2014-12-21,4:05,3:05,@,STL,16,15,Sun,W 37-27,,12,149,9,76,21,225
376,NYG,2015,2015-10-19,8:30,8:30,@,PHI,6,6,Mon,L 7-27,,12,92,9,72,21,164
377,NYG,2018,2018-12-02,1:00,1:00,,CHI,13,12,Sun,W 30-27,OT,12,107,8,58,20,165
378,NYJ,2004,2004-12-12,4:05,4:05,@,PIT,14,13,Sun,L 6-17,,12,84,2,15,14,99
379,NYJ,2014,2014-10-05,4:25,1:25,@,SDG,5,5,Sun,L 0-31,,12,94,5,76,17,170
380,NYJ,2017,2017-10-22,1:00,1:00,@,MIA,7,7,Sun,L 28-31,,12,124,9,76,21,200
381,NYJ,2019,2019-09-16,8:15,8:15,,CLE,2,2,Mon,L 3-23,,12,89,9,85,21,174
382,TEN,2000,2000-09-03,8:35,8:35,@,BUF,1,1,Sun,L 13-16,,12,112,6,91,18,203
383,TEN,2001,2001-09-09,8:36,7:36,,MIA,1,1,Sun,L 23-31,,12,77,9,128,21,205
384,TEN,2001,2001-10-14,1:04,12:04,,TAM,5,4,Sun,W 31-28,OT,12,117,8,53,20,170
385,TEN,2002,2002-12-01,1:03,1:03,@,NYG,13,12,Sun,W 32-29,OT,12,121,6,55,18,176
386,TEN,2004,2004-10-11,9:09,8:09,@,GNB,5,5,Mon,W 48-27,,12,105,3,15,15,120
387,TEN,2004,2004-10-24,1:00,12:00,@,MIN,7,7,Sun,L 3-20,,12,85,8,66,20,151
388,TEN,2010,2010-12-19,1:02,12:02,,HOU,15,14,Sun,W 31-17,,12,76,9,66,21,142
389,TEN,2014,2014-09-07,1:02,12:02,@,KAN,1,1,Sun,W 26-10,,12,110,3,25,15,135
390,TEN,2016,2016-09-18,1:02,1:02,@,DET,2,2,Sun,W 16-15,,12,83,17,138,29,221
391,PHI,2000,2000-09-17,1:02,12:02,@,GNB,3,3,Sun,L 3-6,,12,115,5,31,17,146
392,PHI,2004,2004-11-28,1:03,1:03,@,NYG,12,11,Sun,W 27-6,,12,75,6,64,18,139
393,PHI,2006,2006-12-17,4:15,4:15,@,NYG,15,14,Sun,W 36-22,,12,103,5,55,17,158
394,PHI,2009,2009-10-26,8:41,8:41,@,WAS,7,6,Mon,W 27-17,,12,66,6,60,18,126
395,PHI,2010,2010-12-28,8:06,8:06,,MIN,16,15,Tue,L 14-24,,12,62,5,74,17,136
396,PHI,2012,2012-09-09,1:03,1:03,@,CLE,1,1,Sun,W 17-16,,12,110,3,35,15,145
397,PHI,2020,2020-12-27,4:25,3:25,@,DAL,16,15,Sun,L 17-37,,12,115,5,73,17,188
398,PIT,2001,2001-09-30,1:03,1:03,@,BUF,3,2,Sun,W 20-3,,12,125,6,57,18,182
399,PIT,2005,2005-12-18,1:05,12:05,@,MIN,15,14,Sun,W 18-3,,12,129,13,95,25,224
400,PIT,2011,2011-12-08,8:28,8:28,,CLE,14,13,Thu,W 14-3,,12,97,6,54,18,151
401,PIT,2016,2016-12-04,4:25,4:25,,NYG,13,12,Sun,W 24-14,,12,115,4,24,16,139
402,PIT,2018,2018-09-09,1:00,1:00,@,CLE,1,1,Sun,T 21-21,OT,12,116,11,87,23,203
403,PIT,2018,2018-09-16,1:00,1:00,,KAN,2,2,Sun,L 37-42,,12,90,12,76,24,166
404,OAK,2000,2000-11-26,4:05,1:05,,ATL,13,12,Sun,W 41-14,,12,108,10,55,22,163
405,OAK,2001,2001-09-30,4:10,1:10,,SEA,3,3,Sun,W 38-14,,12,89,5,50,17,139
406,OAK,2002,2002-11-17,8:36,5:36,,NWE,11,10,Sun,W 27-20,,12,115,7,34,19,149
407,OAK,2004,2004-12-25,5:00,4:00,@,KAN,16,15,Sat,L 30-31,,12,90,7,52,19,142
408,OAK,2010,2010-09-19,4:05,1:05,,STL,2,2,Sun,W 16-14,,12,90,8,92,20,182
409,OAK,2010,2010-10-10,4:15,1:15,,SDG,5,5,Sun,W 35-27,,12,85,7,53,19,138
410,OAK,2011,2011-11-20,1:05,12:05,@,MIN,11,10,Sun,W 27-21,,12,117,9,50,21,167
411,OAK,2012,2012-10-14,1:01,1:01,@,ATL,6,5,Sun,L 20-23,,12,110,2,25,14,135
412,OAK,2013,2013-12-22,4:25,1:25,@,SDG,16,15,Sun,L 13-26,,12,73,3,24,15,97
413,OAK,2015,2015-09-27,1:02,1:02,@,CLE,3,3,Sun,W 27-20,,12,85,6,50,18,135
414,OAK,2016,2016-10-02,1:02,1:02,@,BAL,4,4,Sun,W 28-27,,12,93,10,105,22,198
415,OAK,2019,2019-11-07,8:20,5:20,,LAC,10,9,Thu,W 26-24,,12,97,8,70,20,167
416,OAK,2019,2019-12-01,4:25,3:25,@,KAN,13,12,Sun,L 9-40,,12,99,0,0,12,99
417,STL,2001,2001-10-14,12:02,12:02,,NYG,5,5,Sun,W 15-14,,12,89,12,125,24,214
418,STL,2001,2001-12-02,4:15,4:15,@,ATL,12,11,Sun,W 35-6,,12,107,7,61,19,168
419,STL,2002,2002-12-22,4:05,1:05,@,SEA,16,15,Sun,L 10-30,,12,102,4,20,16,122
420,STL,2004,2004-09-26,1:02,12:02,,NOR,3,3,Sun,L 25-28,OT,12,85,5,25,17,110
421,STL,2010,2010-11-14,4:15,1:15,@,SFO,10,9,Sun,L 20-23,OT,12,135,14,105,26,240
422,STL,2012,2012-10-14,1:00,1:00,@,MIA,6,6,Sun,L 14-17,,12,94,5,40,17,134
423,STL,2012,2012-10-28,1:06,5:06,,NWE,8,8,Sun,L 7-45,,12,102,8,42,20,144
424,STL,2013,2013-12-29,4:26,1:26,@,SEA,17,16,Sun,L 9-27,,12,87,7,65,19,152
425,STL,2015,2015-11-01,1:00,12:00,,SFO,8,7,Sun,W 27-6,,12,93,13,93,25,186
426,STL,2015,2015-11-08,1:02,12:02,@,MIN,9,8,Sun,L 18-21,OT,12,87,6,67,18,154
427,LAR,2021,2021-11-07,8:20,5:20,,TEN,9,9,Sun,L 16-28,,12,115,4,19,16,134
428,BAL,2006,2006-12-24,1:02,1:02,@,PIT,16,15,Sun,W 31-7,,12,89,5,32,17,121
429,BAL,2009,2009-12-07,8:40,7:40,@,GNB,13,12,Mon,L 14-27,,12,135,11,175,23,310
430,BAL,2015,2015-10-11,1:02,1:02,,CLE,5,5,Sun,L 30-33,OT,12,98,9,74,21,172
431,BAL,2015,2015-12-27,1:02,1:02,,PIT,16,15,Sun,W 20-17,,12,121,3,25,15,146
432,BAL,2016,2016-11-20,1:00,12:00,@,DAL,11,10,Sun,L 17-27,,12,136,5,45,17,181
433,BAL,2020,2020-10-18,1:00,1:00,@,PHI,6,6,Sun,W 30-28,,12,132,3,20,15,152
434,SDG,2000,2000-10-15,1:01,1:01,@,BUF,7,7,Sun,L 24-27,OT,12,88,10,103,22,191
435,SDG,2002,2002-11-10,1:02,12:02,@,STL,10,9,Sun,L 24-28,,12,82,10,85,22,167
436,SDG,2003,2003-10-19,1:02,1:02,@,CLE,7,6,Sun,W 26-20,,12,93,7,76,19,169
437,SDG,2005,2005-11-06,1:02,1:02,@,NYJ,9,9,Sun,W 31-26,,12,124,5,35,17,159
438,SDG,2006,2006-11-05,4:15,1:15,,CLE,9,8,Sun,W 32-25,,12,113,6,50,18,163
439,SDG,2009,2009-09-20,4:15,1:15,,BAL,2,2,Sun,L 26-31,,12,85,4,32,16,117
440,SDG,2011,2011-10-31,8:40,7:40,@,KAN,8,7,Mon,L 20-23,OT,12,105,9,53,21,158
441,LAC,2018,2018-11-04,4:05,1:05,@,SEA,9,8,Sun,W 25-17,,12,105,10,83,22,188
442,LAC,2021,2021-09-19,4:25,1:25,,DAL,2,2,Sun,L 17-20,,12,99,8,76,20,175
443,LAC,2021,2021-11-21,8:20,5:20,,PIT,11,10,Sun,W 41-37,,12,75,8,38,20,113
444,SEA,2000,2000-10-08,4:15,4:15,@,CAR,6,6,Sun,L 3-26,,12,80,5,30,17,110
445,SEA,2017,2017-11-09,8:25,6:25,@,ARI,10,9,Thu,W 22-16,,12,108,9,58,21,166
446,SEA,2019,2019-11-24,1:00,1:00,@,PHI,12,11,Sun,W 17-9,,12,90,2,15,14,105
447,SFO,2005,2005-11-06,4:06,1:06,,NYG,9,8,Sun,L 6-24,,12,80,10,81,22,161
448,SFO,2011,2011-09-25,1:02,1:02,@,CIN,3,3,Sun,W 13-8,,12,70,6,40,18,110
449,SFO,2013,2013-09-15,8:31,5:31,@,SEA,2,2,Sun,L 3-29,,12,121,10,84,22,205
450,TAM,2004,2004-12-12,4:15,1:15,@,SDG,14,13,Sun,L 24-31,,12,111,4,40,16,151
451,TAM,2005,2005-10-09,1:03,1:03,@,NYJ,5,5,Sun,L 12-14,,12,87,6,46,18,133
452,TAM,2010,2010-10-24,1:02,1:02,,STL,7,6,Sun,W 18-17,,12,92,6,45,18,137
453,TAM,2011,2011-12-11,1:03,1:03,@,JAX,14,13,Sun,L 14-41,,12,97,8,80,20,177
454,TAM,2015,2015-09-13,4:25,4:25,,TEN,1,1,Sun,L 14-42,,12,97,8,55,20,152
455,TAM,2015,2015-11-29,1:02,1:02,@,IND,12,11,Sun,L 12-25,,12,95,6,45,18,140
456,TAM,2017,2017-12-24,1:00,1:00,@,CAR,16,15,Sun,L 19-22,,12,72,6,50,18,122
457,TAM,2019,2019-09-12,8:20,8:20,@,CAR,2,2,Thu,W 20-14,,12,66,5,50,17,116
458,TAM,2019,2019-09-29,4:05,1:05,@,LAR,4,4,Sun,W 55-40,,12,99,13,106,25,205
459,TAM,2019,2019-12-29,1:00,1:00,,ATL,17,16,Sun,L 22-28,OT,12,97,5,53,17,150
460,WAS,2000,2000-10-08,1:02,1:02,@,PHI,6,6,Sun,W 17-14,,12,80,5,48,17,128
461,WAS,2002,2002-12-08,1:02,1:02,,NYG,14,13,Sun,L 21-27,,12,90,8,61,20,151
462,WAS,2003,2003-09-14,1:03,1:03,@,ATL,2,2,Sun,W 33-31,,12,79,5,35,17,114
463,WAS,2004,2004-11-21,4:16,4:16,@,PHI,11,10,Sun,L 6-28,,12,115,9,69,21,184
464,WAS,2004,2004-12-12,8:37,8:37,,PHI,14,13,Sun,L 14-17,,12,137,5,41,17,178
465,WAS,2005,2005-09-19,9:07,8:07,@,DAL,2,2,Mon,W 14-13,,12,80,7,60,19,140
466,WAS,2006,2006-09-24,1:03,12:03,@,HOU,3,3,Sun,W 31-15,,12,126,7,57,19,183
467,WAS,2012,2012-09-09,1:03,12:03,@,NOR,1,1,Sun,W 40-32,,12,127,12,107,24,234
468,WAS,2013,2013-10-13,8:31,7:31,@,DAL,6,5,Sun,L 16-31,,12,104,7,80,19,184
469,WAS,2019,2019-09-08,1:00,1:00,@,PHI,1,1,Sun,L 27-32,,12,96,6,55,18,151
470,WAS,2019,2019-09-29,1:00,1:00,@,NYG,4,4,Sun,L 3-24,,12,58,5,45,17,103
471,ATL,2002,2002-11-10,1:01,1:01,@,PIT,10,9,Sun,T 34-34,OT,11,95,4,25,15,120
472,ATL,2002,2002-12-15,1:03,1:03,,SEA,15,14,Sun,L 24-30,OT,11,95,7,45,18,140
473,ATL,2004,2004-10-03,4:05,4:05,@,CAR,4,4,Sun,W 27-10,,11,106,10,91,21,197
474,ATL,2005,2005-11-20,1:05,1:05,,TAM,11,10,Sun,L 27-30,,11,87,8,55,19,142
475,ATL,2005,2005-11-24,12:40,12:40,@,DET,12,11,Thu,W 27-7,,11,84,9,50,20,134
476,ATL,2007,2007-11-18,1:05,1:05,,TAM,11,10,Sun,L 7-31,,11,105,6,45,17,150
477,ATL,2011,2011-10-23,1:05,1:05,@,DET,7,7,Sun,W 23-16,,11,80,10,84,21,164
478,ATL,2015,2015-11-01,1:02,1:02,,TAM,8,8,Sun,L 20-23,OT,11,124,8,43,19,167
479,ATL,2019,2019-12-15,4:25,1:25,@,SFO,15,14,Sun,W 29-22,,11,98,7,67,18,165
480,BUF,2000,2000-10-22,1:02,12:02,@,MIN,8,7,Sun,L 27-31,,11,72,9,55,20,127
481,BUF,2003,2003-09-21,8:36,8:36,@,MIA,3,3,Sun,L 7-17,,11,84,4,35,15,119
482,BUF,2004,2004-10-03,1:02,1:02,,NWE,4,3,Sun,L 17-31,,11,94,10,77,21,171
483,BUF,2004,2004-12-05,1:03,1:03,@,MIA,13,12,Sun,W 42-32,,11,73,7,46,18,119
484,BUF,2009,2009-12-20,1:02,1:02,,NWE,15,14,Sun,L 10-17,,11,124,6,52,17,176
485,BUF,2011,2011-12-18,1:02,1:02,,MIA,15,14,Sun,L 23-30,,11,92,5,62,16,154
486,BUF,2012,2012-11-15,8:29,8:29,,MIA,11,10,Thu,W 19-14,,11,100,6,69,17,169
487,BUF,2012,2012-12-23,1:02,1:02,@,MIA,16,15,Sun,L 10-24,,11,93,3,25,14,118
488,BUF,2013,2013-09-29,1:02,1:02,,BAL,4,4,Sun,W 23-20,,11,99,8,59,19,158
489,BUF,2013,2013-12-08,1:02,1:02,@,TAM,14,13,Sun,L 6-27,,11,114,8,76,19,190
490,BUF,2014,2014-09-21,1:02,1:02,,SDG,3,3,Sun,L 10-22,,11,110,6,44,17,154
491,BUF,2014,2014-10-05,1:03,1:03,@,DET,5,5,Sun,W 17-14,,11,74,8,62,19,136
492,BUF,2014,2014-12-07,4:05,2:05,@,DEN,14,13,Sun,L 17-24,,11,98,5,45,16,143
493,BUF,2015,2015-09-13,1:03,1:03,,IND,1,1,Sun,W 27-14,,11,113,5,49,16,162
494,BUF,2016,2016-11-07,8:30,5:30,@,SEA,9,9,Mon,L 25-31,,11,115,10,75,21,190
495,BUF,2017,2017-10-29,1:00,1:00,,OAK,8,7,Sun,W 34-14,,11,95,6,50,17,145
496,BUF,2017,2017-11-02,8:25,8:25,@,NYJ,9,8,Thu,L 21-34,,11,99,10,66,21,165
497,BUF,2019,2019-10-06,1:00,12:00,@,TEN,5,5,Sun,W 14-7,,11,78,8,60,19,138
498,BUF,2020,2020-10-25,1:00,1:00,@,NYJ,7,7,Sun,W 18-10,,11,106,6,49,17,155
499,CAR,2003,2003-11-23,1:02,12:02,@,DAL,12,11,Sun,L 20-24,,11,68,10,123,21,191
500,CAR,2005,2005-09-11,1:06,1:06,,NOR,1,1,Sun,L 20-23,,11,84,9,74,20,158
501,CAR,2008,2008-09-28,1:04,1:04,,ATL,4,4,Sun,W 24-9,,11,90,5,45,16,135
502,CAR,2012,2012-11-18,1:04,1:04,,TAM,11,10,Sun,L 21-27,OT,11,91,6,50,17,141
503,CAR,2017,2017-10-08,1:00,1:00,@,DET,5,5,Sun,W 27-24,,11,100,1,10,12,110
504,CHI,2003,2003-10-05,1:02,12:02,,OAK,5,4,Sun,W 24-21,,11,97,5,45,16,142
505,CHI,2004,2004-11-07,4:06,4:06,@,NYG,9,8,Sun,W 28-21,,11,70,14,109,25,179
506,CHI,2006,2006-12-11,8:30,7:30,@,STL,14,13,Mon,W 42-27,,11,86,11,91,22,177
507,CHI,2007,2007-12-17,8:40,7:40,@,MIN,15,14,Mon,L 13-20,,11,95,4,30,15,125
508,CHI,2010,2010-11-14,1:02,12:02,,MIN,10,9,Sun,W 27-13,,11,116,2,19,13,135
509,CHI,2014,2014-11-09,8:30,7:30,@,GNB,10,9,Sun,L 14-55,,11,163,5,50,16,213
510,CHI,2016,2016-12-11,1:00,1:00,@,DET,14,13,Sun,L 17-20,,11,139,7,55,18,194
511,CHI,2018,2018-12-30,4:25,3:00,@,MIN,17,16,Sun,W 24-10,,11,102,3,30,14,132
512,CIN,2003,2003-09-28,1:03,1:03,@,CLE,4,4,Sun,W 21-14,,11,60,11,101,22,161
513,CIN,2007,2007-11-18,1:02,1:02,,ARI,11,10,Sun,L 27-35,,11,79,11,101,22,180
514,CIN,2009,2009-12-13,1:05,12:05,@,MIN,14,13,Sun,L 10-30,,11,85,9,69,20,154
515,CIN,2011,2011-10-16,1:02,1:02,,IND,6,6,Sun,W 27-17,,11,111,2,11,13,122
516,CIN,2011,2011-12-18,1:00,12:00,@,STL,15,14,Sun,W 20-13,,11,101,10,109,21,210
517,CIN,2012,2012-12-13,8:30,8:30,@,PHI,15,14,Thu,W 34-13,,11,94,9,76,20,170
518,CIN,2015,2015-10-04,1:03,1:03,,KAN,4,4,Sun,W 36-21,,11,84,7,46,18,130
519,CIN,2015,2016-01-03,1:02,1:02,,BAL,17,16,Sun,W 24-16,,11,72,4,38,15,110
520,CLE,2002,2002-11-03,1:03,1:03,,PIT,9,9,Sun,L 20-23,,11,85,3,21,14,106
521,CLE,2003,2003-09-28,1:03,1:03,,CIN,4,4,Sun,L 14-21,,11,101,11,60,22,161
522,CLE,2011,2011-09-11,1:06,1:06,,CIN,1,1,Sun,L 17-27,,11,72,3,22,14,94
523,CLE,2015,2015-10-25,1:00,12:00,@,STL,7,7,Sun,L 6-24,,11,98,9,75,20,173
524,CLE,2016,2016-10-16,1:02,12:02,@,TEN,6,6,Sun,L 26-28,,11,69,7,96,18,165
525,CLE,2017,2017-09-17,1:00,1:00,@,BAL,2,2,Sun,L 10-24,,11,65,7,45,18,110
526,CLE,2017,2017-10-15,1:00,12:00,@,HOU,6,6,Sun,L 17-33,,11,72,4,44,15,116
527,CLE,2018,2018-09-09,1:00,1:00,,PIT,1,1,Sun,T 21-21,OT,11,87,12,116,23,203
528,IND,2000,2000-09-25,9:00,8:00,,JAX,4,3,Mon,W 43-14,,11,90,4,40,15,130
529,IND,2003,2003-10-06,9:15,9:15,@,TAM,5,5,Mon,W 38-35,OT,11,80,11,111,22,191
530,IND,2004,2004-11-14,1:00,1:00,,HOU,10,9,Sun,W 49-14,,11,85,8,65,19,150
531,IND,2008,2008-10-12,1:02,1:02,,BAL,6,5,Sun,W 31-3,,11,84,4,33,15,117
532,IND,2012,2012-09-23,1:03,1:03,,JAX,3,3,Sun,L 17-22,,11,106,6,67,17,173
533,IND,2012,2012-11-04,1:02,1:02,,MIA,9,8,Sun,W 23-20,,11,91,8,79,19,170
534,IND,2014,2014-09-28,1:03,1:03,,TEN,4,4,Sun,W 41-17,,11,88,6,68,17,156
535,IND,2015,2015-09-21,8:30,8:30,,NYJ,2,2,Mon,L 7-20,,11,84,8,90,19,174
536,IND,2015,2015-09-27,1:03,12:03,@,TEN,3,3,Sun,W 35-33,,11,71,6,55,17,126
537,IND,2015,2015-10-18,8:30,8:30,,NWE,6,6,Sun,L 27-34,,11,103,8,72,19,175
538,IND,2016,2016-09-25,4:25,4:25,,SDG,3,3,Sun,W 26-22,,11,66,10,80,21,146
539,IND,2017,2017-09-24,1:00,1:00,,CLE,3,3,Sun,W 31-28,,11,99,10,113,21,212
540,IND,2018,2018-09-23,1:00,1:00,@,PHI,3,3,Sun,L 16-20,,11,77,10,110,21,187
541,ARI,2000,2000-10-22,1:00,12:00,@,DAL,8,7,Sun,L 7-48,,11,59,5,30,16,89
542,ARI,2005,2005-11-27,4:06,2:06,,JAX,12,11,Sun,L 17-24,,11,105,11,81,22,186
543,ARI,2005,2005-12-04,4:05,1:05,@,SFO,13,12,Sun,W 17-10,,11,80,6,44,17,124
544,ARI,2006,2006-09-10,4:15,1:15,,SFO,1,1,Sun,W 34-27,,11,85,8,62,19,147
545,ARI,2006,2006-09-17,4:06,1:06,@,SEA,2,2,Sun,L 10-21,,11,66,7,73,18,139
546,ARI,2006,2006-12-03,1:02,12:02,@,STL,13,12,Sun,W 34-20,,11,107,10,126,21,233
547,ARI,2007,2007-10-07,1:02,12:02,@,STL,5,5,Sun,W 34-31,,11,98,9,86,20,184
548,ARI,2007,2007-10-14,4:05,1:05,,CAR,6,6,Sun,L 10-25,,11,101,9,65,20,166
549,ARI,2007,2007-11-18,1:02,1:02,@,CIN,11,10,Sun,W 35-27,,11,101,11,79,22,180
550,ARI,2007,2007-12-02,4:06,2:06,,CLE,13,12,Sun,W 27-21,,11,75,10,77,21,152
551,ARI,2008,2008-09-28,1:02,1:02,@,NYJ,4,4,Sun,L 35-56,,11,71,4,61,15,132
552,ARI,2009,2009-11-15,4:15,2:15,,SEA,10,9,Sun,W 31-20,,11,136,9,113,20,249
553,ARI,2009,2009-12-14,8:40,5:40,@,SFO,14,13,Mon,L 9-24,,11,78,7,55,18,133
554,ARI,2010,2010-11-21,1:03,12:03,@,KAN,11,10,Sun,L 13-31,,11,96,5,23,16,119
555,ARI,2011,2011-10-02,4:05,1:05,,NYG,4,4,Sun,L 27-31,,11,118,7,55,18,173
556,ARI,2019,2019-11-10,1:00,1:00,@,TAM,10,10,Sun,L 27-30,,11,87,9,94,20,181
557,ARI,2020,2020-09-20,4:05,2:05,,WAS,2,2,Sun,W 30-15,,11,97,6,42,17,139
558,ARI,2021,2021-12-25,8:15,6:15,,IND,16,15,Sat,L 16-22,,11,85,5,40,16,125
559,DAL,2003,2003-09-15,9:08,9:08,@,NYG,2,2,Mon,W 35-32,OT,11,108,10,102,21,210
560,DAL,2004,2004-09-19,4:15,3:15,,CLE,2,2,Sun,W 19-12,,11,120,6,31,17,151
561,DAL,2004,2004-10-10,1:03,12:03,,NYG,5,4,Sun,L 10-26,,11,74,9,60,20,134
562,DAL,2004,2004-12-12,1:05,12:05,,NOR,14,13,Sun,L 13-27,,11,76,9,136,20,212
563,DAL,2006,2006-11-05,1:02,1:02,@,WAS,9,8,Sun,L 19-22,,11,153,5,41,16,194
564,DAL,2007,2007-09-16,4:05,4:05,@,MIA,2,2,Sun,W 37-20,,11,101,7,57,18,158
565,DAL,2008,2008-09-07,4:16,4:16,@,CLE,1,1,Sun,W 28-10,,11,82,9,55,20,137
566,DAL,2008,2008-12-14,8:24,7:24,,NYG,15,14,Sun,W 20-8,,11,108,7,40,18,148
567,DAL,2009,2009-11-08,8:31,8:31,@,PHI,9,8,Sun,W 20-16,,11,70,8,82,19,152
568,DAL,2009,2010-01-03,4:15,3:15,,PHI,17,16,Sun,W 24-0,,11,80,6,58,17,138
569,DAL,2010,2010-10-17,4:15,3:15,@,MIN,6,5,Sun,L 21-24,,11,91,5,45,16,136
570,DAL,2011,2011-11-24,4:16,3:16,,MIA,12,11,Thu,W 20-19,,11,69,6,55,17,124
571,DAL,2013,2013-11-10,8:30,7:30,@,NOR,10,10,Sun,L 17-49,,11,82,6,44,17,126
572,DAL,2013,2013-11-24,4:25,4:25,@,NYG,12,11,Sun,W 24-21,,11,85,11,81,22,166
573,DAL,2014,2014-12-14,8:35,8:35,@,PHI,15,14,Sun,W 38-27,,11,79,8,95,19,174
574,DAL,2016,2016-10-30,8:31,7:31,,PHI,8,7,Sun,W 29-23,OT,11,84,5,40,16,124
575,DAL,2018,2018-12-09,4:25,3:25,,PHI,14,13,Sun,W 29-23,OT,11,110,5,49,16,159
576,DAL,2019,2019-10-06,4:25,3:25,,GNB,5,5,Sun,L 24-34,,11,124,9,78,20,202
577,DAL,2021,2021-10-31,8:20,6:20,@,MIN,8,7,Sun,W 20-16,,11,96,7,57,18,153
578,DEN,2002,2002-11-17,4:16,1:16,@,SEA,11,10,Sun,W 31-9,,11,104,6,56,17,160
579,DEN,2003,2003-12-14,4:05,2:05,,CLE,15,14,Sun,W 23-20,OT,11,124,7,32,18,156
580,DEN,2003,2003-12-21,8:35,8:35,@,IND,16,15,Sun,W 31-17,,11,93,6,45,17,138
581,DEN,2005,2005-10-16,4:16,2:16,,NWE,6,6,Sun,W 28-20,,11,82,8,55,19,137
582,DEN,2011,2011-11-06,4:05,1:05,@,OAK,9,8,Sun,W 38-24,,11,93,15,130,26,223
583,DEN,2012,2012-12-23,4:05,2:05,,CLE,16,15,Sun,W 34-12,,11,84,10,69,21,153
584,DEN,2014,2014-09-14,4:25,2:25,,KAN,2,2,Sun,W 24-17,,11,71,7,62,18,133
585,DEN,2014,2014-10-12,1:02,1:02,@,NYJ,6,5,Sun,W 31-17,,11,101,2,9,13,110
586,DEN,2015,2015-11-01,8:30,6:30,,GNB,8,7,Sun,W 29-10,,11,93,2,15,13,108
587,DEN,2018,2018-12-09,4:05,1:05,@,SFO,14,13,Sun,L 14-20,,11,62,11,87,22,149
588,DEN,2018,2018-12-24,8:15,5:15,@,OAK,16,15,Mon,L 14-27,,11,91,6,50,17,141
589,DEN,2018,2018-12-30,4:25,2:25,,LAC,17,16,Sun,L 9-23,,11,99,6,51,17,150
590,DET,2001,2001-11-22,12:36,12:36,,GNB,11,10,Thu,L 27-29,,11,117,8,63,19,180
591,DET,2002,2002-09-15,1:04,1:04,@,CAR,2,2,Sun,L 7-31,,11,100,4,55,15,155
592,DET,2005,2005-10-23,1:04,1:04,@,CLE,7,6,Sun,W 13-10,,11,72,8,50,19,122
593,DET,2005,2005-12-24,1:06,12:06,@,NOR,16,15,Sat,W 13-12,,11,65,4,17,15,82
594,DET,2006,2006-12-24,1:03,1:03,,CHI,16,15,Sun,L 21-26,,11,92,7,48,18,140
595,DET,2010,2010-10-10,12:56,12:56,,STL,5,5,Sun,W 44-6,,11,78,7,40,18,118
596,DET,2010,2010-10-17,1:03,1:03,@,NYG,6,6,Sun,L 20-28,,11,91,2,15,13,106
597,DET,2010,2010-11-07,1:03,1:03,,NYJ,9,8,Sun,L 20-23,OT,11,102,11,99,22,201
598,DET,2010,2010-11-14,1:02,1:02,@,BUF,10,9,Sun,L 12-14,,11,60,4,30,15,90
599,DET,2011,2011-11-24,12:35,12:35,,GNB,12,11,Thu,L 15-27,,11,82,7,54,18,136
600,DET,2011,2011-12-04,8:31,7:31,@,NOR,13,12,Sun,L 17-31,,11,107,3,30,14,137
601,DET,2011,2012-01-01,1:02,12:02,@,GNB,17,16,Sun,L 41-45,,11,101,6,78,17,179
602,DET,2013,2013-09-08,1:02,1:02,,MIN,1,1,Sun,W 34-24,,11,88,5,52,16,140
603,DET,2019,2019-11-17,1:00,1:00,,DAL,11,10,Sun,L 27-35,,11,89,6,45,17,134
604,DET,2020,2020-12-26,1:00,1:00,,TAM,16,15,Sat,L 7-47,,11,117,8,65,19,182
605,GNB,2002,2002-10-20,4:15,3:15,,WAS,7,7,Sun,W 30-9,,11,95,11,129,22,224
606,GNB,2004,2004-09-26,4:15,3:15,@,IND,3,3,Sun,L 31-45,,11,84,9,70,20,154
607,GNB,2009,2009-09-20,1:02,12:02,,CIN,2,2,Sun,L 24-31,,11,76,13,100,24,176
608,GNB,2009,2009-12-07,8:40,7:40,,BAL,13,12,Mon,W 27-14,,11,175,12,135,23,310
609,GNB,2018,2018-09-23,1:00,1:00,@,WAS,3,3,Sun,L 17-31,,11,115,6,66,17,181
610,HOU,2002,2002-09-08,8:36,7:36,,DAL,1,1,Sun,W 19-10,,11,80,9,117,20,197
611,HOU,2002,2002-09-29,1:02,1:02,@,PHI,4,4,Sun,L 17-35,,11,83,4,32,15,115
612,HOU,2002,2002-10-13,1:02,12:02,,BUF,6,5,Sun,L 24-31,,11,75,13,128,24,203
613,HOU,2003,2003-09-14,1:02,12:02,@,NOR,2,2,Sun,L 10-31,,11,86,9,78,20,164
614,HOU,2003,2003-11-16,1:01,1:01,@,BUF,11,10,Sun,W 12-10,,11,65,6,44,17,109
615,HOU,2004,2004-10-10,1:02,12:02,,MIN,5,5,Sun,L 28-34,OT,11,88,10,75,21,163
616,HOU,2005,2005-12-04,1:02,1:02,@,BAL,13,12,Sun,L 15-16,,11,93,8,71,19,164
617,HOU,2008,2008-11-23,1:03,1:03,@,CLE,12,11,Sun,W 16-6,,11,84,5,40,16,124
618,HOU,2008,2008-12-14,1:05,12:05,,TEN,15,14,Sun,W 13-12,,11,127,7,64,18,191
619,HOU,2011,2011-12-22,8:29,8:29,@,IND,16,15,Thu,L 16-19,,11,84,4,35,15,119
620,HOU,2012,2012-12-02,1:02,12:02,@,TEN,13,12,Sun,W 24-10,,11,97,4,35,15,132
621,HOU,2017,2017-12-03,1:00,12:00,@,TEN,13,12,Sun,L 13-24,,11,85,7,63,18,148
622,HOU,2018,2018-09-16,1:00,12:00,@,TEN,2,2,Sun,L 17-20,,11,88,8,70,19,158
623,JAX,2002,2002-11-24,1:03,12:03,@,DAL,12,11,Sun,L 19-21,,11,79,10,75,21,154
624,JAX,2004,2004-10-31,1:02,12:02,@,HOU,8,8,Sun,L 6-20,,11,80,8,75,19,155
625,JAX,2005,2005-11-27,4:06,2:06,@,ARI,12,11,Sun,W 24-17,,11,81,11,105,22,186
626,JAX,2007,2007-09-16,1:04,1:04,,ATL,2,2,Sun,W 13-7,,11,91,5,44,16,135
627,JAX,2016,2016-10-02,9:35,2:35,,IND,4,4,Sun,W 30-27,,11,145,7,78,18,223
628,JAX,2018,2018-09-09,1:00,1:00,@,NYG,1,1,Sun,W 20-15,,11,119,6,43,17,162
629,JAX,2018,2018-11-18,1:00,1:00,,PIT,11,10,Sun,L 16-20,,11,111,3,15,14,126
630,JAX,2019,2019-10-20,1:00,1:00,@,CIN,7,7,Sun,W 27-17,,11,130,6,50,17,180
631,JAX,2019,2019-11-24,4:05,3:05,@,TEN,12,11,Sun,L 20-42,,11,104,6,54,17,158
632,KAN,2000,2000-11-26,4:15,1:15,@,SDG,13,12,Sun,L 16-17,,11,90,5,43,16,133
633,KAN,2005,2005-11-06,1:00,12:00,,OAK,9,8,Sun,W 27-23,,11,87,9,84,20,171
634,KAN,2011,2011-12-11,1:02,1:02,@,NYJ,14,13,Sun,L 10-37,,11,128,4,22,15,150
635,KAN,2011,2011-12-24,1:03,12:03,,OAK,16,15,Sat,L 13-16,OT,11,88,15,92,26,180
636,KAN,2014,2014-12-14,1:03,12:03,,OAK,15,14,Sun,W 31-13,,11,84,10,75,21,159
637,KAN,2015,2015-11-15,4:30,2:30,@,DEN,10,9,Sun,W 29-13,,11,102,5,55,16,157
638,KAN,2015,2015-12-06,4:05,1:05,@,OAK,13,12,Sun,W 34-20,,11,88,4,21,15,109
639,KAN,2018,2018-10-07,1:00,12:00,,JAX,5,5,Sun,W 30-14,,11,105,5,45,16,150
640,KAN,2018,2018-11-04,1:00,1:00,@,CLE,9,9,Sun,W 37-21,,11,86,4,20,15,106
641,KAN,2018,2018-12-02,4:05,1:05,@,OAK,13,12,Sun,W 40-33,,11,94,8,74,19,168
642,KAN,2019,2019-10-06,8:20,7:20,,IND,5,5,Sun,L 13-19,,11,125,7,50,18,175
643,KAN,2019,2019-10-13,1:00,12:00,,HOU,6,6,Sun,L 24-31,,11,79,10,70,21,149
644,KAN,2020,2020-09-20,4:25,1:25,@,LAC,2,2,Sun,W 23-20,OT,11,90,6,40,17,130
645,MIA,2001,2001-10-07,1:03,1:03,,NWE,4,4,Sun,W 30-10,,11,86,3,20,14,106
646,MIA,2002,2002-09-15,1:00,12:00,@,IND,2,2,Sun,W 21-13,,11,68,5,35,16,103
647,MIA,2003,2003-09-07,1:06,1:06,,HOU,1,1,Sun,L 20-21,,11,87,8,67,19,154
648,MIA,2003,2003-10-12,1:01,1:01,@,JAX,6,5,Sun,W 24-10,,11,149,7,50,18,199
649,MIA,2005,2005-09-11,1:07,1:07,,DEN,1,1,Sun,W 34-10,,11,69,7,73,18,142
650,MIA,2006,2006-11-05,1:02,12:02,@,CHI,9,8,Sun,W 31-13,,11,69,7,45,18,114
651,MIA,2006,2006-11-23,12:30,12:30,@,DET,12,11,Thu,W 27-10,,11,100,7,55,18,155
652,MIA,2012,2012-09-23,1:03,1:03,,NYJ,3,3,Sun,L 20-23,OT,11,65,9,108,20,173
653,MIA,2016,2016-11-13,4:05,1:05,@,SDG,10,9,Sun,W 31-24,,11,81,4,29,15,110
654,MIA,2017,2017-10-01,9:30,2:30,,NOR,4,3,Sun,L 0-20,,11,90,8,71,19,161
655,MIA,2017,2017-11-05,8:30,8:30,,OAK,9,8,Sun,L 24-27,,11,107,10,105,21,212
656,MIA,2017,2017-12-24,1:00,12:00,@,KAN,16,15,Sun,L 13-29,,11,75,5,40,16,115
657,MIA,2021,2021-11-11,8:20,8:20,,BAL,10,10,Thu,W 22-10,,11,97,4,20,15,117
658,MIN,2000,2000-11-06,9:09,8:09,@,GNB,10,9,Mon,L 20-26,OT,11,129,8,63,19,192
659,MIN,2001,2001-11-25,8:35,7:35,,CHI,11,10,Sun,L 6-13,,11,75,2,15,13,90
660,MIN,2002,2002-10-27,1:00,12:00,,CHI,8,7,Sun,W 25-7,,11,65,6,33,17,98
661,MIN,2003,2003-09-21,1:03,1:03,@,DET,3,3,Sun,W 23-13,,11,125,9,56,20,181
662,MIN,2003,2003-11-23,1:00,12:00,,DET,12,11,Sun,W 24-14,,11,95,5,50,16,145
663,MIN,2003,2003-11-30,1:02,12:02,@,STL,13,12,Sun,L 17-48,,11,65,4,25,15,90
664,MIN,2004,2004-09-26,1:00,12:00,,CHI,3,3,Sun,W 27-22,,11,70,14,101,25,171
665,MIN,2005,2005-10-02,4:17,4:17,@,ATL,4,4,Sun,L 10-30,,11,84,8,65,19,149
666,MIN,2005,2005-12-04,1:02,1:02,@,DET,13,12,Sun,W 21-16,,11,94,3,30,14,124
667,MIN,2007,2007-11-04,1:05,12:05,,SDG,9,8,Sun,W 35-17,,11,81,10,67,21,148
668,MIN,2009,2009-10-25,1:03,1:03,@,PIT,7,7,Sun,L 17-27,,11,78,3,15,14,93
669,MIN,2010,2010-11-07,1:05,12:05,,ARI,9,8,Sun,W 27-24,OT,11,65,7,39,18,104
670,MIN,2012,2012-09-16,1:03,1:03,@,IND,2,2,Sun,L 20-23,,11,105,7,51,18,156
671,MIN,2017,2017-09-17,1:00,1:00,@,PIT,2,2,Sun,L 9-26,,11,131,10,72,21,203
672,MIN,2017,2017-12-17,1:00,3:00,,CIN,15,14,Sun,W 34-7,,11,93,5,44,16,137
673,MIN,2018,2018-12-23,1:00,1:00,@,DET,16,15,Sun,W 27-9,,11,78,7,55,18,133
674,MIN,2019,2019-09-08,1:00,3:00,,ATL,1,1,Sun,W 28-12,,11,100,9,78,20,178
675,MIN,2021,2021-10-17,1:00,1:00,@,CAR,6,6,Sun,W 34-28,OT,11,98,6,28,17,126
676,MIN,2021,2021-12-09,8:20,6:20,,PIT,14,13,Thu,W 36-28,,11,102,10,85,21,187
677,NOR,2002,2002-11-10,1:02,1:02,@,CAR,10,9,Sun,W 34-24,,11,63,7,57,18,120
678,NOR,2003,2003-09-07,4:18,1:18,@,SEA,1,1,Sun,L 10-27,,11,114,3,20,14,134
679,NOR,2005,2005-10-09,1:02,12:02,@,GNB,5,5,Sun,L 3-52,,11,107,6,36,17,143
680,NOR,2005,2005-11-20,1:02,1:02,@,NWE,11,10,Sun,L 17-24,,11,99,5,50,16,149
681,NOR,2008,2008-10-06,8:40,7:40,,MIN,5,5,Mon,L 27-30,,11,102,7,60,18,162
682,NOR,2010,2010-12-05,1:03,1:03,@,CIN,13,12,Sun,W 34-30,,11,100,7,43,18,143
683,NOR,2011,2011-11-28,8:40,7:40,,NYG,12,11,Mon,W 49-24,,11,104,4,32,15,136
684,NOR,2011,2011-12-11,1:03,12:03,@,TEN,14,13,Sun,W 22-17,,11,95,8,54,19,149
685,NOR,2012,2012-11-18,4:05,1:05,@,OAK,11,10,Sun,W 38-17,,11,109,4,40,15,149
686,NOR,2014,2014-11-30,1:02,1:02,@,PIT,13,12,Sun,W 35-32,,11,77,5,28,16,105
687,NOR,2015,2015-12-06,4:25,3:25,,CAR,13,12,Sun,L 38-41,,11,104,8,87,19,191
688,NOR,2017,2017-12-07,8:25,8:25,@,ATL,14,13,Thu,L 17-20,,11,87,4,35,15,122
689,NOR,2018,2018-09-23,1:00,1:00,@,ATL,3,3,Sun,W 43-37,OT,11,120,5,54,16,174
690,NOR,2019,2019-09-15,4:25,1:25,@,LAR,2,2,Sun,L 9-27,,11,87,8,65,19,152
691,NOR,2019,2019-09-22,4:25,1:25,@,SEA,3,3,Sun,W 33-27,,11,70,7,53,18,123
692,NOR,2019,2019-12-22,1:00,12:00,@,TEN,16,15,Sun,W 38-28,,11,70,6,56,17,126
693,NOR,2021,2021-09-19,1:00,1:00,@,CAR,2,2,Sun,L 7-26,,11,115,5,49,16,164
694,NWE,2005,2005-10-09,1:05,1:05,@,ATL,5,5,Sun,W 31-28,,11,83,8,84,19,167
695,NWE,2009,2009-09-20,1:02,1:02,@,NYJ,2,2,Sun,L 9-16,,11,89,8,55,19,144
696,NWE,2014,2014-11-23,1:02,1:02,,DET,12,11,Sun,W 34-9,,11,89,9,54,20,143
697,NWE,2015,2015-09-20,1:02,1:02,@,BUF,2,2,Sun,W 40-32,,11,119,14,140,25,259
698,NWE,2018,2018-11-25,1:00,1:00,@,NYJ,12,11,Sun,W 27-13,,11,105,8,47,19,152
699,NYG,2001,2001-09-30,1:06,1:06,,NOR,3,3,Sun,W 21-13,,11,100,14,92,25,192
700,NYG,2003,2003-11-16,1:01,1:01,@,PHI,11,10,Sun,L 10-28,,11,113,7,49,18,162
701,NYG,2005,2005-10-02,1:03,1:03,,STL,4,4,Sun,W 44-24,,11,90,11,103,22,193
702,NYG,2008,2008-10-19,1:02,1:02,,SFO,7,6,Sun,W 29-17,,11,80,13,134,24,214
703,NYG,2010,2010-09-26,1:02,1:02,,TEN,3,3,Sun,L 10-29,,11,86,8,80,19,166
704,NYG,2013,2013-10-27,1:02,1:02,@,PHI,8,8,Sun,W 15-7,,11,92,4,48,15,140
705,NYG,2013,2013-11-24,4:25,4:25,,DAL,12,11,Sun,L 21-24,,11,81,11,85,22,166
706,NYG,2015,2015-10-04,1:02,1:02,@,BUF,4,4,Sun,W 24-10,,11,85,17,135,28,220
707,NYG,2016,2016-09-25,1:02,1:02,,WAS,3,3,Sun,L 27-29,,11,128,8,70,19,198
708,NYG,2018,2018-10-28,1:00,1:00,,WAS,8,8,Sun,L 13-20,,11,102,8,90,19,192
709,NYG,2018,2018-11-25,1:00,1:00,@,PHI,12,11,Sun,L 22-25,,11,91,7,46,18,137
710,NYG,2018,2018-12-30,1:00,1:00,,DAL,17,16,Sun,L 35-36,,11,78,6,46,17,124
711,NYG,2021,2021-09-16,8:20,8:20,@,WAS,2,2,Thu,L 29-30,,11,81,9,80,20,161
712,NYJ,2010,2010-11-07,1:03,1:03,@,DET,9,8,Sun,W 23-20,OT,11,99,11,102,22,201
713,NYJ,2011,2011-12-18,4:16,4:16,@,PHI,15,14,Sun,L 19-45,,11,93,7,62,18,155
714,NYJ,2014,2014-09-07,1:02,1:02,,OAK,1,1,Sun,W 19-14,,11,105,4,20,15,125
715,NYJ,2018,2018-12-02,4:05,3:05,@,TEN,13,12,Sun,L 22-26,,11,96,8,75,19,171
716,NYJ,2020,2020-10-01,8:20,8:20,,DEN,4,4,Thu,L 28-37,,11,118,8,94,19,212
717,TEN,2001,2001-11-18,1:02,1:02,@,CIN,10,9,Sun,W 20-7,,11,93,8,70,19,163
718,TEN,2001,2002-01-06,1:03,12:03,,CIN,17,16,Sun,L 21-23,,11,95,5,90,16,185
719,TEN,2002,2002-09-29,4:15,1:15,@,OAK,4,4,Sun,L 25-52,,11,77,10,117,21,194
720,TEN,2003,2003-09-07,8:51,7:51,,OAK,1,1,Sun,W 25-20,,11,111,17,173,28,284
721,TEN,2005,2005-09-25,1:02,12:02,@,STL,3,3,Sun,L 27-31,,11,80,11,75,22,155
722,TEN,2005,2005-10-23,4:15,1:15,@,ARI,7,7,Sun,L 10-20,,11,90,9,71,20,161
723,TEN,2005,2005-11-20,1:02,12:02,,JAX,11,10,Sun,L 28-31,,11,73,3,15,14,88
724,TEN,2006,2006-12-24,1:02,1:02,@,BUF,16,15,Sun,W 30-29,,11,81,5,50,16,131
725,TEN,2010,2010-09-19,1:02,12:02,,PIT,2,2,Sun,L 11-19,,11,72,5,35,16,107
726,TEN,2010,2010-11-21,1:03,12:03,,WAS,11,10,Sun,L 16-19,OT,11,81,3,20,14,101
727,TEN,2011,2011-09-25,1:02,12:02,,DEN,3,3,Sun,W 17-14,,11,80,1,15,12,95
728,TEN,2013,2013-09-22,1:03,12:03,,SDG,3,3,Sun,W 20-17,,11,116,5,45,16,161
729,TEN,2014,2014-09-21,1:02,1:02,@,CIN,3,3,Sun,L 7-33,,11,99,7,50,18,149
730,TEN,2014,2014-10-19,1:02,1:02,@,WAS,7,7,Sun,L 17-19,,11,96,7,50,18,146
731,TEN,2016,2016-10-02,1:02,12:02,@,HOU,4,4,Sun,L 20-27,,11,93,6,59,17,152
732,TEN,2016,2016-11-20,1:00,1:00,@,IND,11,11,Sun,L 17-24,,11,109,8,70,19,179
733,TEN,2017,2017-10-08,1:00,1:00,@,MIA,5,5,Sun,L 10-16,,11,77,5,23,16,100
734,TEN,2019,2019-11-03,1:00,1:00,@,CAR,9,9,Sun,L 20-30,,11,99,6,77,17,176
735,TEN,2021,2021-10-31,1:00,1:00,@,IND,8,8,Sun,W 34-31,OT,11,161,9,75,20,236
736,PHI,2000,2000-11-26,1:01,1:01,@,WAS,13,13,Sun,W 23-20,,11,98,6,46,17,144
737,PHI,2001,2001-11-04,4:05,2:05,@,ARI,8,7,Sun,W 21-7,,11,92,1,9,12,101
738,PHI,2001,2001-12-22,5:15,2:15,@,SFO,15,14,Sat,L 3-13,,11,109,3,15,14,124
739,PHI,2001,2002-01-06,8:30,8:30,@,TAM,17,16,Sun,W 17-13,,11,95,1,10,12,105
740,PHI,2002,2002-12-15,1:02,1:02,,WAS,15,14,Sun,W 34-21,,11,91,9,73,20,164
741,PHI,2003,2003-11-02,4:15,4:15,@,ATL,9,8,Sun,W 23-16,,11,90,8,61,19,151
742,PHI,2004,2004-10-24,1:03,1:03,@,CLE,7,6,Sun,W 34-31,OT,11,101,10,80,21,181
743,PHI,2006,2006-12-31,4:13,4:13,,ATL,17,16,Sun,W 24-17,,11,108,9,99,20,207
744,PHI,2010,2010-12-02,8:30,8:30,,HOU,13,12,Thu,W 34-24,,11,85,4,25,15,110
745,PHI,2011,2011-11-13,1:02,1:02,,ARI,10,9,Sun,L 17-21,,11,97,7,66,18,163
746,PHI,2014,2014-09-15,8:31,8:31,@,IND,2,2,Mon,W 30-27,,11,90,4,70,15,160
747,PHI,2014,2014-10-26,4:05,1:05,@,ARI,8,7,Sun,L 20-24,,11,103,10,95,21,198
748,PHI,2017,2017-11-26,1:00,1:00,,CHI,12,11,Sun,W 31-3,,11,70,9,56,20,126
749,PHI,2018,2018-09-06,8:20,8:20,,ATL,1,1,Thu,W 18-12,,11,101,15,135,26,236
750,PHI,2018,2018-12-23,1:00,1:00,,HOU,16,15,Sun,W 32-30,,11,105,10,61,21,166
751,PHI,2020,2020-09-27,1:00,1:00,,CIN,3,3,Sun,T 23-23,OT,11,93,9,73,20,166
752,PHI,2020,2020-11-15,1:00,1:00,@,NYG,10,9,Sun,L 17-27,,11,74,7,64,18,138
753,PHI,2021,2021-12-26,1:00,1:00,,NYG,16,15,Sun,W 34-10,,11,79,6,40,17,119
754,PIT,2003,2003-11-02,4:06,1:06,@,SEA,9,8,Sun,L 16-23,,11,76,5,35,16,111
755,PIT,2004,2004-09-26,8:36,8:36,@,MIA,3,3,Sun,W 13-3,,11,103,6,33,17,136
756,PIT,2004,2004-12-05,8:35,8:35,@,JAX,13,12,Sun,W 17-16,,11,82,3,25,14,107
757,PIT,2005,2005-10-10,9:00,6:00,@,SDG,5,4,Mon,W 24-22,,11,104,9,100,20,204
758,PIT,2007,2007-09-30,4:15,1:15,@,ARI,4,4,Sun,L 14-21,,11,72,5,30,16,102
759,PIT,2010,2010-10-03,1:02,1:02,,BAL,4,4,Sun,L 14-17,,11,88,7,52,18,140
760,PIT,2014,2014-09-07,1:02,1:02,,CLE,1,1,Sun,W 30-27,,11,96,8,55,19,151
761,PIT,2014,2014-09-21,8:31,8:31,@,CAR,3,3,Sun,W 37-19,,11,91,7,105,18,196
762,PIT,2019,2019-10-06,1:00,1:00,,BAL,5,5,Sun,L 23-26,OT,11,76,11,92,22,168
763,OAK,2001,2001-11-05,9:05,6:05,,DEN,8,7,Mon,W 38-28,,11,93,7,71,18,164
764,OAK,2003,2003-11-30,4:15,1:15,,DEN,13,12,Sun,L 8-22,,11,89,6,45,17,134
765,OAK,2004,2004-09-26,8:35,5:35,,TAM,3,3,Sun,W 30-20,,11,74,8,56,19,130
766,OAK,2007,2007-12-23,1:02,1:02,@,JAX,16,15,Sun,L 11-49,,11,88,6,42,17,130
767,OAK,2010,2010-09-26,4:15,1:15,@,ARI,3,3,Sun,L 23-24,,11,123,7,104,18,227
768,OAK,2010,2010-10-31,4:15,1:15,,SEA,8,8,Sun,W 33-3,,11,105,7,55,18,160
769,OAK,2011,2011-10-09,1:02,12:02,@,HOU,5,5,Sun,W 25-20,,11,89,6,50,17,139
770,OAK,2011,2011-12-11,4:15,3:15,@,GNB,14,13,Sun,L 16-46,,11,89,5,35,16,124
771,OAK,2012,2012-12-06,8:30,5:30,,DEN,14,13,Thu,L 13-26,,11,94,3,25,14,119
772,OAK,2013,2013-10-13,1:02,12:02,@,KAN,6,6,Sun,L 7-24,,11,68,4,20,15,88
773,OAK,2014,2014-10-12,4:05,1:05,,SDG,6,5,Sun,L 28-31,,11,78,7,60,18,138
774,OAK,2015,2015-11-29,1:02,12:02,@,TEN,12,11,Sun,W 24-21,,11,94,4,25,15,119
775,OAK,2016,2016-10-23,1:02,1:02,@,JAX,7,7,Sun,W 33-16,,11,117,13,122,24,239
776,OAK,2018,2018-09-10,10:20,7:20,,LAR,1,1,Mon,L 13-33,,11,155,8,70,19,225
777,OAK,2019,2019-09-29,1:00,1:00,@,IND,4,4,Sun,W 31-24,,11,80,5,35,16,115
778,OAK,2019,2019-10-27,4:25,3:25,@,HOU,8,7,Sun,L 24-27,,11,100,7,50,18,150
779,LVR,2020,2020-11-29,1:00,1:00,@,ATL,12,11,Sun,L 6-43,,11,141,6,49,17,190
780,STL,2000,2000-10-15,1:02,12:02,,ATL,7,6,Sun,W 45-29,,11,96,8,40,19,136
781,STL,2000,2000-10-29,4:05,1:05,@,SFO,9,8,Sun,W 34-24,,11,90,8,80,19,170
782,STL,2001,2001-12-17,9:09,8:09,@,NOR,14,13,Mon,W 34-21,,11,85,16,132,27,217
783,STL,2002,2002-10-13,4:15,3:15,,OAK,6,6,Sun,W 28-13,,11,82,14,107,25,189
784,STL,2002,2002-11-18,9:07,8:07,,CHI,11,10,Mon,W 21-16,,11,97,5,50,16,147
785,STL,2004,2004-11-21,1:02,1:02,@,BUF,11,10,Sun,L 17-37,,11,84,15,123,26,207
786,STL,2005,2005-09-25,1:02,12:02,,TEN,3,3,Sun,W 31-27,,11,75,11,80,22,155
787,STL,2005,2005-10-02,1:03,1:03,@,NYG,4,4,Sun,L 24-44,,11,103,11,90,22,193
788,STL,2006,2006-12-11,8:30,7:30,,CHI,14,13,Mon,L 27-42,,11,91,11,86,22,177
789,STL,2008,2008-11-23,1:00,12:00,,CHI,12,11,Sun,L 3-27,,11,85,3,14,14,99
790,STL,2013,2013-12-01,4:05,1:05,@,SFO,13,12,Sun,L 13-23,,11,105,9,85,20,190
791,STL,2013,2013-12-08,4:25,2:25,@,ARI,14,13,Sun,L 10-30,,11,90,6,31,17,121
792,STL,2014,2014-12-07,1:03,1:03,@,WAS,14,13,Sun,W 24-0,,11,98,5,51,16,149
793,STL,2015,2016-01-03,4:25,1:25,@,SFO,17,16,Sun,L 16-19,OT,11,105,7,60,18,165
794,LAR,2016,2016-12-11,4:25,1:25,,ATL,14,13,Sun,L 14-42,,11,105,5,40,16,145
795,BAL,2005,2005-10-16,1:02,1:02,,CLE,6,5,Sun,W 16-3,,11,97,8,53,19,150
796,BAL,2005,2005-10-23,4:15,3:15,@,CHI,7,6,Sun,L 6-10,,11,100,9,60,20,160
797,BAL,2005,2005-11-20,1:02,1:02,,PIT,11,10,Sun,W 16-13,OT,11,70,10,62,21,132
798,BAL,2007,2007-09-16,4:15,4:15,,NYJ,2,2,Sun,W 20-13,,11,100,2,10,13,110
799,BAL,2007,2007-10-21,1:02,1:02,@,BUF,7,7,Sun,L 14-19,,11,91,3,25,14,116
800,BAL,2007,2007-11-05,8:38,8:38,@,PIT,9,8,Mon,L 7-38,,11,85,5,49,16,134
801,BAL,2008,2008-10-05,1:02,1:02,,TEN,5,4,Sun,L 10-13,,11,91,10,78,21,169
802,BAL,2009,2009-12-27,1:02,1:02,@,PIT,16,15,Sun,L 20-23,,11,113,4,20,15,133
803,BAL,2011,2011-10-30,1:02,1:02,,ARI,8,7,Sun,W 30-27,,11,99,12,92,23,191
804,BAL,2012,2012-09-27,8:30,8:30,,CLE,4,4,Thu,W 23-16,,11,100,7,66,18,166
805,BAL,2017,2017-09-10,1:00,1:00,@,CIN,1,1,Sun,W 20-0,,11,85,9,66,20,151
806,BAL,2018,2018-12-09,1:00,12:00,@,KAN,14,13,Sun,L 24-27,OT,11,112,7,53,18,165
807,BAL,2019,2019-10-06,1:00,1:00,@,PIT,5,5,Sun,W 26-23,OT,11,92,11,76,22,168
808,SDG,2000,2000-10-29,8:35,5:35,,OAK,9,8,Sun,L 13-15,,11,88,8,50,19,138
809,SDG,2001,2001-10-14,1:03,1:03,@,NWE,5,5,Sun,L 26-29,OT,11,93,7,51,18,144
810,SDG,2003,2003-09-14,4:15,1:15,,DEN,2,2,Sun,L 13-37,,11,96,10,81,21,177
811,SDG,2003,2003-12-07,1:03,1:03,@,DET,14,13,Sun,W 14-7,,11,95,8,71,19,166
812,SDG,2004,2004-10-17,1:02,1:02,@,ATL,6,6,Sun,L 20-21,,11,69,4,26,15,95
813,SDG,2004,2004-12-05,4:05,1:05,,DEN,13,12,Sun,W 20-17,,11,94,8,57,19,151
814,SDG,2005,2005-12-18,1:02,1:02,@,IND,15,14,Sun,W 26-17,,11,75,8,67,19,142
815,SDG,2010,2010-09-26,4:16,1:16,@,SEA,3,3,Sun,L 20-27,,11,83,5,32,16,115
816,LAC,2017,2017-10-08,1:00,1:00,@,NYG,5,5,Sun,W 27-22,,11,87,10,67,21,154
817,SEA,2008,2008-12-28,4:15,2:15,@,ARI,17,16,Sun,L 21-34,,11,82,10,100,21,182
818,SEA,2011,2011-09-11,4:22,1:22,@,SFO,1,1,Sun,L 17-33,,11,72,9,102,20,174
819,SEA,2011,2011-10-30,4:16,1:16,,CIN,8,7,Sun,L 12-34,,11,80,7,65,18,145
820,SEA,2014,2014-12-21,8:30,6:30,@,ARI,16,15,Sun,W 35-6,,11,97,1,5,12,102
821,SEA,2016,2016-10-30,1:03,12:03,@,NOR,8,7,Sun,L 20-25,,11,76,2,10,13,86
822,SEA,2017,2017-09-24,4:05,3:05,@,TEN,3,3,Sun,L 27-33,,11,98,5,45,16,143
823,SEA,2017,2017-12-24,4:25,3:25,@,DAL,16,15,Sun,W 21-12,,11,142,7,75,18,217
824,SFO,2000,2000-12-23,4:17,2:17,@,DEN,17,16,Sat,L 9-38,,11,110,8,90,19,200
825,SFO,2004,2004-10-10,4:15,1:15,,ARI,5,5,Sun,W 31-28,OT,11,85,8,60,19,145
826,SFO,2009,2009-10-25,1:04,12:04,@,HOU,7,6,Sun,L 21-24,,11,65,7,77,18,142
827,SFO,2010,2010-10-17,4:05,1:05,,OAK,6,6,Sun,W 17-9,,11,143,8,60,19,203
828,SFO,2010,2010-10-24,1:03,1:03,@,CAR,7,7,Sun,L 20-23,,11,81,4,35,15,116
829,SFO,2012,2012-12-02,1:00,12:00,@,STL,13,12,Sun,L 13-16,OT,11,97,8,65,19,162
830,SFO,2013,2013-09-08,4:26,1:26,,GNB,1,1,Sun,W 34-28,,11,85,5,44,16,129
831,SFO,2014,2014-09-07,4:25,3:25,@,DAL,1,1,Sun,W 28-17,,11,78,10,72,21,150
832,SFO,2015,2015-12-20,4:25,1:25,,CIN,15,14,Sun,L 14-24,,11,98,6,45,17,143
833,SFO,2015,2015-12-27,1:03,1:03,@,DET,16,15,Sun,L 17-32,,11,65,7,71,18,136
834,SFO,2016,2016-12-04,1:00,12:00,@,CHI,13,12,Sun,L 6-26,,11,106,5,40,16,146
835,SFO,2016,2016-12-24,4:25,1:25,@,LAR,16,15,Sat,W 22-21,,11,100,5,45,16,145
836,SFO,2017,2017-12-10,1:00,12:00,@,HOU,14,13,Sun,W 26-16,,11,87,8,81,19,168
837,SFO,2018,2018-12-09,4:05,1:05,,DEN,14,13,Sun,W 20-14,,11,87,11,62,22,149
838,SFO,2019,2019-09-08,4:25,4:25,@,TAM,1,1,Sun,W 31-17,,11,87,8,87,19,174
839,TAM,2003,2003-10-06,9:15,9:15,,IND,5,4,Mon,L 35-38,OT,11,111,11,80,22,191
840,TAM,2004,2004-10-10,1:03,12:03,@,NOR,5,5,Sun,W 20-17,,11,65,8,60,19,125
841,TAM,2008,2008-09-14,4:05,4:05,,ATL,2,2,Sun,W 24-9,,11,94,8,60,19,154
842,TAM,2008,2008-12-14,1:03,1:03,@,ATL,15,14,Sun,L 10-13,OT,11,76,3,20,14,96
843,TAM,2012,2012-12-02,4:05,2:05,@,DEN,13,12,Sun,L 23-31,,11,80,8,75,19,155
844,TAM,2013,2013-10-20,1:02,1:02,@,ATL,7,6,Sun,L 23-31,,11,103,9,101,20,204
845,TAM,2013,2013-11-17,1:03,1:03,,ATL,11,10,Sun,W 41-28,,11,121,7,45,18,166
846,TAM,2014,2014-09-18,8:26,8:26,@,ATL,3,3,Thu,L 14-56,,11,110,5,50,16,160
847,TAM,2014,2014-11-16,1:03,1:03,@,WAS,11,10,Sun,W 27-7,,11,101,9,67,20,168
848,TAM,2015,2015-09-20,1:02,12:02,@,NOR,2,2,Sun,W 26-19,,11,90,10,115,21,205
849,TAM,2016,2016-11-03,8:25,8:25,,ATL,9,8,Thu,L 28-43,,11,85,6,34,17,119
850,TAM,2018,2018-09-30,1:00,12:00,@,CHI,4,4,Sun,L 10-48,,11,99,4,38,15,137
851,TAM,2018,2018-10-28,1:00,1:00,@,CIN,8,7,Sun,L 34-37,,11,75,4,46,15,121
852,TAM,2020,2020-10-08,8:20,7:20,@,CHI,5,5,Thu,L 19-20,,11,109,6,66,17,175
853,TAM,2021,2021-09-09,8:20,8:20,,DAL,1,1,Thu,W 31-29,,11,106,8,55,19,161
854,TAM,2021,2021-10-31,4:25,3:25,@,NOR,8,8,Sun,L 27-36,,11,99,2,10,13,109
855,WAS,2000,2000-12-10,4:15,3:15,@,DAL,15,14,Sun,L 13-32,,11,121,6,35,17,156
856,WAS,2001,2001-10-28,4:05,4:05,,NYG,7,7,Sun,W 35-21,,11,76,5,43,16,119
857,WAS,2002,2002-10-13,1:01,1:01,,NOR,6,5,Sun,L 27-43,,11,87,12,90,23,177
858,WAS,2002,2002-10-20,4:15,3:15,@,GNB,7,6,Sun,L 9-30,,11,129,11,95,22,224
859,WAS,2003,2003-10-05,4:15,4:15,@,PHI,5,5,Sun,L 25-27,,11,85,7,86,18,171
860,WAS,2004,2004-12-18,5:16,2:16,@,SFO,15,14,Sat,W 26-16,,11,93,5,45,16,138
861,WAS,2006,2006-09-17,8:20,7:20,@,DAL,2,2,Sun,L 10-27,,11,117,9,90,20,207
862,WAS,2006,2006-12-10,1:03,1:03,,PHI,14,13,Sun,L 19-21,,11,68,2,20,13,88
863,WAS,2007,2007-11-11,1:03,1:03,,PHI,10,9,Sun,L 25-33,,11,74,5,38,16,112
864,WAS,2012,2012-09-16,4:05,3:05,@,STL,2,2,Sun,L 28-31,,11,96,7,60,18,156
865,WAS,2014,2014-09-14,1:05,1:05,,JAX,2,2,Sun,W 41-10,,11,98,6,44,17,142
866,WAS,2014,2014-09-25,8:26,8:26,,NYG,4,4,Thu,L 14-45,,11,88,7,66,18,154
867,WAS,2015,2015-09-13,1:02,1:02,,MIA,1,1,Sun,L 10-17,,11,88,6,39,17,127
868,WAS,2019,2019-11-17,1:00,1:00,,NYJ,11,10,Sun,L 17-34,,11,66,6,55,17,121
869,ATL,2000,2000-09-10,4:16,2:16,@,DEN,2,2,Sun,L 14-42,,10,71,7,54,17,125
870,ATL,2000,2000-11-12,1:01,1:01,@,DET,11,11,Sun,L 10-13,,10,82,9,70,19,152
871,ATL,2000,2000-11-26,4:05,1:05,@,OAK,13,13,Sun,L 14-41,,10,55,12,108,22,163
872,ATL,2001,2001-12-09,1:05,1:05,,NOR,13,12,Sun,L 10-28,,10,83,10,67,20,150
873,ATL,2002,2002-10-27,1:03,12:03,@,NOR,8,7,Sun,W 37-35,,10,95,9,96,19,191
874,ATL,2005,2005-10-16,1:03,12:03,@,NOR,6,6,Sun,W 34-31,,10,79,8,55,18,134
875,ATL,2007,2007-09-23,4:15,4:15,,CAR,3,3,Sun,L 20-27,,10,135,3,45,13,180
876,ATL,2007,2007-12-23,4:05,2:05,@,ARI,16,15,Sun,L 27-30,OT,10,74,4,57,14,131
877,ATL,2011,2011-11-13,1:03,1:03,,NOR,10,9,Sun,L 23-26,OT,10,85,8,79,18,164
878,ATL,2013,2013-10-27,4:25,1:25,@,ARI,8,7,Sun,L 13-27,,10,55,8,52,18,107
879,ATL,2014,2014-09-07,1:03,1:03,,NOR,1,1,Sun,W 37-34,OT,10,96,3,27,13,123
880,ATL,2015,2015-10-04,1:02,1:02,,HOU,4,4,Sun,W 48-21,,10,80,5,35,15,115
881,ATL,2017,2017-12-24,1:00,12:00,@,NOR,16,15,Sun,L 13-23,,10,91,3,30,13,121
882,ATL,2018,2018-09-30,1:00,1:00,,CIN,4,4,Sun,L 36-37,,10,95,6,55,16,150
883,ATL,2019,2019-09-15,8:20,8:20,,PHI,2,2,Sun,W 24-20,,10,58,7,60,17,118
884,BUF,2000,2000-10-15,1:01,1:01,,SDG,7,6,Sun,W 27-24,OT,10,103,12,88,22,191
885,BUF,2000,2000-12-11,9:00,9:00,@,IND,15,14,Mon,L 20-44,,10,106,7,67,17,173
886,BUF,2001,2001-11-25,1:02,1:02,,MIA,11,10,Sun,L 27-34,,10,71,8,62,18,133
887,BUF,2002,2002-09-08,1:04,1:04,,NYJ,1,1,Sun,L 31-37,OT,10,82,10,90,20,172
888,BUF,2002,2002-09-22,4:05,2:05,@,DEN,3,3,Sun,L 23-28,,10,82,9,64,19,146
889,BUF,2003,2003-09-07,1:04,1:04,,NWE,1,1,Sun,W 31-0,,10,119,12,121,22,240
890,BUF,2003,2003-09-28,1:02,1:02,,PHI,4,4,Sun,L 13-23,,10,84,7,45,17,129
891,BUF,2003,2003-12-27,1:35,1:35,@,NWE,17,16,Sat,L 0-31,,10,71,4,34,14,105
892,BUF,2005,2005-09-11,1:05,1:05,,HOU,1,1,Sun,W 22-7,,10,71,6,38,16,109
893,BUF,2009,2009-11-15,1:02,12:02,@,TEN,10,9,Sun,L 17-41,,10,65,8,75,18,140
894,BUF,2009,2009-12-27,1:02,1:02,@,ATL,16,15,Sun,L 3-31,,10,60,6,70,16,130
895,BUF,2010,2010-11-21,1:02,1:02,@,CIN,11,10,Sun,W 49-31,,10,58,7,57,17,115
896,BUF,2012,2012-09-23,1:02,1:02,@,CLE,3,3,Sun,W 24-14,,10,75,6,57,16,132
897,BUF,2013,2013-09-08,1:02,1:02,,NWE,1,1,Sun,L 21-23,,10,75,4,36,14,111
898,BUF,2014,2014-12-14,1:02,1:02,,GNB,15,14,Sun,W 21-13,,10,75,9,70,19,145
899,BUF,2015,2015-10-25,8:35,1:35,@,JAX,7,7,Sun,L 31-34,,10,87,10,66,20,153
900,BUF,2018,2018-09-09,1:00,1:00,@,BAL,1,1,Sun,L 3-47,,10,100,9,78,19,178
901,BUF,2018,2018-11-04,1:00,1:00,,CHI,9,9,Sun,L 9-41,,10,163,14,129,24,292
902,BUF,2020,2020-10-13,7:00,6:00,@,TEN,5,5,Tue,L 16-42,,10,56,6,46,16,102
903,BUF,2021,2021-10-10,8:20,7:20,@,KAN,5,5,Sun,W 38-20,,10,103,7,55,17,158
904,CAR,2002,2002-12-08,1:02,1:02,,CIN,14,13,Sun,W 52-31,,10,91,5,39,15,130
905,CAR,2003,2003-12-07,8:37,8:37,@,ATL,14,13,Sun,L 14-20,OT,10,75,7,42,17,117
906,CAR,2004,2004-10-03,4:05,4:05,,ATL,4,3,Sun,L 10-27,,10,91,11,106,21,197
907,CAR,2004,2004-10-31,4:06,1:06,@,SEA,8,7,Sun,L 17-23,,10,79,2,13,12,92
908,CAR,2005,2005-10-16,1:02,1:02,@,DET,6,6,Sun,W 21-20,,10,73,10,75,20,148
909,CAR,2007,2007-11-04,1:02,12:02,@,TEN,9,8,Sun,L 7-20,,10,92,10,89,20,181
910,CAR,2008,2008-09-14,1:03,1:03,,CHI,2,2,Sun,W 20-17,,10,65,12,86,22,151
911,CAR,2010,2010-11-07,1:04,1:04,,NOR,9,8,Sun,L 3-34,,10,65,7,64,17,129
912,CAR,2010,2011-01-02,1:03,1:03,@,ATL,17,16,Sun,L 10-31,,10,97,4,20,14,117
913,CAR,2011,2011-09-11,4:15,1:15,@,ARI,1,1,Sun,L 21-28,,10,74,6,61,16,135
914,CAR,2012,2012-12-23,1:04,1:04,,OAK,16,15,Sun,W 17-6,,10,97,6,70,16,167
915,CAR,2015,2015-09-20,1:02,1:02,,HOU,2,2,Sun,W 24-17,,10,92,10,70,20,162
916,CAR,2015,2015-09-27,1:03,1:03,,NOR,3,3,Sun,W 27-22,,10,88,8,55,18,143
917,CAR,2016,2016-09-25,1:02,1:02,,MIN,3,3,Sun,L 10-22,,10,65,6,42,16,107
918,CAR,2017,2017-11-26,1:00,1:00,@,NYJ,12,11,Sun,W 35-27,,10,84,7,68,17,152
919,CAR,2018,2018-12-09,1:00,1:00,@,CLE,14,13,Sun,L 20-26,,10,68,7,52,17,120
920,CAR,2018,2018-12-23,1:00,1:00,,ATL,16,15,Sun,L 10-24,,10,86,4,41,14,127
921,CAR,2020,2020-10-04,1:00,1:00,,ARI,4,4,Sun,W 31-21,,10,72,5,29,15,101
922,CAR,2021,2021-11-07,1:00,1:00,,NWE,9,9,Sun,L 6-24,,10,83,6,35,16,118
923,CHI,2004,2004-10-24,1:02,1:02,@,TAM,7,6,Sun,L 7-19,,10,78,6,41,16,119
924,CHI,2005,2005-10-30,1:04,1:04,@,DET,8,7,Sun,W 19-13,OT,10,75,5,40,15,115
925,CHI,2006,2006-09-24,1:05,12:05,@,MIN,3,3,Sun,W 19-16,,10,82,8,83,18,165
926,CHI,2006,2006-11-19,1:04,1:04,@,NYJ,11,10,Sun,W 10-0,,10,65,6,40,16,105
927,CHI,2007,2007-12-02,4:15,3:15,,NYG,13,12,Sun,L 16-21,,10,71,2,10,12,81
928,CHI,2009,2009-09-20,4:15,3:15,,PIT,2,2,Sun,W 17-14,,10,80,6,52,16,132
929,CHI,2009,2009-11-12,8:20,5:20,@,SFO,10,9,Thu,L 6-10,,10,75,9,77,19,152
930,CHI,2011,2011-09-25,4:15,3:15,,GNB,3,3,Sun,L 17-27,,10,70,7,35,17,105
931,CHI,2012,2012-12-09,1:05,12:05,@,MIN,14,13,Sun,L 14-21,,10,80,7,54,17,134
932,CHI,2012,2012-12-16,1:03,12:03,,GNB,15,14,Sun,L 13-21,,10,91,8,104,18,195
933,CHI,2013,2013-11-24,1:00,12:00,@,STL,12,11,Sun,L 21-42,,10,84,6,39,16,123
934,CHI,2014,2014-09-14,8:31,5:31,@,SFO,2,2,Sun,W 28-20,,10,58,16,118,26,176
935,CHI,2014,2014-10-05,1:03,1:03,@,CAR,5,5,Sun,L 24-31,,10,79,3,30,13,109
936,CHI,2016,2016-10-09,1:02,1:02,@,IND,5,5,Sun,L 23-29,,10,80,9,68,19,148
937,CHI,2016,2016-10-16,1:02,12:02,,JAX,6,6,Sun,L 16-17,,10,87,5,50,15,137
938,CHI,2016,2016-10-20,8:26,7:26,@,GNB,7,7,Thu,L 10-26,,10,108,9,56,19,164
939,CHI,2017,2017-09-24,1:00,12:00,,PIT,3,3,Sun,W 23-17,OT,10,73,6,40,16,113
940,CHI,2017,2017-12-10,1:00,1:00,@,CIN,14,13,Sun,W 33-7,,10,74,7,56,17,130
941,CHI,2017,2017-12-31,1:00,3:00,@,MIN,17,16,Sun,L 10-23,,10,116,12,103,22,219
942,CHI,2019,2019-09-05,8:20,7:20,,GNB,1,1,Thu,L 3-10,,10,107,10,71,20,178
943,CHI,2019,2019-10-06,1:00,6:00,@,OAK,5,5,Sun,L 21-24,,10,75,6,69,16,144
944,CHI,2019,2019-11-28,12:30,12:30,@,DET,13,12,Thu,W 24-20,,10,89,9,85,19,174
945,CHI,2020,2020-09-27,1:00,1:00,@,ATL,3,3,Sun,W 30-26,,10,80,7,75,17,155
946,CHI,2020,2020-10-18,1:00,1:00,@,CAR,6,6,Sun,W 23-16,,10,92,8,69,18,161
947,CIN,2000,2000-10-01,4:05,4:05,,MIA,5,4,Sun,L 16-31,,10,123,8,61,18,184
948,CIN,2001,2001-10-14,1:02,1:02,,CLE,5,5,Sun,W 24-14,,10,74,9,92,19,166
949,CIN,2001,2001-11-11,1:03,1:03,@,JAX,9,8,Sun,L 13-30,,10,107,6,32,16,139
950,CIN,2002,2002-12-29,1:02,1:02,@,BUF,17,16,Sun,L 9-27,,10,105,7,71,17,176
951,CIN,2004,2004-10-17,1:03,1:03,@,CLE,6,5,Sun,L 17-34,,10,75,6,50,16,125
952,CIN,2004,2004-10-31,1:03,12:03,@,TEN,8,7,Sun,L 20-27,,10,64,7,58,17,122
953,CIN,2004,2004-11-21,1:03,1:03,,PIT,11,10,Sun,L 14-19,,10,97,8,56,18,153
954,CIN,2006,2006-10-15,1:02,1:02,@,TAM,6,5,Sun,L 13-14,,10,84,9,75,19,159
955,CIN,2007,2007-09-23,4:05,1:05,@,SEA,3,3,Sun,L 21-24,,10,72,3,20,13,92
956,CIN,2009,2009-11-29,1:02,1:02,,CLE,12,11,Sun,W 16-7,,10,75,4,30,14,105
957,CIN,2011,2011-12-04,1:02,1:02,@,PIT,13,12,Sun,L 7-35,,10,109,4,29,14,138
958,CIN,2013,2013-12-29,1:02,1:02,,BAL,17,16,Sun,W 34-17,,10,76,6,56,16,132
959,CIN,2014,2014-11-30,1:02,1:02,@,TAM,13,12,Sun,W 14-13,,10,73,13,94,23,167
960,CIN,2015,2015-11-01,1:02,1:02,@,PIT,8,7,Sun,W 16-10,,10,94,10,91,20,185
961,CIN,2015,2015-11-22,8:30,6:30,@,ARI,11,10,Sun,L 31-34,,10,108,7,40,17,148
962,CIN,2019,2019-12-22,1:00,1:00,@,MIA,16,15,Sun,L 35-38,OT,10,77,6,47,16,124
963,CIN,2021,2021-09-26,1:00,1:00,@,PIT,3,3,Sun,W 24-10,,10,89,10,73,20,162
964,CLE,2002,2002-12-08,1:03,1:03,@,JAX,14,13,Sun,W 21-20,,10,68,5,51,15,119
965,CLE,2004,2004-10-24,1:03,1:03,,PHI,7,7,Sun,L 31-34,OT,10,80,11,101,21,181
966,CLE,2007,2007-12-02,4:06,2:06,@,ARI,13,12,Sun,L 21-27,,10,77,11,75,21,152
967,CLE,2008,2008-09-14,8:23,8:23,,PIT,2,2,Sun,L 6-10,,10,65,7,60,17,125
968,CLE,2008,2008-10-13,8:41,8:41,,NYG,6,5,Mon,W 35-14,,10,55,5,38,15,93
969,CLE,2012,2012-09-16,1:02,1:02,@,CIN,2,2,Sun,L 27-34,,10,103,6,54,16,157
970,CLE,2012,2012-10-07,1:02,1:02,@,NYG,5,5,Sun,L 27-41,,10,91,3,25,13,116
971,CLE,2012,2012-11-25,1:02,1:02,,PIT,12,11,Sun,W 20-14,,10,90,9,68,19,158
972,CLE,2012,2012-12-23,4:05,2:05,@,DEN,16,15,Sun,L 12-34,,10,69,11,84,21,153
973,CLE,2014,2014-11-30,1:02,1:02,@,BUF,13,12,Sun,L 10-26,,10,76,6,45,16,121
974,CLE,2017,2017-09-24,1:00,1:00,@,IND,3,3,Sun,L 28-31,,10,113,11,99,21,212
975,CLE,2018,2018-10-07,1:00,1:00,,BAL,5,5,Sun,W 12-9,OT,10,66,4,41,14,107
976,CLE,2021,2021-11-07,1:00,1:00,@,CIN,9,9,Sun,W 41-16,,10,84,4,31,14,115
977,CLE,2021,2021-11-21,1:00,1:00,,DET,11,11,Sun,W 13-10,,10,82,7,67,17,149
978,CLE,2021,2022-01-03,8:15,8:15,@,PIT,17,16,Mon,L 14-26,,10,77,5,51,15,128
979,IND,2000,2000-11-26,4:15,4:15,,MIA,13,12,Sun,L 14-17,,10,78,4,30,14,108
980,IND,2004,2004-11-21,1:02,12:02,@,CHI,11,10,Sun,W 41-10,,10,91,9,50,19,141
981,IND,2004,2004-12-26,1:00,1:00,,SDG,16,15,Sun,W 34-31,OT,10,70,7,63,17,133
982,IND,2005,2005-10-09,4:05,1:05,@,SFO,5,5,Sun,W 28-3,,10,80,7,40,17,120
983,IND,2006,2006-10-01,1:02,1:02,@,NYJ,4,4,Sun,W 31-28,,10,64,5,47,15,111
984,IND,2011,2011-10-30,1:02,12:02,@,TEN,8,8,Sun,L 10-27,,10,66,3,40,13,106
985,IND,2014,2014-11-30,1:02,1:02,,WAS,13,12,Sun,W 49-27,,10,94,10,78,20,172
986,IND,2018,2018-09-30,1:00,1:00,,HOU,4,4,Sun,L 34-37,OT,10,85,10,54,20,139
987,IND,2018,2018-10-28,4:05,1:05,@,OAK,8,8,Sun,W 42-28,,10,77,10,79,20,156
988,IND,2019,2019-10-27,1:00,1:00,,DEN,8,7,Sun,W 15-13,,10,103,10,88,20,191
989,ARI,2002,2002-12-08,4:06,2:06,,DET,14,13,Sun,W 23-20,OT,10,92,7,75,17,167
990,ARI,2003,2003-09-28,1:02,12:02,@,STL,4,4,Sun,L 13-37,,10,92,5,35,15,127
991,ARI,2004,2005-01-02,4:06,2:06,,TAM,17,16,Sun,W 12-7,,10,70,8,63,18,133
992,ARI,2005,2005-09-11,4:18,4:18,@,NYG,1,1,Sun,L 19-42,,10,53,7,52,17,105
993,ARI,2005,2005-11-20,1:02,12:02,@,STL,11,10,Sun,W 38-28,,10,111,9,54,19,165
994,ARI,2007,2007-09-10,10:25,7:25,@,SFO,1,1,Mon,L 17-20,,10,71,6,40,16,111
995,ARI,2007,2007-11-25,4:06,2:06,,SFO,12,11,Sun,L 31-37,OT,10,70,3,42,13,112
996,ARI,2007,2007-12-16,1:03,12:03,@,NOR,15,14,Sun,L 24-31,,10,78,3,15,13,93
997,ARI,2008,2008-11-02,1:00,12:00,@,STL,9,8,Sun,W 34-13,,10,69,4,41,14,110
998,ARI,2008,2008-11-10,8:40,6:40,,SFO,10,9,Mon,W 29-24,,10,71,10,93,20,164
999,ARI,2008,2008-12-28,4:15,2:15,,SEA,17,16,Sun,W 34-21,,10,100,11,82,21,182
1000,ARI,2010,2010-09-12,4:15,3:15,@,STL,1,1,Sun,W 17-13,,10,72,5,40,15,112
1001,ARI,2010,2010-09-19,1:03,1:03,@,ATL,2,2,Sun,L 7-41,,10,109,6,75,16,184
1002,ARI,2010,2010-11-14,4:15,2:15,,SEA,10,9,Sun,L 18-36,,10,50,6,51,16,101
1003,ARI,2011,2011-09-18,1:03,1:03,@,WAS,2,2,Sun,L 21-22,,10,97,3,15,13,112
1004,ARI,2012,2012-09-09,4:25,1:25,,SEA,1,1,Sun,W 20-16,,10,102,13,90,23,192
1005,ARI,2013,2013-09-29,1:03,1:03,@,TAM,4,4,Sun,W 13-10,,10,90,8,73,18,163
1006,ARI,2014,2014-10-26,4:05,1:05,,PHI,8,7,Sun,W 24-20,,10,95,11,103,21,198
1007,ARI,2015,2015-12-27,4:25,2:25,,GNB,16,15,Sun,W 38-8,,10,119,7,59,17,178
1008,ARI,2016,2016-10-30,12:47,12:47,@,CAR,8,8,Sun,L 20-30,,10,88,5,40,15,128
1009,ARI,2017,2017-10-01,4:05,2:05,,SFO,4,4,Sun,W 18-15,OT,10,80,13,113,23,193
1010,ARI,2017,2017-10-22,1:00,6:00,@,LAR,7,7,Sun,L 0-33,,10,65,6,45,16,110
1011,ARI,2017,2017-11-19,1:00,12:00,@,HOU,11,10,Sun,L 21-31,,10,90,6,42,16,132
1012,ARI,2017,2017-11-26,4:25,2:25,,JAX,12,11,Sun,W 27-24,,10,98,5,45,15,143
1013,ARI,2019,2019-10-20,1:00,1:00,@,NYG,7,7,Sun,W 27-21,,10,85,6,75,16,160
1014,ARI,2019,2019-11-17,4:05,1:05,@,SFO,11,11,Sun,L 26-36,,10,104,10,127,20,231
1015,ARI,2020,2020-10-11,1:00,1:00,@,NYJ,5,5,Sun,W 30-10,,10,59,6,30,16,89
1016,ARI,2020,2020-11-19,8:20,5:20,@,SEA,11,10,Thu,L 21-28,,10,115,8,79,18,194
1017,DAL,2001,2001-11-18,1:03,12:03,,PHI,10,9,Sun,L 3-36,,10,81,3,22,13,103
1018,DAL,2002,2002-11-24,1:03,12:03,,JAX,12,11,Sun,W 21-19,,10,75,11,79,21,154
1019,DAL,2003,2003-11-16,8:37,8:37,@,NWE,11,10,Sun,L 0-12,,10,78,7,84,17,162
1020,DAL,2003,2003-11-23,1:02,12:02,,CAR,12,11,Sun,W 24-20,,10,123,11,68,21,191
1021,DAL,2005,2006-01-01,8:36,7:36,,STL,17,16,Sun,L 10-20,,10,78,7,40,17,118
1022,DAL,2007,2007-11-11,4:15,4:15,@,NYG,10,9,Sun,W 31-20,,10,84,8,70,18,154
1023,DAL,2007,2007-11-29,8:16,7:16,,GNB,13,12,Thu,W 37-27,,10,65,9,142,19,207
1024,DAL,2008,2008-09-15,8:40,7:40,,PHI,2,2,Mon,W 41-37,,10,108,5,44,15,152
1025,DAL,2008,2008-12-20,8:15,7:15,,BAL,16,15,Sat,L 24-33,,10,86,3,19,13,105
1026,DAL,2009,2009-11-15,4:15,3:15,@,GNB,10,9,Sun,L 7-17,,10,67,12,100,22,167
1027,DAL,2011,2011-10-16,4:15,4:15,@,NWE,6,5,Sun,L 16-20,,10,77,5,35,15,112
1028,DAL,2011,2011-12-11,8:30,7:30,,NYG,14,13,Sun,L 34-37,,10,51,6,55,16,106
1029,DAL,2014,2014-09-07,4:25,3:25,,SFO,1,1,Sun,L 17-28,,10,72,11,78,21,150
1030,DAL,2015,2015-11-22,1:03,1:03,@,MIA,11,10,Sun,W 24-14,,10,79,9,74,19,153
1031,DAL,2016,2016-11-13,4:25,4:25,@,PIT,10,9,Sun,W 35-30,,10,98,4,40,14,138
1032,DAL,2016,2016-12-01,7:25,9:25,@,MIN,13,12,Thu,W 17-15,,10,78,8,57,18,135
1033,DAL,2018,2018-09-09,4:25,4:25,@,CAR,1,1,Sun,L 8-16,,10,85,9,80,19,165
1034,DAL,2018,2018-12-23,1:00,12:00,,TAM,16,15,Sun,W 27-20,,10,67,9,72,19,139
1035,DAL,2019,2019-11-04,8:15,8:15,@,NYG,9,8,Mon,W 37-18,,10,104,8,71,18,175
1036,DAL,2019,2019-12-29,4:25,3:25,,WAS,17,16,Sun,W 47-16,,10,81,2,10,12,91
1037,DAL,2020,2020-09-27,4:25,1:25,@,SEA,3,3,Sun,L 31-38,,10,59,5,30,15,89
1038,DAL,2021,2022-01-02,1:00,12:00,,ARI,17,16,Sun,L 22-25,,10,88,7,45,17,133
1039,DEN,2003,2003-09-14,4:15,1:15,@,SDG,2,2,Sun,W 37-13,,10,81,11,96,21,177
1040,DEN,2004,2004-12-19,1:00,12:00,@,KAN,15,14,Sun,L 17-45,,10,100,6,58,16,158
1041,DEN,2005,2005-11-24,4:17,3:17,@,DAL,12,11,Thu,W 24-21,OT,10,67,7,40,17,107
1042,DEN,2008,2008-11-02,4:05,2:05,,MIA,9,8,Sun,L 17-26,,10,81,2,42,12,123
1043,DEN,2009,2009-10-04,4:15,2:15,,DAL,4,4,Sun,W 17-10,,10,81,7,70,17,151
1044,DEN,2010,2010-10-10,1:02,1:02,@,BAL,5,5,Sun,L 17-31,,10,90,5,66,15,156
1045,DEN,2010,2010-12-19,4:15,1:15,@,OAK,15,14,Sun,L 23-39,,10,93,9,84,19,177
1046,DEN,2011,2011-09-12,10:26,8:26,,OAK,1,1,Mon,L 20-23,,10,91,15,131,25,222
1047,DEN,2012,2012-09-17,8:41,8:41,@,ATL,2,2,Mon,L 21-27,,10,96,8,72,18,168
1048,DEN,2012,2012-10-15,8:40,5:40,@,SDG,6,6,Mon,W 35-24,,10,81,9,64,19,145
1049,DEN,2013,2013-12-01,4:26,3:26,@,KAN,13,12,Sun,W 35-28,,10,75,9,102,19,177
1050,DEN,2014,2014-11-02,4:25,4:25,@,NWE,9,8,Sun,L 21-43,,10,72,9,71,19,143
1051,DEN,2017,2017-09-24,1:00,1:00,@,BUF,3,3,Sun,L 16-26,,10,79,8,69,18,148
1052,DEN,2017,2017-10-22,4:25,1:25,@,LAC,7,6,Sun,L 0-21,,10,68,9,81,19,149
1053,DEN,2018,2018-10-28,1:00,12:00,@,KAN,8,8,Sun,L 23-30,,10,83,7,50,17,133
1054,DEN,2019,2019-09-15,4:25,2:25,,CHI,2,2,Sun,L 14-16,,10,81,7,65,17,146
1055,DEN,2019,2019-10-27,1:00,1:00,@,IND,8,8,Sun,L 13-15,,10,88,10,103,20,191
1056,DEN,2021,2021-09-19,1:00,1:00,@,JAX,2,2,Sun,W 23-13,,10,101,7,70,17,171
1057,DET,2000,2000-09-17,1:06,1:06,,TAM,3,3,Sun,L 10-31,,10,51,5,45,15,96
1058,DET,2000,2000-11-23,12:36,12:36,,NWE,13,12,Thu,W 34-9,,10,99,9,81,19,180
1059,DET,2001,2001-12-02,1:03,12:03,@,CHI,12,11,Sun,L 10-13,,10,79,5,56,15,135
1060,DET,2002,2002-10-20,1:03,1:03,,CHI,7,6,Sun,W 23-20,OT,10,79,5,40,15,119
1061,DET,2004,2004-10-31,1:03,12:03,@,DAL,8,7,Sun,L 21-31,,10,112,5,35,15,147
1062,DET,2004,2004-11-25,12:38,12:38,,IND,12,11,Thu,L 9-41,,10,60,5,40,15,100
1063,DET,2004,2004-12-05,1:03,1:03,,ARI,13,12,Sun,W 26-12,,10,69,7,70,17,139
1064,DET,2004,2004-12-12,4:15,3:15,@,GNB,14,13,Sun,L 13-16,,10,85,9,94,19,179
1065,DET,2005,2005-10-16,1:02,1:02,,CAR,6,5,Sun,L 20-21,,10,75,10,73,20,148
1066,DET,2006,2006-11-05,1:03,1:03,,ATL,9,8,Sun,W 30-14,,10,71,9,76,19,147
1067,DET,2007,2007-11-11,4:15,2:15,@,ARI,10,9,Sun,L 21-31,,10,70,9,70,19,140
1068,DET,2008,2008-11-23,1:03,1:03,,TAM,12,11,Sun,L 20-38,,10,70,3,25,13,95
1069,DET,2010,2010-11-21,1:02,12:02,@,DAL,11,10,Sun,L 19-35,,10,76,6,39,16,115
1070,DET,2011,2011-10-02,1:02,12:02,@,DAL,4,4,Sun,W 34-30,,10,75,7,33,17,108
1071,DET,2011,2011-10-23,1:05,1:05,,ATL,7,7,Sun,L 16-23,,10,84,11,80,21,164
1072,DET,2011,2011-12-11,1:03,1:03,,MIN,14,13,Sun,W 34-28,,10,76,5,37,15,113
1073,DET,2012,2012-09-23,1:03,12:03,@,TEN,3,3,Sun,L 41-44,OT,10,91,6,32,16,123
1074,DET,2014,2014-11-09,1:02,1:02,,MIA,10,9,Sun,W 20-16,,10,98,5,44,15,142
1075,DET,2014,2014-12-28,4:25,3:25,@,GNB,17,16,Sun,L 20-30,,10,53,5,40,15,93
1076,DET,2015,2015-10-18,1:02,1:02,,CHI,6,6,Sun,W 37-34,OT,10,98,9,76,19,174
1077,DET,2015,2015-12-21,8:30,7:30,@,NOR,15,14,Mon,W 35-27,,10,92,6,28,16,120
1078,DET,2016,2016-10-02,1:00,12:00,@,CHI,4,4,Sun,L 14-17,,10,76,8,55,18,131
1079,DET,2017,2017-09-10,1:00,1:00,,ARI,1,1,Sun,W 35-23,,10,100,6,55,16,155
1080,DET,2018,2018-09-16,4:05,1:05,@,SFO,2,2,Sun,L 27-30,,10,105,9,86,19,191
1081,DET,2021,2021-11-25,12:30,12:30,,CHI,12,11,Thu,L 14-16,,10,67,5,50,15,117
1082,GNB,2000,2000-09-03,4:20,3:20,,NYJ,1,1,Sun,L 16-20,,10,81,10,75,20,156
1083,GNB,2002,2002-09-29,1:02,12:02,,CAR,4,4,Sun,W 17-14,,10,83,7,77,17,160
1084,GNB,2003,2003-12-22,9:05,6:05,@,OAK,16,15,Mon,W 41-7,,10,70,3,25,13,95
1085,GNB,2004,2004-11-21,8:35,7:35,@,HOU,11,10,Sun,W 16-13,,10,90,3,25,13,115
1086,GNB,2005,2005-12-19,9:07,9:07,@,BAL,15,14,Mon,L 3-48,,10,94,7,71,17,165
1087,GNB,2006,2006-10-29,1:02,12:02,,ARI,8,7,Sun,W 31-14,,10,65,9,68,19,133
1088,GNB,2006,2006-11-27,8:41,5:41,@,SEA,12,11,Mon,L 24-34,,10,61,3,25,13,86
1089,GNB,2008,2008-11-09,1:05,12:05,@,MIN,10,9,Sun,L 27-28,,10,80,7,55,17,135
1090,GNB,2012,2012-09-09,4:25,3:25,,SFO,1,1,Sun,L 22-30,,10,77,8,66,18,143
1091,GNB,2012,2012-09-24,8:41,5:41,@,SEA,3,3,Mon,L 12-14,,10,127,14,118,24,245
1092,GNB,2012,2012-12-02,1:02,12:02,,MIN,13,12,Sun,W 23-14,,10,78,5,48,15,126
1093,GNB,2013,2013-10-06,1:02,12:02,,DET,5,4,Sun,W 22-9,,10,72,7,50,17,122
1094,GNB,2013,2013-10-20,4:25,3:25,,CLE,7,6,Sun,W 31-13,,10,97,12,106,22,203
1095,GNB,2015,2015-09-13,1:00,12:00,@,CHI,1,1,Sun,W 31-23,,10,74,6,64,16,138
1096,GNB,2016,2017-01-01,8:30,8:30,@,DET,17,16,Sun,W 31-24,,10,75,5,30,15,105
1097,GNB,2017,2017-09-17,8:30,8:30,@,ATL,2,2,Sun,L 23-34,,10,70,6,34,16,104
1098,GNB,2018,2018-12-23,1:00,1:00,@,NYJ,16,15,Sun,W 44-38,OT,10,86,16,172,26,258
1099,GNB,2019,2019-09-05,8:20,7:20,@,CHI,1,1,Thu,W 10-3,,10,71,10,107,20,178
1100,GNB,2019,2019-11-10,4:25,3:25,,CAR,10,10,Sun,W 24-16,,10,64,5,46,15,110
1101,HOU,2002,2002-12-22,1:02,1:02,@,WAS,16,15,Sun,L 10-26,,10,83,6,60,16,143
1102,HOU,2003,2003-09-21,1:02,12:02,,KAN,3,3,Sun,L 14-42,,10,74,4,20,14,94
1103,HOU,2003,2003-12-07,1:02,1:02,@,JAX,14,13,Sun,L 0-27,,10,86,7,70,17,156
1104,HOU,2004,2004-12-19,1:02,12:02,@,CHI,15,14,Sun,W 24-5,,10,89,5,50,15,139
1105,HOU,2006,2006-10-29,1:02,12:02,@,TEN,8,7,Sun,L 22-28,,10,74,8,64,18,138
1106,HOU,2008,2008-11-09,1:02,12:02,,BAL,10,9,Sun,L 13-41,,10,76,7,55,17,131
1107,HOU,2009,2009-11-29,1:02,12:02,,IND,12,11,Sun,L 27-35,,10,129,3,25,13,154
1108,HOU,2012,2012-09-16,1:03,1:03,@,JAX,2,2,Sun,W 27-7,,10,64,8,71,18,135
1109,HOU,2015,2015-09-20,1:02,1:02,@,CAR,2,2,Sun,L 17-24,,10,70,10,92,20,162
1110,HOU,2015,2015-10-18,1:02,1:02,@,JAX,6,6,Sun,W 31-20,,10,69,7,64,17,133
1111,HOU,2015,2015-12-06,1:02,1:02,@,BUF,13,12,Sun,L 21-30,,10,89,5,42,15,131
1112,HOU,2017,2017-09-24,1:00,1:00,@,NWE,3,3,Sun,L 33-36,,10,60,5,69,15,129
1113,HOU,2018,2018-09-30,1:00,1:00,@,IND,4,4,Sun,W 37-34,OT,10,54,10,85,20,139
1114,HOU,2018,2018-12-23,1:00,1:00,@,PHI,16,15,Sun,L 30-32,,10,61,11,105,21,166
1115,HOU,2019,2019-10-13,1:00,12:00,@,KAN,6,6,Sun,W 31-24,,10,70,11,79,21,149
1116,HOU,2019,2019-10-20,1:00,1:00,@,IND,7,7,Sun,L 23-30,,10,54,6,45,16,99
1117,HOU,2020,2020-11-26,12:30,12:30,@,DET,12,11,Thu,W 41-25,,10,74,4,44,14,118
1118,HOU,2021,2021-10-03,1:00,1:00,@,BUF,4,4,Sun,L 0-40,,10,100,3,30,13,130
1119,HOU,2021,2021-12-26,1:00,12:00,,LAC,16,15,Sun,W 41-29,,10,70,5,49,15,119
1120,JAX,2000,2000-09-10,1:02,1:02,@,BAL,2,2,Sun,L 36-39,,10,60,8,65,18,125
1121,JAX,2000,2000-10-01,1:03,1:03,,PIT,5,5,Sun,L 13-24,,10,75,7,55,17,130
1122,JAX,2001,2001-10-28,1:01,1:01,@,BAL,7,6,Sun,L 17-18,,10,70,4,34,14,104
1123,JAX,2004,2004-09-19,1:02,1:02,,DEN,2,2,Sun,W 7-6,,10,85,7,57,17,142
1124,JAX,2004,2004-11-14,1:04,1:04,,DET,10,9,Sun,W 23-17,OT,10,99,8,45,18,144
1125,JAX,2005,2005-10-09,8:36,8:36,,CIN,5,5,Sun,W 23-20,,10,98,12,94,22,192
1126,JAX,2005,2005-10-16,1:02,1:02,@,PIT,6,6,Sun,W 23-17,OT,10,106,7,80,17,186
1127,JAX,2005,2005-12-18,1:02,1:02,,SFO,15,14,Sun,W 10-9,,10,84,8,56,18,140
1128,JAX,2006,2006-09-18,8:40,8:40,,PIT,2,2,Mon,W 9-0,,10,86,3,25,13,111
1129,JAX,2006,2006-11-26,1:02,1:02,@,BUF,12,11,Sun,L 24-27,,10,108,4,55,14,163
1130,JAX,2012,2012-11-08,8:30,8:30,,IND,10,9,Thu,L 10-27,,10,115,6,40,16,155
1131,JAX,2012,2012-12-16,1:03,1:03,@,MIA,15,14,Sun,L 3-24,,10,88,5,41,15,129
1132,JAX,2013,2013-09-15,4:25,1:25,@,OAK,2,2,Sun,L 9-19,,10,70,5,30,15,100
1133,JAX,2015,2015-10-25,8:35,1:35,,BUF,7,7,Sun,W 34-31,,10,66,10,87,20,153
1134,JAX,2017,2017-09-10,1:00,12:00,@,HOU,1,1,Sun,W 29-7,,10,89,9,94,19,183
1135,JAX,2017,2017-09-17,1:00,1:00,,TEN,2,2,Sun,L 16-37,,10,99,7,70,17,169
1136,JAX,2018,2018-11-25,1:00,1:00,@,BUF,12,11,Sun,L 21-24,,10,90,13,80,23,170
1137,JAX,2018,2018-12-23,1:00,1:00,@,MIA,16,15,Sun,W 17-7,,10,97,10,95,20,192
1138,JAX,2019,2019-09-08,1:00,1:00,,KAN,1,1,Sun,L 26-40,,10,71,5,55,15,126
1139,JAX,2019,2019-12-08,4:05,4:05,,LAC,14,13,Sun,L 10-45,,10,101,6,65,16,166
1140,JAX,2020,2020-12-06,1:00,3:00,@,MIN,13,12,Sun,L 24-27,OT,10,83,6,41,16,124
1141,JAX,2020,2020-12-13,1:00,1:00,,TEN,14,13,Sun,L 10-31,,10,80,7,78,17,158
1142,JAX,2020,2020-12-27,1:00,1:00,,CHI,16,15,Sun,L 17-41,,10,115,4,40,14,155
1143,JAX,2021,2021-09-12,1:00,12:00,@,HOU,1,1,Sun,L 21-37,,10,82,5,50,15,132
1144,KAN,2000,2000-09-10,1:03,12:03,@,TEN,2,2,Sun,L 14-17,OT,10,72,7,70,17,142
1145,KAN,2001,2001-10-21,4:05,1:05,@,ARI,6,6,Sun,L 16-24,,10,107,6,50,16,157
1146,KAN,2002,2002-09-29,1:00,12:00,,MIA,4,4,Sun,W 48-30,,10,71,9,86,19,157
1147,KAN,2002,2002-12-15,4:05,2:05,@,DEN,15,14,Sun,L 24-31,,10,93,3,25,13,118
1148,KAN,2004,2004-10-04,9:08,9:08,@,BAL,4,4,Mon,W 27-24,,10,72,6,54,16,126
1149,KAN,2004,2004-11-07,1:00,1:00,@,TAM,9,8,Sun,L 31-34,,10,97,10,95,20,192
1150,KAN,2007,2007-09-23,1:00,12:00,,MIN,3,3,Sun,W 13-10,,10,61,6,45,16,106
1151,KAN,2009,2009-09-27,1:02,1:02,@,PHI,3,3,Sun,L 14-34,,10,90,3,20,13,110
1152,KAN,2011,2011-10-23,7:05,4:05,@,OAK,7,6,Sun,W 28-0,,10,98,14,120,24,218
1153,KAN,2013,2013-09-15,1:02,12:02,,DAL,2,2,Sun,W 17-16,,10,45,5,27,15,72
1154,KAN,2018,2018-10-01,8:15,6:15,@,DEN,4,4,Mon,W 27-23,,10,93,3,25,13,118
1155,KAN,2018,2018-12-13,8:20,7:20,,LAC,15,14,Thu,L 28-29,,10,66,7,50,17,116
1156,KAN,2019,2019-09-15,4:05,1:05,@,OAK,2,2,Sun,W 28-10,,10,114,7,52,17,166
1157,KAN,2019,2019-12-08,4:25,4:25,@,NWE,14,13,Sun,W 23-16,,10,136,5,25,15,161
1158,KAN,2020,2020-10-11,1:00,12:00,,LVR,5,5,Sun,L 32-40,,10,94,8,59,18,153
1159,KAN,2020,2020-11-22,8:20,5:20,@,LVR,11,10,Sun,W 35-31,,10,89,8,72,18,161
1160,KAN,2020,2020-11-29,4:25,4:25,@,TAM,12,11,Sun,W 27-24,,10,82,8,57,18,139
1161,KAN,2021,2022-01-02,1:00,1:00,@,CIN,17,16,Sun,L 31-34,,10,83,5,62,15,145
1162,MIA,2000,2000-11-19,4:05,4:05,,NYJ,12,11,Sun,L 3-20,,10,88,4,29,14,117
1163,MIA,2000,2000-12-03,1:02,1:02,@,BUF,14,13,Sun,W 33-6,,10,86,4,30,14,116
1164,MIA,2005,2005-09-18,4:16,4:16,@,NYJ,2,2,Sun,L 7-17,,10,88,5,40,15,128
1165,MIA,2006,2006-10-08,1:02,1:02,@,NWE,5,5,Sun,L 10-20,,10,81,7,59,17,140
1166,MIA,2008,2008-11-30,1:00,12:00,@,STL,13,12,Sun,W 16-12,,10,94,5,30,15,124
1167,MIA,2011,2011-09-25,1:02,1:02,@,CLE,3,3,Sun,L 16-17,,10,93,8,85,18,178
1168,MIA,2013,2013-09-08,1:02,1:02,@,CLE,1,1,Sun,W 23-10,,10,77,9,57,19,134
1169,MIA,2015,2016-01-03,1:02,1:02,,NWE,17,16,Sun,W 20-10,,10,93,7,41,17,134
1170,MIA,2018,2018-09-30,1:00,1:00,@,NWE,4,4,Sun,L 7-38,,10,89,6,57,16,146
1171,MIA,2018,2018-11-25,4:25,1:00,@,IND,12,11,Sun,L 24-27,,10,75,7,52,17,127
1172,MIA,2018,2018-12-23,1:00,1:00,,JAX,16,15,Sun,L 7-17,,10,95,10,97,20,192
1173,MIN,2000,2000-10-01,1:01,1:01,@,DET,5,4,Sun,W 31-24,,10,72,9,55,19,127
1174,MIN,2002,2002-10-13,1:00,12:00,,DET,6,5,Sun,W 31-24,,10,75,5,56,15,131
1175,MIN,2002,2002-11-10,1:00,12:00,,NYG,10,9,Sun,L 20-27,,10,84,9,84,19,168
1176,MIN,2002,2002-12-01,12:00,12:00,,ATL,13,12,Sun,L 24-30,OT,10,95,5,34,15,129
1177,MIN,2003,2003-11-09,4:05,1:05,@,SDG,10,9,Sun,L 28-42,,10,107,6,49,16,156
1178,MIN,2003,2003-11-16,4:15,1:15,@,OAK,11,10,Sun,L 18-28,,10,60,7,85,17,145
1179,MIN,2004,2004-09-20,9:09,9:09,@,PHI,2,2,Mon,L 16-27,,10,70,3,25,13,95
1180,MIN,2004,2004-10-10,1:02,12:02,@,HOU,5,4,Sun,W 34-28,OT,10,75,11,88,21,163
1181,MIN,2005,2005-10-30,1:02,1:02,@,CAR,8,7,Sun,L 13-38,,10,60,6,53,16,113
1182,MIN,2006,2006-12-21,8:05,7:05,@,GNB,16,15,Thu,L 7-9,,10,68,4,35,14,103
1183,MIN,2009,2009-11-29,4:15,3:15,,CHI,12,11,Sun,W 36-10,,10,70,6,44,16,114
1184,MIN,2010,2010-12-13,7:20,7:20,,NYG,14,13,Mon,L 3-21,,10,71,7,55,17,126
1185,MIN,2011,2011-09-25,1:05,12:05,,DET,3,3,Sun,L 23-26,OT,10,79,7,65,17,144
1186,MIN,2011,2011-11-14,8:40,7:40,@,GNB,10,9,Mon,L 7-45,,10,80,1,5,11,85
1187,MIN,2012,2012-12-30,4:25,3:25,,GNB,17,16,Sun,W 37-34,,10,98,7,43,17,141
1188,MIN,2015,2015-09-20,1:03,12:03,,DET,2,2,Sun,W 26-16,,10,97,6,39,16,136
1189,MIN,2016,2016-11-20,1:00,3:00,,ARI,11,10,Sun,W 30-24,,10,73,8,96,18,169
1190,MIN,2021,2021-11-14,4:05,1:05,@,LAC,10,9,Sun,W 27-20,,10,118,7,52,17,170
1191,NOR,2000,2000-10-08,1:03,12:03,@,CHI,6,5,Sun,W 31-10,,10,149,5,45,15,194
1192,NOR,2000,2000-11-05,1:02,12:02,,SFO,10,9,Sun,W 31-15,,10,54,14,97,24,151
1193,NOR,2001,2001-12-02,1:03,12:03,,CAR,12,11,Sun,W 27-23,,10,85,3,21,13,106
1194,NOR,2001,2001-12-09,1:05,1:05,@,ATL,13,12,Sun,W 28-10,,10,67,10,83,20,150
1195,NOR,2002,2002-09-22,1:05,12:05,@,CHI,3,3,Sun,W 29-23,,10,91,7,49,17,140
1196,NOR,2004,2004-11-07,4:05,1:05,@,SDG,9,8,Sun,L 17-43,,10,117,5,32,15,149
1197,NOR,2004,2004-11-21,1:03,12:03,,DEN,11,10,Sun,L 13-34,,10,79,6,82,16,161
1198,NOR,2004,2004-12-05,1:03,12:03,,CAR,13,12,Sun,L 21-32,,10,104,6,44,16,148
1199,NOR,2004,2004-12-26,1:03,12:03,,ATL,16,15,Sun,W 26-13,,10,73,6,35,16,108
1200,NOR,2005,2005-12-12,9:05,9:05,@,ATL,14,13,Mon,L 17-36,,10,107,9,74,19,181
1201,NOR,2006,2006-10-29,1:04,12:04,,BAL,8,7,Sun,L 22-35,,10,68,9,69,19,137
1202,NOR,2012,2012-09-30,4:25,3:25,@,GNB,4,4,Sun,L 27-28,,10,72,7,43,17,115
1203,NOR,2012,2012-10-07,8:31,7:31,,SDG,5,5,Sun,W 31-24,,10,99,7,56,17,155
1204,NOR,2012,2012-12-09,4:26,4:26,@,NYG,14,13,Sun,L 27-52,,10,81,6,55,16,136
1205,NOR,2015,2015-09-20,1:02,12:02,,TAM,2,2,Sun,L 19-26,,10,115,11,90,21,205
1206,NOR,2015,2015-11-29,1:02,12:02,@,HOU,12,11,Sun,L 6-24,,10,82,6,40,16,122
1207,NOR,2016,2016-10-16,1:03,12:03,,CAR,6,5,Sun,W 41-38,,10,126,5,51,15,177
1208,NOR,2016,2016-10-23,1:03,12:03,@,KAN,7,6,Sun,L 21-27,,10,75,4,30,14,105
1209,NOR,2016,2016-12-04,1:00,12:00,,DET,13,12,Sun,L 13-28,,10,83,6,39,16,122
1210,NOR,2020,2020-09-21,8:15,5:15,@,LVR,2,2,Mon,L 24-34,,10,129,3,13,13,142
1211,NOR,2020,2020-12-06,1:00,1:00,@,ATL,13,12,Sun,W 21-16,,10,79,1,15,11,94
1212,NOR,2020,2020-12-20,4:25,3:25,,KAN,15,14,Sun,L 29-32,,10,93,5,54,15,147
1213,NOR,2021,2021-11-07,1:00,12:00,,ATL,9,8,Sun,L 25-27,,10,74,6,76,16,150
1214,NWE,2003,2003-10-12,1:02,1:02,,NYG,6,6,Sun,W 17-6,,10,110,8,50,18,160
1215,NWE,2004,2004-10-03,1:02,1:02,@,BUF,4,3,Sun,W 31-17,,10,77,11,94,21,171
1216,NWE,2004,2004-11-28,4:16,4:16,,BAL,12,11,Sun,W 24-3,,10,97,10,106,20,203
1217,NWE,2005,2005-09-25,4:15,4:15,@,PIT,3,3,Sun,W 23-20,,10,118,5,35,15,153
1218,NWE,2006,2006-12-03,1:02,1:02,,DET,13,12,Sun,W 28-21,,10,72,7,70,17,142
1219,NWE,2007,2007-11-04,4:18,4:18,@,IND,9,9,Sun,W 24-20,,10,146,4,25,14,171
1220,NWE,2009,2009-10-25,1:06,5:06,@,TAM,7,7,Sun,W 35-7,,10,66,6,55,16,121
1221,NWE,2010,2010-11-14,8:30,8:30,@,PIT,10,9,Sun,W 39-26,,10,113,6,45,16,158
1222,NWE,2012,2012-09-23,8:31,8:31,@,BAL,3,3,Sun,L 30-31,,10,83,14,135,24,218
1223,NWE,2016,2016-10-30,1:02,1:02,@,BUF,8,8,Sun,W 41-25,,10,116,12,84,22,200
1224,NYG,2000,2000-11-19,1:03,1:03,,DET,12,11,Sun,L 21-31,,10,103,6,55,16,158
1225,NYG,2002,2002-09-05,8:38,8:38,,SFO,1,1,Thu,L 13-16,,10,80,5,29,15,109
1226,NYG,2002,2002-09-29,4:04,1:04,@,ARI,4,4,Sun,L 7-21,,10,110,5,35,15,145
1227,NYG,2003,2003-09-15,9:08,9:08,,DAL,2,2,Mon,L 32-35,OT,10,102,11,108,21,210
1228,NYG,2003,2003-10-26,1:00,12:00,@,MIN,8,7,Sun,W 29-17,,10,75,9,52,19,127
1229,NYG,2004,2004-11-14,4:15,2:15,@,ARI,10,9,Sun,L 14-17,,10,97,3,15,13,112
1230,NYG,2005,2005-11-06,4:06,1:06,@,SFO,9,8,Sun,W 24-6,,10,81,12,80,22,161
1231,NYG,2005,2005-12-11,4:05,4:05,@,PHI,14,13,Sun,W 26-23,OT,10,71,9,101,19,172
1232,NYG,2006,2006-09-10,8:24,8:24,,IND,1,1,Sun,L 21-26,,10,64,3,20,13,84
1233,NYG,2006,2006-11-12,8:21,8:21,,CHI,10,9,Sun,L 20-38,,10,96,9,80,19,176
1234,NYG,2014,2014-10-12,8:41,8:41,@,PHI,6,6,Sun,L 0-27,,10,75,3,25,13,100
1235,NYG,2017,2017-09-24,1:00,1:00,@,PHI,3,3,Sun,L 24-27,,10,137,9,103,19,240
1236,NYG,2017,2017-10-08,1:00,1:00,,LAC,5,5,Sun,L 22-27,,10,67,11,87,21,154
1237,NYG,2017,2017-12-24,4:25,2:25,@,ARI,16,15,Sun,L 0-23,,10,101,6,45,16,146
1238,NYG,2018,2018-12-16,1:00,1:00,,TEN,15,14,Sun,L 0-17,,10,58,4,35,14,93
1239,NYG,2021,2021-11-01,8:15,7:15,@,KAN,8,8,Mon,L 17-20,,10,88,12,103,22,191
1240,NYJ,2000,2000-09-03,4:20,3:20,@,GNB,1,1,Sun,W 20-16,,10,75,10,81,20,156
1241,NYJ,2002,2002-09-08,1:04,1:04,@,BUF,1,1,Sun,W 37-31,OT,10,90,10,82,20,172
1242,NYJ,2009,2009-09-13,1:03,12:03,@,HOU,1,1,Sun,W 24-7,,10,80,6,37,16,117
1243,NYJ,2011,2011-12-24,1:03,1:03,,NYG,16,15,Sat,L 14-29,,10,95,5,45,15,140
1244,NYJ,2013,2013-09-29,4:05,3:05,@,TEN,4,4,Sun,L 13-38,,10,66,4,30,14,96
1245,NYJ,2014,2014-10-26,1:02,1:02,,BUF,8,8,Sun,L 23-43,,10,90,7,49,17,139
1246,NYJ,2016,2016-10-17,8:30,5:30,@,ARI,6,6,Mon,L 3-28,,10,83,9,64,19,147
1247,NYJ,2016,2016-11-06,1:00,1:00,@,MIA,9,9,Sun,L 23-27,,10,77,8,86,18,163
1248,NYJ,2017,2017-09-24,1:00,1:00,,MIA,3,3,Sun,W 20-6,,10,94,8,51,18,145
1249,NYJ,2017,2017-10-01,1:00,1:00,,JAX,4,4,Sun,W 23-20,OT,10,70,6,47,16,117
1250,NYJ,2017,2017-11-02,8:25,8:25,,BUF,9,9,Thu,W 34-21,,10,66,11,99,21,165
1251,NYJ,2019,2019-10-27,1:00,1:00,@,JAX,8,7,Sun,L 15-29,,10,83,9,70,19,153
1252,NYJ,2019,2019-11-03,1:00,1:00,@,MIA,9,8,Sun,L 18-26,,10,105,6,51,16,156
1253,NYJ,2019,2019-12-01,1:00,1:00,@,CIN,13,12,Sun,L 6-22,,10,106,2,15,12,121
1254,TEN,2000,2000-10-16,9:10,8:10,,JAX,7,6,Mon,W 27-13,,10,89,5,40,15,129
1255,TEN,2000,2000-10-30,9:01,9:01,@,WAS,9,8,Mon,W 27-21,,10,56,7,62,17,118
1256,TEN,2003,2003-09-14,1:00,12:00,@,IND,2,2,Sun,L 7-33,,10,99,6,38,16,137
1257,TEN,2003,2003-09-28,1:01,1:01,@,PIT,4,4,Sun,W 30-13,,10,77,8,80,18,157
1258,TEN,2003,2003-12-07,1:03,12:03,,IND,14,13,Sun,L 27-29,,10,67,6,57,16,124
1259,TEN,2005,2005-11-27,1:03,12:03,,SFO,12,11,Sun,W 33-22,,10,70,4,35,14,105
1260,TEN,2006,2006-12-31,1:02,12:02,,NWE,17,16,Sun,L 23-40,,10,119,9,129,19,248
1261,TEN,2007,2007-11-04,1:02,12:02,,CAR,9,8,Sun,W 20-7,,10,89,10,92,20,181
1262,TEN,2008,2008-10-05,1:02,1:02,@,BAL,5,5,Sun,W 13-10,,10,78,11,91,21,169
1263,TEN,2008,2008-11-16,4:15,4:15,@,JAX,11,10,Sun,W 24-14,,10,63,9,61,19,124
1264,TEN,2010,2010-10-03,1:02,12:02,,DEN,4,4,Sun,L 20-26,,10,111,6,74,16,185
1265,TEN,2010,2010-10-31,4:05,1:05,@,SDG,8,8,Sun,L 25-33,,10,80,8,62,18,142
1266,TEN,2010,2010-11-28,1:02,12:02,@,HOU,12,11,Sun,L 0-20,,10,79,6,68,16,147
1267,TEN,2011,2011-11-20,4:15,4:15,@,ATL,11,10,Sun,L 17-23,,10,86,5,55,15,141
1268,TEN,2012,2012-10-07,4:15,3:15,@,MIN,5,5,Sun,L 7-30,,10,75,5,60,15,135
1269,TEN,2013,2013-10-20,4:06,3:06,,SFO,7,7,Sun,L 17-31,,10,100,5,42,15,142
1270,TEN,2013,2013-11-24,4:05,1:05,@,OAK,12,11,Sun,W 23-19,,10,100,4,50,14,150
1271,PHI,2000,2000-09-24,1:02,12:02,@,NOR,4,4,Sun,W 21-7,,10,64,5,40,15,104
1272,PHI,2000,2000-10-15,4:15,1:15,@,ARI,7,7,Sun,W 33-14,,10,95,9,65,19,160
1273,PHI,2001,2001-09-30,8:38,8:38,,DAL,3,3,Sun,W 40-18,,10,81,6,50,16,131
1274,PHI,2002,2002-09-08,1:06,12:06,@,TEN,1,1,Sun,L 24-27,,10,113,6,50,16,163
1275,PHI,2002,2002-10-06,4:14,4:14,@,JAX,5,5,Sun,L 25-28,,10,75,4,21,14,96
1276,PHI,2002,2002-12-21,8:39,7:39,@,DAL,16,15,Sat,W 27-3,,10,67,7,69,17,136
1277,PHI,2004,2004-10-03,1:05,12:05,@,CHI,4,4,Sun,W 19-9,,10,73,4,36,14,109
1278,PHI,2005,2005-10-23,1:02,1:02,,SDG,7,6,Sun,W 20-17,,10,72,9,72,19,144
1279,PHI,2005,2005-10-30,4:15,2:15,@,DEN,8,7,Sun,L 21-49,,10,70,6,50,16,120
1280,PHI,2005,2005-12-05,9:07,9:07,,SEA,13,12,Mon,L 0-42,,10,56,2,10,12,66
1281,PHI,2005,2005-12-24,4:05,2:05,@,ARI,16,15,Sat,L 21-27,,10,103,9,83,19,186
1282,PHI,2006,2006-09-17,1:02,1:02,,NYG,2,2,Sun,L 24-30,OT,10,66,9,75,19,141
1283,PHI,2009,2009-10-11,1:02,1:02,,TAM,5,4,Sun,W 33-14,,10,111,4,30,14,141
1284,PHI,2010,2010-09-12,4:16,4:16,,GNB,1,1,Sun,L 20-27,,10,80,2,15,12,95
1285,PHI,2010,2010-10-24,1:02,12:02,@,TEN,7,7,Sun,L 19-37,,10,100,6,37,16,137
1286,PHI,2010,2010-11-21,8:30,8:30,,NYG,11,10,Sun,W 27-17,,10,119,6,54,16,173
1287,PHI,2011,2011-11-27,4:15,4:15,,NWE,12,11,Sun,L 20-38,,10,60,3,20,13,80
1288,PHI,2014,2014-09-28,4:25,1:25,@,SFO,4,4,Sun,L 21-26,,10,70,10,80,20,150
1289,PHI,2015,2015-09-14,7:10,7:10,@,ATL,1,1,Mon,L 24-26,,10,88,7,57,17,145
1290,PHI,2015,2015-11-08,8:31,7:31,@,DAL,9,8,Sun,W 33-27,OT,10,70,8,58,18,128
1291,PHI,2016,2016-09-25,4:25,4:25,,PIT,3,3,Sun,W 34-3,,10,99,7,77,17,176
1292,PHI,2016,2016-11-13,1:00,1:00,,ATL,10,9,Sun,W 24-15,,10,77,8,67,18,144
1293,PHI,2016,2016-12-04,1:00,1:00,@,CIN,13,12,Sun,L 14-32,,10,88,3,23,13,111
1294,PHI,2017,2017-10-12,8:25,8:25,@,CAR,6,6,Thu,W 28-23,,10,126,1,1,11,127
1295,PHI,2017,2017-12-10,4:25,1:25,@,LAR,14,13,Sun,W 43-35,,10,67,7,102,17,169
1296,PHI,2018,2018-09-23,1:00,1:00,,IND,3,3,Sun,W 20-16,,10,110,11,77,21,187
1297,PHI,2019,2019-12-01,1:00,1:00,@,MIA,13,12,Sun,L 31-37,,10,91,7,59,17,150
1298,PIT,2003,2003-10-05,8:35,8:35,,CLE,5,5,Sun,L 13-33,,10,62,2,10,12,72
1299,PIT,2003,2003-11-23,1:02,1:02,@,CLE,12,11,Sun,W 13-6,,10,55,5,32,15,87
1300,PIT,2005,2005-11-20,1:02,1:02,@,BAL,11,10,Sun,L 13-16,OT,10,62,11,70,21,132
1301,PIT,2005,2005-11-28,9:08,9:08,@,IND,12,11,Mon,L 7-26,,10,62,12,106,22,168
1302,PIT,2008,2008-10-05,8:23,8:23,@,JAX,5,5,Sun,W 26-21,,10,129,8,89,18,218
1303,PIT,2009,2009-12-20,4:15,4:15,,GNB,15,14,Sun,W 37-36,,10,84,7,53,17,137
1304,PIT,2010,2010-11-28,1:02,1:02,@,BUF,12,11,Sun,W 19-16,OT,10,107,4,20,14,127
1305,PIT,2012,2012-09-16,4:25,4:25,,NYJ,2,2,Sun,W 27-10,,10,107,7,63,17,170
1306,PIT,2012,2012-09-23,4:25,1:25,@,OAK,3,3,Sun,L 31-34,,10,81,3,25,13,106
1307,PIT,2014,2014-10-26,4:25,4:25,,IND,8,8,Sun,W 51-34,,10,59,5,43,15,102
1308,PIT,2015,2015-11-01,1:02,1:02,,CIN,8,8,Sun,L 10-16,,10,91,10,94,20,185
1309,PIT,2016,2016-10-23,4:25,4:25,,NWE,7,7,Sun,L 16-27,,10,85,4,40,14,125
1310,PIT,2017,2017-09-17,1:00,1:00,,MIN,2,2,Sun,W 26-9,,10,72,11,131,21,203
1311,PIT,2019,2019-11-24,1:00,1:00,@,CIN,12,11,Sun,W 16-10,,10,77,7,79,17,156
1312,PIT,2019,2019-12-01,1:00,1:00,,CLE,13,12,Sun,W 20-13,,10,65,5,34,15,99
1313,PIT,2020,2020-09-20,1:00,1:00,,DEN,2,2,Sun,W 26-21,,10,89,4,30,14,119
1314,PIT,2021,2021-09-26,1:00,1:00,,CIN,3,3,Sun,L 10-24,,10,73,10,89,20,162
1315,PIT,2021,2021-12-09,8:20,6:20,@,MIN,14,13,Thu,L 28-36,,10,85,11,102,21,187
1316,OAK,2000,2000-10-08,4:00,1:00,@,SFO,6,5,Sun,W 34-28,OT,10,74,13,124,23,198
1317,OAK,2000,2000-10-22,4:05,1:05,,SEA,8,7,Sun,W 31-3,,10,90,10,68,20,158
1318,OAK,2001,2001-09-09,12:01,12:01,@,KAN,1,1,Sun,W 27-24,,10,106,4,25,14,131
1319,OAK,2001,2001-10-14,8:30,7:30,@,IND,5,5,Sun,W 23-18,,10,61,7,38,17,99
1320,OAK,2002,2002-09-29,4:15,1:15,,TEN,4,3,Sun,W 52-25,,10,117,11,77,21,194
1321,OAK,2002,2002-10-06,1:02,1:02,@,BUF,5,4,Sun,W 49-31,,10,120,7,43,17,163
1322,OAK,2002,2002-12-02,9:08,6:08,,NYJ,13,12,Mon,W 26-20,,10,83,3,40,13,123
1323,OAK,2004,2004-09-19,4:15,1:15,,BUF,2,2,Sun,W 13-10,,10,96,7,55,17,151
1324,OAK,2004,2004-10-31,4:15,1:15,@,SDG,8,8,Sun,L 14-42,,10,75,7,46,17,121
1325,OAK,2005,2005-11-20,1:02,1:02,@,WAS,11,10,Sun,W 16-13,,10,101,6,50,16,151
1326,OAK,2007,2007-09-16,4:15,2:15,@,DEN,2,2,Sun,L 20-23,OT,10,70,6,34,16,104
1327,OAK,2007,2007-11-18,1:05,12:05,@,MIN,11,10,Sun,L 22-29,,10,55,4,30,14,85
1328,OAK,2008,2008-09-08,10:22,7:22,,DEN,1,1,Mon,L 14-41,,10,96,3,15,13,111
1329,OAK,2008,2008-11-09,4:05,1:05,,CAR,10,9,Sun,L 6-17,,10,83,4,40,14,123
1330,OAK,2008,2008-11-23,4:05,2:05,@,DEN,12,11,Sun,W 31-10,,10,90,4,39,14,129
1331,OAK,2009,2009-11-15,4:05,1:05,,KAN,10,9,Sun,L 10-16,,10,88,5,35,15,123
1332,OAK,2010,2010-09-12,1:02,12:02,@,TEN,1,1,Sun,L 13-38,,10,77,8,81,18,158
1333,OAK,2010,2010-10-24,4:15,2:15,@,DEN,7,7,Sun,W 59-14,,10,94,5,64,15,158
1334,OAK,2010,2010-12-26,4:05,1:05,,IND,16,15,Sun,L 26-31,,10,116,4,42,14,158
1335,OAK,2010,2011-01-02,1:02,12:02,@,KAN,17,16,Sun,W 31-10,,10,77,5,39,15,116
1336,OAK,2011,2011-12-04,1:03,1:03,@,MIA,13,12,Sun,L 14-34,,10,91,8,79,18,170
1337,OAK,2011,2011-12-18,4:05,1:05,,DET,15,14,Sun,L 27-28,,10,86,9,72,19,158
1338,OAK,2012,2012-11-11,1:02,1:02,@,BAL,10,9,Sun,L 20-55,,10,105,4,41,14,146
1339,OAK,2013,2013-11-28,4:31,3:31,@,DAL,13,12,Thu,L 24-31,,10,71,6,40,16,111
1340,OAK,2013,2013-12-15,4:05,1:05,,KAN,15,14,Sun,L 31-56,,10,90,8,91,18,181
1341,OAK,2014,2014-12-07,4:25,1:25,,SFO,14,13,Sun,W 24-13,,10,84,7,50,17,134
1342,OAK,2014,2014-12-14,1:03,12:03,@,KAN,15,14,Sun,L 13-31,,10,75,11,84,21,159
1343,OAK,2015,2015-12-13,4:05,2:05,@,DEN,14,13,Sun,W 15-12,,10,70,4,27,14,97
1344,OAK,2015,2015-12-20,4:05,1:05,,GNB,15,14,Sun,L 20-30,,10,95,6,75,16,170
1345,OAK,2016,2016-12-08,8:25,7:25,@,KAN,14,13,Thu,L 13-21,,10,82,9,73,19,155
1346,OAK,2016,2016-12-24,4:05,1:05,,IND,16,15,Sat,W 33-25,,10,93,4,22,14,115
1347,OAK,2017,2017-10-19,8:25,5:25,,KAN,7,7,Thu,W 31-30,,10,97,8,108,18,205
1348,OAK,2017,2017-11-05,8:30,8:30,@,MIA,9,9,Sun,W 27-24,,10,105,11,107,21,212
1349,OAK,2018,2018-10-28,4:05,1:05,,IND,8,7,Sun,L 28-42,,10,79,10,77,20,156
1350,OAK,2019,2019-11-03,4:05,1:05,,DET,9,8,Sun,W 31-24,,10,96,5,35,15,131
1351,OAK,2019,2019-12-29,4:25,2:25,@,DEN,17,16,Sun,L 15-16,,10,107,9,61,19,168
1352,LVR,2021,2021-09-13,8:15,5:15,,BAL,1,1,Mon,W 33-27,OT,10,62,5,71,15,133
1353,LVR,2021,2021-10-10,4:05,1:05,,CHI,5,5,Sun,L 9-20,,10,82,8,70,18,152
1354,STL,2000,2000-09-24,1:02,1:02,@,ATL,4,4,Sun,W 41-20,,10,90,5,42,15,132
1355,STL,2002,2002-11-10,1:02,12:02,,SDG,10,9,Sun,W 28-24,,10,85,12,82,22,167
1356,STL,2004,2004-09-19,1:03,1:03,@,ATL,2,2,Sun,L 17-34,,10,75,6,51,16,126
1357,STL,2004,2004-11-07,4:15,3:15,,NWE,9,8,Sun,L 22-40,,10,80,7,48,17,128
1358,STL,2004,2005-01-02,1:02,12:02,,NYJ,17,16,Sun,W 32-29,OT,10,76,7,75,17,151
1359,STL,2006,2006-09-10,1:02,12:02,,DEN,1,1,Sun,W 18-10,,10,94,4,30,14,124
1360,STL,2006,2006-10-08,1:02,12:02,@,GNB,5,5,Sun,W 23-20,,10,78,4,41,14,119
1361,STL,2006,2006-12-03,1:02,12:02,,ARI,13,12,Sun,L 20-34,,10,126,11,107,21,233
1362,STL,2006,2006-12-17,4:15,1:15,@,OAK,15,14,Sun,W 20-0,,10,56,9,75,19,131
1363,STL,2008,2008-10-12,1:03,1:03,@,WAS,6,5,Sun,W 19-17,,10,79,7,53,17,132
1364,STL,2009,2009-09-13,4:16,1:16,@,SEA,1,1,Sun,L 0-28,,10,85,4,25,14,110
1365,STL,2009,2009-10-04,4:15,1:15,@,SFO,4,4,Sun,L 0-35,,10,73,3,33,13,106
1366,STL,2009,2009-12-13,4:05,3:05,@,TEN,14,13,Sun,L 7-47,,10,82,4,40,14,122
1367,STL,2011,2011-12-18,1:00,12:00,,CIN,15,14,Sun,L 13-20,,10,109,11,101,21,210
1368,STL,2012,2012-11-25,4:25,2:25,@,ARI,12,11,Sun,W 31-17,,10,84,7,56,17,140
1369,STL,2014,2014-10-05,1:02,1:02,@,PHI,5,4,Sun,L 28-34,,10,82,4,39,14,121
1370,LAR,2016,2016-09-12,10:20,7:20,@,SFO,1,1,Mon,L 0-28,,10,102,2,10,12,112
1371,LAR,2016,2016-11-06,4:05,1:05,,CAR,9,8,Sun,L 10-13,,10,109,5,35,15,144
1372,LAR,2017,2017-11-12,4:05,1:05,,HOU,10,9,Sun,W 33-7,,10,86,8,60,18,146
1373,LAR,2018,2018-10-14,4:05,2:05,@,DEN,6,6,Sun,W 23-20,,10,81,6,61,16,142
1374,LAR,2018,2018-11-11,4:25,1:25,,SEA,10,10,Sun,W 36-31,,10,102,7,56,17,158
1375,LAR,2019,2019-11-10,4:25,4:25,@,PIT,10,9,Sun,L 12-17,,10,95,13,107,23,202
1376,LAR,2019,2019-12-29,4:25,1:25,,ARI,17,16,Sun,W 31-24,,10,91,8,63,18,154
1377,BAL,2000,2000-09-24,1:02,1:02,,CIN,4,4,Sun,W 37-0,,10,90,8,53,18,143
1378,BAL,2001,2001-10-14,1:02,12:02,@,GNB,5,5,Sun,L 23-31,,10,85,6,29,16,114
1379,BAL,2003,2003-09-07,1:04,1:04,@,PIT,1,1,Sun,L 15-34,,10,81,9,138,19,219
1380,BAL,2003,2003-09-14,1:02,1:02,,CLE,2,2,Sun,W 33-13,,10,85,6,50,16,135
1381,BAL,2003,2003-11-09,8:38,7:38,@,STL,10,9,Sun,L 22-33,,10,80,7,75,17,155
1382,BAL,2003,2003-11-16,1:03,1:03,@,MIA,11,10,Sun,L 6-9,OT,10,88,5,50,15,138
1383,BAL,2003,2003-12-28,8:36,8:36,,PIT,17,16,Sun,W 13-10,OT,10,55,3,40,13,95
1384,BAL,2004,2004-09-19,1:02,1:02,,PIT,2,2,Sun,W 30-13,,10,123,9,75,19,198
1385,BAL,2004,2004-11-28,4:16,4:16,@,NWE,12,11,Sun,L 3-24,,10,106,10,97,20,203
1386,BAL,2005,2005-09-18,1:03,12:03,@,TEN,2,2,Sun,L 10-25,,10,73,5,47,15,120
1387,BAL,2006,2006-09-17,1:02,1:02,,OAK,2,2,Sun,W 28-6,,10,72,6,45,16,117
1388,BAL,2006,2006-11-26,1:02,1:02,,PIT,12,11,Sun,W 27-0,,10,87,4,28,14,115
1389,BAL,2007,2007-09-10,7:10,7:10,@,CIN,1,1,Mon,L 20-27,,10,86,5,41,15,127
1390,BAL,2008,2008-11-16,1:02,1:02,@,NYG,11,10,Sun,L 10-30,,10,66,8,65,18,131
1391,BAL,2009,2009-10-11,1:02,1:02,,CIN,5,5,Sun,L 14-17,,10,76,7,39,17,115
1392,BAL,2010,2010-12-19,1:03,1:03,,NOR,15,14,Sun,W 30-24,,10,68,6,68,16,136
1393,BAL,2011,2011-10-24,8:40,8:40,@,JAX,7,6,Mon,L 7-12,,10,85,6,90,16,175
1394,BAL,2012,2012-10-14,1:02,1:02,,DAL,6,6,Sun,W 31-29,,10,76,13,82,23,158
1395,BAL,2012,2012-12-30,1:03,1:03,@,CIN,17,16,Sun,L 17-23,,10,102,4,40,14,142
1396,BAL,2013,2013-09-22,1:03,1:03,,HOU,3,3,Sun,W 30-9,,10,87,14,113,24,200
1397,BAL,2014,2014-11-02,8:30,8:30,@,PIT,9,9,Sun,L 23-43,,10,108,7,67,17,175
1398,BAL,2015,2015-09-20,4:05,1:05,@,OAK,2,2,Sun,L 33-37,,10,109,16,106,26,215
1399,BAL,2015,2015-11-22,1:02,1:02,,STL,11,10,Sun,W 16-13,,10,137,6,35,16,172
1400,BAL,2016,2016-10-02,1:02,1:02,,OAK,4,4,Sun,L 27-28,,10,105,12,93,22,198
1401,BAL,2016,2016-11-06,1:00,1:00,,PIT,9,8,Sun,W 21-14,,10,94,13,99,23,193
1402,BAL,2017,2017-09-24,9:30,2:30,@,JAX,3,3,Sun,L 7-44,,10,88,9,70,19,158
1403,BAL,2018,2018-10-14,4:25,3:25,@,TEN,6,6,Sun,W 21-0,,10,70,4,35,14,105
1404,BAL,2018,2018-12-30,4:25,1:00,,CLE,17,16,Sun,W 26-24,,10,65,4,35,14,100
1405,BAL,2019,2019-09-15,1:00,1:00,,ARI,2,2,Sun,W 23-17,,10,62,8,70,18,132
1406,BAL,2019,2019-10-13,1:00,1:00,,CIN,6,6,Sun,W 23-17,,10,81,4,20,14,101
1407,BAL,2020,2020-12-27,1:00,1:00,,NYG,16,15,Sun,W 27-13,,10,65,5,35,15,100
1408,BAL,2021,2021-12-05,4:25,4:25,@,PIT,13,12,Sun,L 19-20,,10,55,5,81,15,136
1409,BAL,2021,2021-12-12,1:00,1:00,@,CLE,14,13,Sun,L 22-24,,10,129,4,42,14,171
1410,SDG,2000,2000-12-17,1:04,1:04,@,CAR,16,15,Sun,L 22-30,,10,95,7,45,17,140
1411,SDG,2001,2001-12-30,4:15,1:15,,SEA,16,16,Sun,L 22-25,,10,64,4,24,14,88
1412,SDG,2002,2002-10-20,4:05,1:05,@,OAK,7,7,Sun,W 27-21,OT,10,97,5,50,15,147
1413,SDG,2003,2003-09-21,4:15,1:15,,BAL,3,3,Sun,L 10-24,,10,61,4,28,14,89
1414,SDG,2003,2003-10-05,4:05,4:05,@,JAX,5,5,Sun,L 21-27,,10,61,8,89,18,150
1415,SDG,2006,2006-10-01,1:02,1:02,@,BAL,4,3,Sun,L 13-16,,10,78,4,30,14,108
1416,SDG,2006,2006-12-24,4:16,1:16,@,SEA,16,15,Sun,W 20-17,,10,85,6,50,16,135
1417,SDG,2007,2007-11-04,1:05,12:05,@,MIN,9,8,Sun,L 17-35,,10,67,11,81,21,148
1418,SDG,2007,2007-11-11,8:15,5:15,,IND,10,9,Sun,W 23-21,,10,78,4,21,14,99
1419,SDG,2008,2008-12-14,1:00,12:00,@,KAN,15,14,Sun,W 22-21,,10,83,4,30,14,113
1420,SDG,2012,2012-11-18,4:25,2:25,@,DEN,11,10,Sun,L 23-30,,10,65,4,30,14,95
1421,SDG,2013,2013-11-17,4:05,4:05,@,MIA,11,10,Sun,L 16-20,,10,76,3,15,13,91
1422,SDG,2014,2014-12-28,1:03,12:03,@,KAN,17,16,Sun,L 7-19,,10,67,7,46,17,113
1423,SDG,2016,2016-09-25,4:25,4:25,@,IND,3,3,Sun,L 22-26,,10,80,11,66,21,146
1424,SDG,2016,2016-11-27,1:00,12:00,@,HOU,12,11,Sun,W 21-13,,10,78,9,58,19,136
1425,SDG,2016,2017-01-01,4:25,1:25,,KAN,17,16,Sun,L 27-37,,10,50,4,19,14,69
1426,LAC,2017,2017-10-29,1:00,1:00,@,NWE,8,8,Sun,L 13-21,,10,77,6,80,16,157
1427,LAC,2018,2018-10-14,1:00,1:00,@,CLE,6,6,Sun,W 38-14,,10,72,6,53,16,125
1428,LAC,2019,2019-09-29,1:00,1:00,@,MIA,4,4,Sun,W 30-10,,10,89,5,53,15,142
1429,LAC,2021,2022-01-09,4:25,1:25,@,LVR,18,17,Sun,L 32-35,OT,10,108,4,38,14,146
1430,SEA,2000,2000-10-22,4:05,1:05,@,OAK,8,8,Sun,L 3-31,,10,68,10,90,20,158
1431,SEA,2000,2000-10-29,4:16,1:16,,KAN,9,9,Sun,L 19-24,,10,99,7,53,17,152
1432,SEA,2002,2002-10-14,9:09,6:09,,SFO,6,5,Mon,L 21-28,,10,80,8,51,18,131
1433,SEA,2005,2005-09-18,4:06,1:06,,ATL,2,2,Sun,W 21-18,,10,79,3,24,13,103
1434,SEA,2006,2006-10-15,1:02,12:02,@,STL,6,5,Sun,W 30-28,,10,65,6,72,16,137
1435,SEA,2006,2006-11-06,8:40,5:40,,OAK,9,8,Mon,W 16-0,,10,80,8,60,18,140
1436,SEA,2006,2006-12-03,8:20,6:20,@,DEN,13,12,Sun,W 23-20,,10,80,3,25,13,105
1437,SEA,2008,2008-09-14,4:06,1:06,,SFO,2,2,Sun,L 30-33,OT,10,75,9,60,19,135
1438,SEA,2009,2009-11-22,1:05,12:05,@,MIN,11,10,Sun,L 9-35,,10,64,5,31,15,95
1439,SEA,2010,2010-10-24,4:06,1:06,,ARI,7,6,Sun,W 22-10,,10,95,5,32,15,127
1440,SEA,2010,2010-12-19,4:06,1:06,,ATL,15,14,Sun,L 18-34,,10,76,4,35,14,111
1441,SEA,2011,2011-10-09,1:04,1:04,@,NYG,5,5,Sun,W 36-25,,10,70,7,52,17,122
1442,SEA,2011,2011-11-06,1:02,12:02,@,DAL,9,8,Sun,L 13-23,,10,88,7,82,17,170
1443,SEA,2012,2012-11-25,1:03,1:03,@,MIA,12,11,Sun,L 21-24,,10,59,2,15,12,74
1444,SEA,2012,2012-12-09,4:26,1:26,,ARI,14,13,Sun,W 58-0,,10,97,9,79,19,176
1445,SEA,2012,2012-12-30,4:26,1:26,,STL,17,16,Sun,W 20-13,,10,80,14,98,24,178
1446,SEA,2013,2013-09-15,8:31,5:31,,SFO,2,2,Sun,W 29-3,,10,84,12,121,22,205
1447,SEA,2013,2013-10-17,8:25,5:25,@,ARI,7,7,Thu,W 34-22,,10,70,3,22,13,92
1448,SEA,2013,2013-10-28,8:30,7:30,@,STL,8,8,Mon,W 14-9,,10,83,8,53,18,136
1449,SEA,2014,2014-10-19,1:00,12:00,@,STL,7,6,Sun,L 26-28,,10,86,2,20,12,106
1450,SEA,2015,2015-10-11,1:03,1:03,@,CIN,5,5,Sun,L 24-27,OT,10,112,7,50,17,162
1451,SEA,2015,2015-12-27,4:26,1:26,,STL,16,15,Sun,L 17-23,,10,83,5,60,15,143
1452,SEA,2016,2016-09-18,4:08,1:08,@,LAR,2,2,Sun,L 3-9,,10,114,9,78,19,192
1453,SEA,2016,2016-10-23,8:30,5:30,@,ARI,7,6,Sun,T 6-6,OT,10,90,6,45,16,135
1454,SEA,2016,2016-11-07,8:30,5:30,,BUF,9,8,Mon,W 31-25,,10,75,11,115,21,190
1455,SEA,2017,2017-10-29,4:05,1:05,,HOU,8,7,Sun,W 41-38,,10,120,8,93,18,213
1456,SEA,2018,2018-09-23,4:25,1:25,,DAL,3,3,Sun,W 24-13,,10,67,7,55,17,122
1457,SEA,2018,2018-11-04,4:05,1:05,,LAC,9,8,Sun,L 17-25,,10,83,12,105,22,188
1458,SEA,2018,2018-12-02,4:25,1:25,,SFO,13,12,Sun,W 43-16,,10,100,13,128,23,228
1459,SEA,2019,2019-09-15,1:00,1:00,@,PIT,2,2,Sun,W 28-26,,10,93,5,78,15,171
1460,SEA,2019,2019-10-13,1:00,1:00,@,CLE,6,6,Sun,W 32-28,,10,65,9,83,19,148
1461,SEA,2021,2021-09-19,4:25,1:25,,TEN,2,2,Sun,L 30-33,OT,10,100,5,45,15,145
1462,SFO,2001,2001-11-18,1:02,1:02,@,CAR,10,9,Sun,W 25-22,OT,10,70,8,60,18,130
1463,SFO,2002,2002-09-15,4:00,1:00,,DEN,2,2,Sun,L 14-24,,10,114,3,30,13,144
1464,SFO,2004,2004-09-12,4:19,1:19,,ATL,1,1,Sun,L 19-21,,10,57,7,72,17,129
1465,SFO,2004,2004-09-19,1:03,12:03,@,NOR,2,2,Sun,L 27-30,,10,125,9,86,19,211
1466,SFO,2005,2005-11-13,1:03,12:03,@,CHI,10,9,Sun,L 9-17,,10,80,5,34,15,114
1467,SFO,2006,2006-12-14,8:13,5:13,@,SEA,15,14,Thu,W 24-14,,10,87,3,20,13,107
1468,SFO,2007,2007-11-12,8:41,5:41,@,SEA,10,9,Mon,L 0-24,,10,53,4,39,14,92
1469,SFO,2008,2008-10-12,4:15,1:15,,PHI,6,6,Sun,L 26-40,,10,58,2,10,12,68
1470,SFO,2008,2008-11-10,8:40,6:40,@,ARI,10,9,Mon,L 24-29,,10,93,10,71,20,164
1471,SFO,2010,2010-10-10,8:30,5:30,,PHI,5,5,Sun,L 24-27,,10,65,5,30,15,95
1472,SFO,2012,2012-10-29,8:40,5:40,@,ARI,8,8,Mon,W 24-3,,10,80,7,51,17,131
1473,SFO,2012,2012-11-25,4:25,3:25,@,NOR,12,11,Sun,W 31-21,,10,68,4,53,14,121
1474,SFO,2013,2013-09-26,8:25,7:25,@,STL,4,4,Thu,W 35-11,,10,85,8,82,18,167
1475,SFO,2014,2014-09-28,4:25,1:25,,PHI,4,4,Sun,W 26-21,,10,80,10,70,20,150
1476,SFO,2014,2014-12-28,4:25,1:25,,ARI,17,16,Sun,W 20-17,,10,78,3,21,13,99
1477,SFO,2016,2016-11-20,4:25,1:25,,NWE,11,10,Sun,L 17-30,,10,68,5,40,15,108
1478,SFO,2017,2017-09-10,4:25,1:25,,CAR,1,1,Sun,L 3-23,,10,74,5,40,15,114
1479,SFO,2017,2017-09-21,8:25,5:25,,LAR,3,3,Thu,L 39-41,,10,55,7,52,17,107
1480,SFO,2017,2017-10-08,1:00,1:00,@,IND,5,5,Sun,L 23-26,OT,10,77,7,62,17,139
1481,SFO,2018,2018-11-12,8:15,5:15,,NYG,10,10,Mon,L 23-27,,10,97,8,78,18,175
1482,SFO,2019,2019-11-17,4:05,1:05,,ARI,11,10,Sun,W 36-26,,10,127,10,104,20,231
1483,SFO,2019,2019-12-08,1:00,12:00,@,NOR,14,13,Sun,W 48-46,,10,67,5,50,15,117
1484,SFO,2021,2021-12-05,4:00,1:00,@,SEA,13,12,Sun,L 23-30,,10,86,6,40,16,126
1485,TAM,2002,2002-09-15,1:02,1:02,@,BAL,2,2,Sun,W 25-0,,10,74,3,25,13,99
1486,TAM,2003,2003-09-21,1:03,1:03,@,ATL,3,3,Sun,W 31-10,,10,123,5,35,15,158
1487,TAM,2004,2004-11-07,1:00,1:00,,KAN,9,8,Sun,W 34-31,,10,95,10,97,20,192
1488,TAM,2004,2004-12-26,4:15,4:15,,CAR,16,15,Sun,L 20-37,,10,77,5,52,15,129
1489,TAM,2005,2006-01-01,1:02,1:02,,NOR,17,16,Sun,W 27-13,,10,107,7,53,17,160
1490,TAM,2010,2010-11-14,1:02,1:02,,CAR,10,9,Sun,W 31-16,,10,80,7,71,17,151
1491,TAM,2012,2012-09-23,1:05,12:05,@,DAL,3,3,Sun,L 10-16,,10,69,13,105,23,174
1492,TAM,2012,2012-09-30,4:25,4:25,,WAS,4,4,Sun,L 22-24,,10,107,8,73,18,180
1493,TAM,2013,2013-09-15,4:05,4:05,,NOR,2,2,Sun,L 14-16,,10,118,5,35,15,153
1494,TAM,2014,2014-11-09,1:04,1:04,,ATL,10,9,Sun,L 17-27,,10,79,5,30,15,109
1495,TAM,2015,2015-09-27,1:03,12:03,@,HOU,3,3,Sun,L 9-19,,10,84,6,58,16,142
1496,TAM,2015,2015-10-11,1:02,1:02,,JAX,5,5,Sun,W 38-31,,10,72,3,12,13,84
1497,TAM,2018,2018-12-09,1:00,1:00,,NOR,14,13,Sun,L 14-28,,10,84,6,51,16,135
1498,TAM,2019,2019-11-03,4:05,1:05,@,SEA,9,8,Sun,L 34-40,OT,10,82,4,45,14,127
1499,WAS,2004,2004-10-31,1:03,1:03,,GNB,8,7,Sun,L 14-28,,10,82,9,73,19,155
1500,WAS,2005,2005-10-09,4:15,2:15,@,DEN,5,4,Sun,L 19-21,,10,67,6,43,16,110
1501,WAS,2005,2005-10-30,1:06,1:06,@,NYG,8,7,Sun,L 0-36,,10,88,9,73,19,161
1502,WAS,2006,2006-10-22,4:15,4:15,@,IND,7,7,Sun,L 22-36,,10,91,3,27,13,118
1503,WAS,2006,2006-12-30,8:05,8:05,,NYG,17,16,Sat,L 28-34,,10,100,5,41,15,141
1504,WAS,2009,2009-11-08,1:03,1:03,@,ATL,9,8,Sun,L 17-31,,10,88,7,54,17,142
1505,WAS,2010,2010-10-31,1:02,1:02,@,DET,8,8,Sun,L 25-37,,10,77,7,65,17,142
1506,WAS,2011,2011-10-02,1:00,12:00,@,STL,4,4,Sun,W 17-10,,10,96,9,65,19,161
1507,WAS,2011,2011-11-27,4:07,1:07,@,SEA,12,11,Sun,W 23-17,,10,115,9,91,19,206
1508,WAS,2013,2013-09-09,7:10,7:10,,PHI,1,1,Mon,L 27-33,,10,75,8,65,18,140
1509,WAS,2014,2014-09-21,1:02,1:02,@,PHI,3,3,Sun,L 34-37,,10,131,9,70,19,201
1510,WAS,2014,2014-11-30,1:02,1:02,@,IND,13,12,Sun,L 27-49,,10,78,10,94,20,172
1511,WAS,2014,2014-12-14,1:02,1:02,@,NYG,15,14,Sun,L 13-24,,10,135,9,60,19,195
1512,WAS,2015,2015-10-04,1:03,1:03,,PHI,4,4,Sun,W 23-20,,10,110,8,72,18,182
1513,WAS,2017,2017-09-24,8:30,8:30,,OAK,3,3,Sun,W 27-10,,10,77,4,35,14,112
1514,WAS,2018,2018-11-04,1:00,1:00,,ATL,9,8,Sun,L 14-38,,10,147,7,50,17,197
1515,WAS,2018,2018-12-03,8:15,8:15,@,PHI,13,12,Mon,L 13-28,,10,69,5,38,15,107
1516,ATL,2001,2001-09-30,4:05,1:05,@,ARI,3,3,Sun,W 34-14,,9,98,3,30,12,128
1517,ATL,2001,2001-11-18,1:02,12:02,@,GNB,10,9,Sun,W 23-20,,9,70,3,25,12,95
1518,ATL,2002,2002-10-20,1:05,1:05,,CAR,7,6,Sun,W 30-0,,9,65,6,40,15,105
1519,ATL,2002,2002-11-17,1:05,1:05,,NOR,11,10,Sun,W 24-17,,9,69,16,133,25,202
1520,ATL,2003,2003-09-28,4:15,4:15,@,CAR,4,4,Sun,L 3-23,,9,84,4,40,13,124
1521,ATL,2004,2004-12-12,1:03,1:03,,OAK,14,13,Sun,W 35-10,,9,75,9,59,18,134
1522,ATL,2005,2005-12-12,9:05,9:05,,NOR,14,13,Mon,W 36-17,,9,74,10,107,19,181
1523,ATL,2006,2006-10-29,1:02,1:02,@,CIN,8,7,Sun,W 29-27,,9,75,4,30,13,105
1524,ATL,2006,2006-11-05,1:03,1:03,@,DET,9,8,Sun,L 14-30,,9,76,10,71,19,147
1525,ATL,2006,2006-12-31,4:13,4:13,@,PHI,17,16,Sun,L 17-24,,9,99,11,108,20,207
1526,ATL,2007,2007-10-21,1:03,12:03,@,NOR,7,7,Sun,L 16-22,,9,52,6,49,15,101
1527,ATL,2007,2007-11-11,1:03,1:03,@,CAR,10,9,Sun,W 20-13,,9,68,6,43,15,111
1528,ATL,2011,2011-09-11,1:06,12:06,@,CHI,1,1,Sun,L 12-30,,9,65,8,56,17,121
1529,ATL,2013,2013-10-20,1:02,1:02,,TAM,7,6,Sun,W 31-23,,9,101,11,103,20,204
1530,ATL,2014,2014-11-30,4:05,4:05,,ARI,13,12,Sun,W 29-18,,9,76,5,34,14,110
1531,ATL,2016,2016-10-23,4:05,4:05,,SDG,7,7,Sun,L 30-33,OT,9,70,3,14,12,84
1532,ATL,2016,2017-01-01,4:25,4:25,,NOR,17,16,Sun,W 38-32,,9,63,6,70,15,133
1533,ATL,2018,2018-12-30,1:00,1:00,@,TAM,17,16,Sun,W 34-32,,9,85,3,30,12,115
1534,ATL,2019,2019-09-08,1:00,3:00,@,MIN,1,1,Sun,L 12-28,,9,78,11,100,20,178
1535,ATL,2019,2019-12-22,1:00,1:00,,JAX,16,15,Sun,W 24-12,,9,64,6,36,15,100
1536,ATL,2021,2021-11-18,8:20,8:20,,NWE,11,10,Thu,L 0-25,,9,72,5,59,14,131
1537,BUF,2001,2001-10-28,1:15,1:15,@,SDG,7,6,Sun,L 24-27,,9,68,7,62,16,130
1538,BUF,2001,2001-11-11,1:02,1:02,@,NWE,9,8,Sun,L 11-21,,9,75,7,75,16,150
1539,BUF,2001,2001-12-09,1:02,1:02,,CAR,13,12,Sun,W 25-24,,9,125,5,40,14,165
1540,BUF,2001,2001-12-30,1:03,1:03,@,NYJ,16,15,Sun,W 14-9,,9,53,3,25,12,78
1541,BUF,2002,2002-09-29,1:04,1:04,,CHI,4,4,Sun,W 33-27,OT,9,82,5,55,14,137
1542,BUF,2003,2003-10-19,4:15,4:15,,WAS,7,7,Sun,W 24-7,,9,95,9,77,18,172
1543,BUF,2005,2005-11-20,4:15,1:15,@,SDG,11,10,Sun,L 10-48,,9,65,2,10,11,75
1544,BUF,2006,2006-10-22,1:02,1:02,,NWE,7,7,Sun,L 6-28,,9,67,3,25,12,92
1545,BUF,2009,2009-09-14,7:10,7:10,@,NWE,1,1,Mon,L 24-25,,9,71,6,55,15,126
1546,BUF,2011,2011-09-25,1:03,1:03,,NWE,3,3,Sun,W 34-31,,9,77,8,93,17,170
1547,BUF,2011,2011-11-27,1:02,1:02,@,NYJ,12,11,Sun,L 24-28,,9,85,4,40,13,125
1548,BUF,2012,2012-12-02,1:02,1:02,,JAX,13,12,Sun,W 34-18,,9,100,8,74,17,174
1549,BUF,2014,2014-09-07,1:00,12:00,@,CHI,1,1,Sun,W 23-20,OT,9,108,4,43,13,151
1550,BUF,2015,2015-11-29,1:03,12:03,@,KAN,12,11,Sun,L 22-30,,9,91,8,58,17,149
1551,BUF,2016,2016-09-25,1:02,1:02,,ARI,3,3,Sun,W 33-18,,9,75,8,50,17,125
1552,BUF,2016,2016-11-20,1:00,1:00,@,CIN,11,10,Sun,W 16-12,,9,75,4,25,13,100
1553,BUF,2017,2017-10-01,1:00,1:00,@,ATL,4,4,Sun,W 23-17,,9,55,4,45,13,100
1554,BUF,2019,2019-09-15,1:00,1:00,@,NYG,2,2,Sun,W 28-14,,9,65,7,40,16,105
1555,BUF,2019,2019-10-20,1:00,1:00,,MIA,7,6,Sun,W 31-21,,9,83,6,55,15,138
1556,BUF,2020,2020-11-15,4:05,2:05,@,ARI,10,10,Sun,L 30-32,,9,69,7,40,16,109
1557,BUF,2020,2020-11-29,1:00,1:00,,LAC,12,11,Sun,W 27-17,,9,85,5,91,14,176
1558,BUF,2021,2021-10-31,1:00,1:00,,MIA,8,7,Sun,W 26-11,,9,80,9,58,18,138
1559,CAR,2000,2000-09-03,1:01,1:01,@,WAS,1,1,Sun,L 17-20,,9,65,7,64,16,129
1560,CAR,2000,2000-10-29,1:02,1:02,@,ATL,9,8,Sun,L 12-13,,9,58,8,98,17,156
1561,CAR,2003,2003-09-07,1:04,1:04,,JAX,1,1,Sun,W 24-23,,9,83,8,82,17,165
1562,CAR,2003,2003-10-12,1:00,12:00,@,IND,6,5,Sun,W 23-20,OT,9,70,4,30,13,100
1563,CAR,2003,2003-11-30,1:02,1:02,,PHI,13,12,Sun,L 16-25,,9,70,4,35,13,105
1564,CAR,2004,2004-09-13,9:09,9:09,,GNB,1,1,Mon,L 14-24,,9,59,8,77,17,136
1565,CAR,2004,2004-10-10,4:15,2:15,@,DEN,5,4,Sun,L 17-20,,9,88,4,37,13,125
1566,CAR,2006,2006-11-13,8:40,8:40,,TAM,10,9,Mon,W 24-10,,9,70,9,71,18,141
1567,CAR,2006,2006-11-19,1:02,1:02,,STL,11,10,Sun,W 15-0,,9,80,6,40,15,120
1568,CAR,2007,2007-10-14,4:05,1:05,@,ARI,6,6,Sun,W 25-10,,9,65,11,101,20,166
1569,CAR,2009,2009-10-25,4:05,4:05,,BUF,7,6,Sun,L 9-20,,9,67,3,22,12,89
1570,CAR,2009,2009-12-13,1:02,1:02,@,NWE,14,13,Sun,L 10-20,,9,92,4,25,13,117
1571,CAR,2012,2012-09-30,1:03,1:03,@,ATL,4,4,Sun,L 28-30,,9,64,2,15,11,79
1572,CAR,2012,2012-10-21,1:03,1:03,,DAL,7,6,Sun,L 14-19,,9,71,6,43,15,114
1573,CAR,2013,2013-10-06,4:05,1:05,@,ARI,5,4,Sun,L 6-22,,9,79,3,30,12,109
1574,CAR,2014,2014-10-19,1:02,12:02,@,GNB,7,7,Sun,L 17-38,,9,70,5,29,14,99
1575,CAR,2018,2018-09-09,4:25,4:25,,DAL,1,1,Sun,W 16-8,,9,80,10,85,19,165
1576,CAR,2018,2018-11-04,1:00,1:00,,TAM,9,8,Sun,W 42-28,,9,84,8,49,17,133
1577,CAR,2019,2019-10-27,4:05,1:05,@,SFO,8,7,Sun,L 13-51,,9,70,4,31,13,101
1578,CAR,2020,2020-09-20,1:00,1:00,@,TAM,2,2,Sun,L 17-31,,9,77,5,37,14,114
1579,CAR,2021,2021-10-10,1:00,1:00,,PHI,5,5,Sun,L 18-21,,9,69,6,60,15,129
1580,CAR,2021,2021-11-14,4:05,2:05,@,ARI,10,10,Sun,W 34-10,,9,115,4,58,13,173
1581,CHI,2000,2000-09-10,1:01,1:01,@,TAM,2,2,Sun,L 0-41,,9,64,3,20,12,84
1582,CHI,2000,2000-09-24,1:02,12:02,,DET,4,4,Sun,L 14-21,,9,78,6,39,15,117
1583,CHI,2004,2004-09-12,1:05,12:05,,DET,1,1,Sun,L 16-20,,9,95,9,80,18,175
1584,CHI,2004,2004-11-21,1:02,12:02,,IND,11,10,Sun,L 10-41,,9,50,10,91,19,141
1585,CHI,2005,2005-10-23,4:15,3:15,,BAL,7,6,Sun,W 10-6,,9,60,11,100,20,160
1586,CHI,2005,2005-11-20,1:02,12:02,,CAR,11,10,Sun,W 13-3,,9,75,7,62,16,137
1587,CHI,2006,2006-11-12,8:21,8:21,@,NYG,10,9,Sun,W 38-20,,9,80,10,96,19,176
1588,CHI,2006,2006-12-03,1:03,12:03,,MIN,13,12,Sun,W 23-13,,9,65,12,69,21,134
1589,CHI,2007,2007-12-06,8:16,8:16,@,WAS,14,13,Thu,L 16-24,,9,49,7,48,16,97
1590,CHI,2009,2009-10-18,8:30,8:30,@,ATL,6,5,Sun,L 14-21,,9,65,6,70,15,135
1591,CHI,2009,2009-11-08,1:03,12:03,,ARI,9,8,Sun,L 21-41,,9,89,2,15,11,104
1592,CHI,2010,2010-09-12,1:02,12:02,,DET,1,1,Sun,W 19-14,,9,100,7,40,16,140
1593,CHI,2012,2012-10-22,8:40,7:40,,DET,7,6,Mon,W 13-7,,9,49,5,47,14,96
1594,CHI,2014,2014-09-22,8:30,8:30,@,NYJ,3,3,Mon,W 27-19,,9,95,6,78,15,173
1595,CHI,2014,2014-12-04,8:26,7:26,,DAL,14,13,Thu,L 28-41,,9,54,8,97,17,151
1596,CHI,2014,2014-12-15,8:30,7:30,,NOR,15,14,Mon,L 15-31,,9,74,3,25,12,99
1597,CHI,2015,2015-10-18,1:02,1:02,@,DET,6,6,Sun,L 34-37,OT,9,76,10,98,19,174
1598,CHI,2016,2016-11-13,1:00,1:00,@,TAM,10,9,Sun,L 10-36,,9,74,9,85,18,159
1599,CHI,2017,2017-11-26,1:00,1:00,@,PHI,12,11,Sun,L 3-31,,9,56,11,70,20,126
1600,CHI,2019,2019-09-23,8:15,8:15,@,WAS,3,3,Mon,W 31-15,,9,59,9,61,18,120
1601,CHI,2019,2019-11-03,1:00,1:00,@,PHI,9,8,Sun,L 14-22,,9,70,8,75,17,145
1602,CHI,2021,2021-12-20,8:15,7:15,,MIN,15,14,Mon,L 9-17,,9,91,7,54,16,145
1603,CIN,2000,2000-10-22,1:00,1:00,,DEN,8,7,Sun,W 31-21,,9,69,6,38,15,107
1604,CIN,2002,2002-09-08,1:04,1:04,,SDG,1,1,Sun,L 6-34,,9,57,4,39,13,96
1605,CIN,2002,2002-10-27,1:02,1:02,,TEN,8,7,Sun,L 24-30,,9,81,7,40,16,121
1606,CIN,2002,2002-11-03,1:01,12:01,@,HOU,9,8,Sun,W 38-3,,9,100,8,60,17,160
1607,CIN,2002,2002-11-24,1:01,1:01,@,PIT,12,11,Sun,L 21-29,,9,110,5,40,14,150
1608,CIN,2003,2003-12-07,1:02,1:02,@,BAL,14,13,Sun,L 13-31,,9,63,2,20,11,83
1609,CIN,2003,2003-12-28,1:02,1:02,,CLE,17,16,Sun,L 14-22,,9,66,9,69,18,135
1610,CIN,2004,2004-10-25,9:09,9:09,,DEN,7,6,Mon,W 23-10,,9,65,8,88,17,153
1611,CIN,2004,2004-12-12,1:02,1:02,@,NWE,14,13,Sun,L 28-35,,9,75,2,13,11,88
1612,CIN,2005,2005-09-25,1:02,12:02,@,CHI,3,3,Sun,W 24-7,,9,77,7,88,16,165
1613,CIN,2005,2005-11-20,4:15,4:15,,IND,11,10,Sun,L 37-45,,9,85,4,30,13,115
1614,CIN,2006,2006-09-17,1:03,1:03,,CLE,2,2,Sun,W 34-17,,9,49,2,27,11,76
1615,CIN,2006,2006-10-01,4:15,4:15,,NWE,4,4,Sun,L 13-38,,9,74,7,61,16,135
1616,CIN,2007,2007-10-21,4:05,4:05,,NYJ,7,6,Sun,W 38-31,,9,70,5,62,14,132
1617,CIN,2009,2009-12-06,1:02,1:02,,DET,13,12,Sun,W 23-13,,9,75,7,45,16,120
1618,CIN,2009,2009-12-20,4:05,1:05,@,SDG,15,14,Sun,L 24-27,,9,55,4,30,13,85
1619,CIN,2010,2010-09-19,1:02,1:02,,BAL,2,2,Sun,W 15-10,,9,56,5,45,14,101
1620,CIN,2010,2010-10-10,1:03,1:03,,TAM,5,5,Sun,L 21-24,,9,60,3,25,12,85
1621,CIN,2011,2011-11-06,4:05,3:05,@,TEN,9,8,Sun,W 24-17,,9,87,7,100,16,187
1622,CIN,2013,2013-09-16,8:41,8:41,,PIT,2,2,Mon,W 20-10,,9,84,3,29,12,113
1623,CIN,2013,2013-11-10,1:02,1:02,@,BAL,10,10,Sun,L 17-20,OT,9,134,8,65,17,199
1624,CIN,2015,2015-09-20,1:03,1:03,,SDG,2,2,Sun,W 24-19,,9,75,8,64,17,139
1625,CIN,2015,2015-09-27,1:02,1:02,@,BAL,3,3,Sun,W 28-24,,9,67,13,116,22,183
1626,CIN,2015,2015-11-16,8:30,8:30,,HOU,10,9,Mon,L 6-10,,9,70,5,54,14,124
1627,CIN,2016,2016-09-25,1:02,1:02,,DEN,3,3,Sun,L 17-29,,9,69,5,41,14,110
1628,CIN,2016,2016-11-14,8:30,8:30,@,NYG,10,9,Mon,L 20-21,,9,60,2,15,11,75
1629,CIN,2017,2017-09-10,1:00,1:00,,BAL,1,1,Sun,L 0-20,,9,66,11,85,20,151
1630,CIN,2018,2018-09-13,8:20,8:20,,BAL,2,2,Thu,W 34-23,,9,92,7,51,16,143
1631,CIN,2018,2018-12-16,1:00,1:00,,OAK,15,14,Sun,W 30-16,,9,85,8,90,17,175
1632,CIN,2018,2018-12-30,4:25,1:00,@,PIT,17,16,Sun,L 13-16,,9,85,9,70,18,155
1633,CIN,2020,2020-09-27,1:00,1:00,@,PHI,3,3,Sun,T 23-23,OT,9,73,11,93,20,166
1634,CLE,2000,2000-10-15,4:06,2:06,@,DEN,7,7,Sun,L 10-44,,9,116,2,14,11,130
1635,CLE,2000,2000-10-29,1:03,1:03,,CIN,9,9,Sun,L 3-12,,9,71,6,84,15,155
1636,CLE,2000,2000-12-03,4:16,4:16,@,JAX,14,14,Sun,L 0-48,,9,85,9,59,18,144
1637,CLE,2001,2001-09-23,1:13,1:13,,DET,2,2,Sun,W 24-14,,9,50,15,115,24,165
1638,CLE,2001,2001-10-14,1:02,1:02,@,CIN,5,5,Sun,L 14-24,,9,92,10,74,19,166
1639,CLE,2001,2001-11-04,4:15,3:15,@,CHI,8,7,Sun,L 21-27,OT,9,80,6,55,15,135
1640,CLE,2002,2002-10-06,8:36,8:36,,BAL,5,5,Sun,L 21-26,,9,117,7,65,16,182
1641,CLE,2003,2003-09-07,1:06,1:06,,IND,1,1,Sun,L 6-9,,9,64,9,53,18,117
1642,CLE,2003,2003-12-28,1:02,1:02,@,CIN,17,16,Sun,W 22-14,,9,69,9,66,18,135
1643,CLE,2004,2004-11-07,8:36,8:36,@,BAL,9,8,Sun,L 13-27,,9,55,3,25,12,80
1644,CLE,2005,2005-11-06,1:03,1:03,,TEN,9,8,Sun,W 20-14,,9,63,2,15,11,78
1645,CLE,2005,2005-11-13,8:36,8:36,@,PIT,10,9,Sun,L 21-34,,9,75,4,30,13,105
1646,CLE,2005,2006-01-01,1:02,1:02,,BAL,17,16,Sun,W 20-16,,9,64,8,64,17,128
1647,CLE,2006,2006-11-26,1:04,1:04,,CIN,12,11,Sun,L 0-30,,9,93,8,75,17,168
1648,CLE,2007,2007-09-23,4:05,1:05,@,OAK,3,3,Sun,L 24-26,,9,64,7,55,16,119
1649,CLE,2007,2007-12-30,1:03,1:03,,SFO,17,16,Sun,W 20-7,,9,75,4,29,13,104
1650,CLE,2008,2008-09-07,4:16,4:16,,DAL,1,1,Sun,L 10-28,,9,55,11,82,20,137
1651,CLE,2008,2008-09-21,4:16,4:16,@,BAL,3,3,Sun,L 10-28,,9,65,5,40,14,105
1652,CLE,2008,2008-09-28,1:02,1:02,@,CIN,4,4,Sun,W 20-12,,9,52,6,55,15,107
1653,CLE,2008,2008-12-21,1:03,1:03,,CIN,16,15,Sun,L 0-14,,9,65,2,20,11,85
1654,CLE,2010,2010-09-19,1:02,1:02,,KAN,2,2,Sun,L 14-16,,9,78,4,30,13,108
1655,CLE,2011,2011-11-20,1:02,1:02,,JAX,11,10,Sun,W 14-10,,9,70,9,81,18,151
1656,CLE,2011,2011-12-18,4:15,2:15,@,ARI,15,14,Sun,L 17-20,OT,9,74,2,13,11,87
1657,CLE,2012,2012-10-21,1:02,1:02,@,IND,7,7,Sun,L 13-17,,9,75,7,50,16,125
1658,CLE,2012,2012-12-30,1:02,1:02,@,PIT,17,16,Sun,L 10-24,,9,79,3,58,12,137
1659,CLE,2013,2013-09-08,1:02,1:02,,MIA,1,1,Sun,L 10-23,,9,57,10,77,19,134
1660,CLE,2013,2013-10-13,1:02,1:02,,DET,6,6,Sun,L 17-31,,9,87,8,65,17,152
1661,CLE,2013,2013-10-27,1:02,12:02,@,KAN,8,8,Sun,L 17-23,,9,70,5,31,14,101
1662,CLE,2013,2013-12-01,1:02,1:02,,JAX,13,12,Sun,L 28-32,,9,50,5,35,14,85
1663,CLE,2013,2013-12-15,1:03,1:03,,CHI,15,14,Sun,L 31-38,,9,90,7,40,16,130
1664,CLE,2014,2014-12-14,1:02,1:02,,CIN,15,14,Sun,L 0-30,,9,68,5,41,14,109
1665,CLE,2015,2015-10-11,1:02,1:02,@,BAL,5,5,Sun,W 33-30,OT,9,74,12,98,21,172
1666,CLE,2016,2016-11-20,1:00,1:00,,PIT,11,11,Sun,L 9-24,,9,52,8,70,17,122
1667,CLE,2017,2017-12-31,1:00,1:00,@,PIT,17,16,Sun,L 24-28,,9,77,3,15,12,92
1668,CLE,2019,2019-09-16,8:15,8:15,@,NYJ,2,2,Mon,W 23-3,,9,85,12,89,21,174
1669,CLE,2019,2019-10-13,1:00,1:00,,SEA,6,6,Sun,L 28-32,,9,83,10,65,19,148
1670,CLE,2021,2021-10-17,4:05,4:05,,ARI,6,6,Sun,L 14-37,,9,88,5,45,14,133
1671,CLE,2021,2021-10-21,8:20,8:20,,DEN,7,7,Thu,W 17-14,,9,60,2,15,11,75
1672,IND,2002,2002-10-13,12:00,12:00,,BAL,6,5,Sun,W 22-20,,9,70,5,52,14,122
1673,IND,2002,2002-12-01,4:00,4:00,,HOU,13,12,Sun,W 19-3,,9,75,14,92,23,167
1674,IND,2003,2003-09-07,1:06,1:06,@,CLE,1,1,Sun,W 9-6,,9,53,9,64,18,117
1675,IND,2003,2003-12-14,1:00,1:00,,ATL,15,14,Sun,W 38-7,,9,63,6,80,15,143
1676,IND,2004,2004-09-26,4:15,3:15,,GNB,3,3,Sun,W 45-31,,9,70,11,84,20,154
1677,IND,2010,2010-11-01,8:41,8:41,,HOU,8,7,Mon,W 30-17,,9,69,5,30,14,99
1678,IND,2012,2012-10-07,1:03,1:03,,GNB,5,4,Sun,W 30-27,,9,100,9,89,18,189
1679,IND,2014,2014-09-07,8:30,6:30,@,DEN,1,1,Sun,L 24-31,,9,45,7,70,16,115
1680,IND,2016,2016-10-09,1:02,1:02,,CHI,5,5,Sun,W 29-23,,9,68,10,80,19,148
1681,IND,2016,2016-12-11,1:00,1:00,,HOU,14,13,Sun,L 17-22,,9,59,7,124,16,183
1682,IND,2017,2017-11-12,1:00,1:00,,PIT,10,10,Sun,L 17-20,,9,82,9,70,18,152
1683,IND,2017,2017-11-26,1:00,1:00,,TEN,12,11,Sun,L 16-20,,9,67,2,15,11,82
1684,IND,2018,2018-12-09,1:00,12:00,@,HOU,14,13,Sun,W 24-21,,9,59,7,35,16,94
1685,IND,2020,2020-09-20,1:00,1:00,,MIN,2,2,Sun,W 28-11,,9,93,6,45,15,138
1686,IND,2020,2020-11-12,8:20,7:20,@,TEN,10,9,Thu,W 34-17,,9,73,3,30,12,103
1687,IND,2020,2020-12-27,1:00,1:00,@,PIT,16,15,Sun,L 24-28,,9,83,6,49,15,132
1688,IND,2021,2021-10-31,1:00,1:00,,TEN,8,8,Sun,L 31-34,OT,9,75,11,161,20,236
1689,ARI,2000,2000-10-15,4:15,1:15,,PHI,7,6,Sun,L 14-33,,9,65,10,95,19,160
1690,ARI,2000,2000-11-19,1:02,1:02,@,PHI,12,11,Sun,L 9-34,,9,114,5,35,14,149
1691,ARI,2003,2003-11-16,1:03,1:03,@,CLE,11,10,Sun,L 6-44,,9,55,7,64,16,119
1692,ARI,2004,2004-11-07,1:02,1:02,@,MIA,9,8,Sun,W 24-23,,9,45,12,99,21,144
1693,ARI,2004,2004-12-12,4:15,2:15,,SFO,14,13,Sun,L 28-31,OT,9,61,7,70,16,131
1694,ARI,2005,2005-10-23,4:15,1:15,,TEN,7,6,Sun,W 20-10,,9,71,11,90,20,161
1695,ARI,2005,2005-11-06,4:05,2:05,,SEA,9,8,Sun,L 19-33,,9,78,6,52,15,130
1696,ARI,2005,2005-11-13,1:03,1:03,@,DET,10,9,Sun,L 21-29,,9,80,7,50,16,130
1697,ARI,2005,2005-12-24,4:05,2:05,,PHI,16,15,Sat,W 27-21,,9,83,10,103,19,186
1698,ARI,2006,2006-10-16,8:42,5:42,,CHI,6,6,Mon,L 23-24,,9,65,6,50,15,115
1699,ARI,2006,2006-10-29,1:02,12:02,@,GNB,8,8,Sun,L 14-31,,9,68,10,65,19,133
1700,ARI,2006,2006-12-10,4:05,2:05,,SEA,14,13,Sun,W 27-21,,9,77,6,40,15,117
1701,ARI,2006,2006-12-31,4:15,1:15,@,SDG,17,16,Sun,L 20-27,,9,93,1,15,10,108
1702,ARI,2007,2007-10-21,1:02,1:02,@,WAS,7,7,Sun,L 19-21,,9,75,6,53,15,128
1703,ARI,2007,2007-11-11,4:15,2:15,,DET,10,9,Sun,W 31-21,,9,70,10,70,19,140
1704,ARI,2011,2011-10-23,4:05,1:05,,PIT,7,6,Sun,L 20-32,,9,74,9,69,18,143
1705,ARI,2011,2012-01-01,4:15,2:15,,SEA,17,16,Sun,W 23-20,OT,9,76,7,55,16,131
1706,ARI,2012,2012-10-21,1:05,12:05,@,MIN,7,7,Sun,L 14-21,,9,82,7,35,16,117
1707,ARI,2012,2012-12-09,4:26,1:26,@,SEA,14,13,Sun,L 0-58,,9,79,10,97,19,176
1708,ARI,2013,2013-11-24,4:05,2:05,,IND,12,11,Sun,W 40-11,,9,84,6,89,15,173
1709,ARI,2013,2013-12-15,4:27,3:27,@,TEN,15,14,Sun,W 37-34,OT,9,69,3,16,12,85
1710,ARI,2015,2015-10-11,4:05,4:05,@,DET,5,5,Sun,W 42-17,,9,70,9,85,18,155
1711,ARI,2015,2015-10-18,1:04,1:04,@,PIT,6,6,Sun,L 13-25,,9,111,6,48,15,159
1712,ARI,2015,2015-11-15,8:35,5:35,@,SEA,10,9,Sun,W 39-32,,9,66,14,131,23,197
1713,ARI,2016,2016-10-17,8:30,5:30,,NYJ,6,6,Mon,W 28-3,,9,64,10,83,19,147
1714,ARI,2017,2017-11-09,8:25,6:25,,SEA,10,9,Thu,L 16-22,,9,58,12,108,21,166
1715,ARI,2018,2018-09-09,4:25,2:25,,WAS,1,1,Sun,L 6-24,,9,67,9,63,18,130
1716,ARI,2018,2018-09-16,4:05,1:05,@,LAR,2,2,Sun,L 0-34,,9,47,5,49,14,96
1717,ARI,2018,2018-10-28,4:25,2:25,,SFO,8,8,Sun,W 18-15,,9,62,5,59,14,121
1718,ARI,2019,2019-10-31,8:20,6:20,,SFO,9,9,Thu,L 25-28,,9,65,8,75,17,140
1719,ARI,2020,2020-09-13,4:25,1:25,@,SFO,1,1,Sun,W 24-20,,9,102,5,53,14,155
1720,ARI,2020,2020-12-20,4:05,2:05,,PHI,15,14,Sun,W 33-26,,9,83,9,69,18,152
1721,ARI,2021,2021-11-07,4:25,1:25,@,SFO,9,9,Sun,W 31-17,,9,84,3,35,12,119
1722,DAL,2000,2000-09-03,4:05,3:05,,PHI,1,1,Sun,L 14-41,,9,93,4,25,13,118
1723,DAL,2000,2000-10-15,1:03,1:03,@,NYG,7,6,Sun,L 14-19,,9,81,9,72,18,153
1724,DAL,2001,2001-12-23,4:06,2:06,@,ARI,15,14,Sun,L 10-17,,9,65,5,27,14,92
1725,DAL,2001,2002-01-06,1:03,1:03,@,DET,17,16,Sun,L 10-15,,9,99,1,5,10,104
1726,DAL,2002,2002-09-08,8:36,7:36,@,HOU,1,1,Sun,L 10-19,,9,117,11,80,20,197
1727,DAL,2002,2002-10-13,1:03,12:03,,CAR,6,6,Sun,W 14-13,,9,71,14,106,23,177
1728,DAL,2002,2002-12-29,1:02,1:02,@,WAS,17,16,Sun,L 14-20,,9,86,8,55,17,141
1729,DAL,2003,2003-12-07,1:03,1:03,@,PHI,14,13,Sun,L 10-36,,9,62,3,25,12,87
1730,DAL,2004,2004-09-12,4:15,3:15,@,MIN,1,1,Sun,L 17-35,,9,119,5,40,14,159
1731,DAL,2005,2005-10-23,4:06,1:06,@,SEA,7,7,Sun,L 10-13,,9,81,9,83,18,164
1732,DAL,2005,2005-12-18,4:16,4:16,@,WAS,15,14,Sun,L 7-35,,9,56,7,55,16,111
1733,DAL,2006,2006-09-10,4:15,4:15,@,JAX,1,1,Sun,L 17-24,,9,93,2,41,11,134
1734,DAL,2006,2006-09-17,8:20,7:20,,WAS,2,2,Sun,W 27-10,,9,90,11,117,20,207
1735,DAL,2006,2006-10-15,1:02,12:02,,HOU,6,5,Sun,W 34-6,,9,73,7,55,16,128
1736,DAL,2006,2006-10-29,8:20,8:20,@,CAR,8,7,Sun,W 35-14,,9,86,5,44,14,130
1737,DAL,2008,2008-11-02,4:15,4:15,@,NYG,9,9,Sun,L 14-35,,9,55,8,65,17,120
1738,DAL,2009,2009-09-28,8:40,7:40,,CAR,3,3,Mon,W 21-7,,9,80,6,60,15,140
1739,DAL,2010,2010-12-19,1:03,12:03,,WAS,15,14,Sun,W 33-30,,9,70,3,25,12,95
1740,DAL,2011,2011-11-20,1:03,1:03,@,WAS,11,10,Sun,W 27-24,OT,9,48,6,59,15,107
1741,DAL,2012,2012-11-18,1:04,12:04,,CLE,11,10,Sun,W 23-20,OT,9,92,12,129,21,221
1742,DAL,2013,2013-10-06,4:25,3:25,,DEN,5,5,Sun,L 48-51,,9,81,5,55,14,136
1743,DAL,2014,2014-11-09,1:06,6:06,@,JAX,10,10,Sun,W 31-17,,9,65,2,19,11,84
1744,DAL,2017,2017-09-25,8:30,6:30,@,ARI,3,3,Mon,W 28-17,,9,76,6,50,15,126
1745,DAL,2018,2018-12-16,1:00,1:00,@,IND,15,14,Sun,L 0-23,,9,74,6,55,15,129
1746,DAL,2019,2019-10-13,4:25,4:25,@,NYJ,6,6,Sun,L 22-24,,9,68,8,105,17,173
1747,DEN,2000,2000-10-08,4:15,1:15,@,SDG,6,6,Sun,W 21-7,,9,113,6,57,15,170
1748,DEN,2002,2002-09-22,4:05,2:05,,BUF,3,3,Sun,W 28-23,,9,64,10,82,19,146
1749,DEN,2002,2002-09-30,9:08,9:08,@,BAL,4,4,Mon,L 23-34,,9,91,9,62,18,153
1750,DEN,2002,2002-10-13,8:35,6:35,,MIA,6,6,Sun,L 22-24,,9,70,8,42,17,112
1751,DEN,2002,2002-11-24,8:36,6:36,,IND,12,11,Sun,L 20-23,OT,9,58,4,31,13,89
1752,DEN,2002,2002-12-01,4:05,1:05,@,SDG,13,12,Sun,L 27-30,OT,9,57,1,5,10,62
1753,DEN,2004,2004-10-17,4:15,1:15,@,OAK,6,6,Sun,W 31-3,,9,85,9,81,18,166
1754,DEN,2004,2004-10-31,4:05,2:05,,ATL,8,8,Sun,L 28-41,,9,70,7,56,16,126
1755,DEN,2005,2005-12-17,8:36,8:36,@,BUF,15,14,Sat,W 28-17,,9,90,12,82,21,172
1756,DEN,2007,2007-10-29,8:40,6:40,,GNB,8,7,Mon,L 13-19,OT,9,63,13,103,22,166
1757,DEN,2009,2009-11-22,4:15,2:15,,SDG,11,10,Sun,L 3-32,,9,65,1,15,10,80
1758,DEN,2009,2009-12-27,4:16,4:16,@,PHI,16,15,Sun,L 27-30,,9,95,9,59,18,154
1759,DEN,2011,2011-11-27,4:15,1:15,@,SDG,12,11,Sun,W 16-13,OT,9,63,4,30,13,93
1760,DEN,2013,2013-11-24,8:30,8:30,@,NWE,12,11,Sun,L 31-34,OT,9,85,5,36,14,121
1761,DEN,2014,2014-10-23,8:26,6:26,,SDG,8,7,Thu,W 35-21,,9,71,7,77,16,148
1762,DEN,2014,2014-11-23,4:25,2:25,,MIA,12,11,Sun,W 39-36,,9,98,6,50,15,148
1763,DEN,2015,2015-09-27,8:30,8:30,@,DET,3,3,Sun,W 24-12,,9,94,9,75,18,169
1764,DEN,2016,2016-10-02,4:05,4:05,@,TAM,4,4,Sun,W 27-7,,9,88,9,69,18,157
1765,DEN,2016,2016-12-11,1:00,12:00,@,TEN,14,13,Sun,L 10-13,,9,87,5,55,14,142
1766,DEN,2016,2016-12-25,8:30,7:30,@,KAN,16,15,Sun,L 10-33,,9,70,8,65,17,135
1767,DEN,2017,2017-11-26,4:25,1:25,@,OAK,12,11,Sun,L 14-21,,9,75,7,68,16,143
1768,DEN,2017,2017-12-03,1:00,1:00,@,MIA,13,12,Sun,L 9-35,,9,57,7,85,16,142
1769,DEN,2019,2019-12-29,4:25,2:25,,OAK,17,16,Sun,W 16-15,,9,61,10,107,19,168
1770,DET,2000,2000-10-01,1:01,1:01,,MIN,5,5,Sun,L 24-31,,9,55,10,72,19,127
1771,DET,2000,2000-10-29,2:00,1:00,@,IND,9,8,Sun,L 18-30,,9,57,3,20,12,77
1772,DET,2000,2000-11-12,1:01,1:01,,ATL,11,10,Sun,W 13-10,,9,70,10,82,19,152
1773,DET,2001,2001-10-28,1:00,1:00,,CIN,7,6,Sun,L 27-31,,9,96,5,50,14,146
1774,DET,2002,2002-12-22,1:03,1:03,@,ATL,16,15,Sun,L 15-36,,9,86,7,55,16,141
1775,DET,2003,2003-09-21,1:03,1:03,,MIN,3,3,Sun,L 13-23,,9,56,11,125,20,181
1776,DET,2003,2003-10-19,1:03,1:03,,DAL,7,6,Sun,L 7-38,,9,96,6,65,15,161
1777,DET,2003,2003-10-26,1:03,12:03,@,CHI,8,7,Sun,L 16-24,,9,64,7,60,16,124
1778,DET,2004,2004-09-12,1:05,12:05,@,CHI,1,1,Sun,W 20-16,,9,80,9,95,18,175
1779,DET,2004,2004-11-21,1:00,12:00,@,MIN,11,10,Sun,L 19-22,,9,116,7,51,16,167
1780,DET,2005,2005-11-24,12:40,12:40,,ATL,12,11,Thu,L 7-27,,9,50,11,84,20,134
1781,DET,2006,2006-10-22,1:03,1:03,@,NYJ,7,7,Sun,L 24-31,,9,60,2,20,11,80
1782,DET,2007,2007-09-23,1:02,1:02,@,PHI,3,3,Sun,L 21-56,,9,65,5,35,14,100
1783,DET,2007,2007-09-30,1:03,1:03,,CHI,4,4,Sun,W 37-27,,9,59,14,102,23,161
1784,DET,2008,2008-09-21,4:06,1:06,@,SFO,3,3,Sun,L 13-31,,9,61,3,30,12,91
1785,DET,2009,2009-11-08,4:06,1:06,@,SEA,9,8,Sun,L 20-32,,9,77,6,45,15,122
1786,DET,2010,2010-09-19,1:02,1:02,,PHI,2,2,Sun,L 32-35,,9,51,9,75,18,126
1787,DET,2011,2011-12-18,4:05,1:05,@,OAK,15,14,Sun,W 28-27,,9,72,10,86,19,158
1788,DET,2013,2013-12-08,1:02,1:02,@,PHI,14,13,Sun,L 20-34,,9,48,1,5,10,53
1789,DET,2014,2014-10-19,1:02,1:02,,NOR,7,7,Sun,W 24-23,,9,71,12,134,21,205
1790,DET,2014,2014-11-16,4:25,2:25,@,ARI,11,10,Sun,L 6-14,,9,80,4,35,13,115
1791,DET,2014,2014-11-23,1:02,1:02,@,NWE,12,11,Sun,L 9-34,,9,54,11,89,20,143
1792,DET,2014,2014-12-07,1:02,1:02,,TAM,14,13,Sun,W 34-17,,9,122,5,50,14,172
1793,DET,2015,2015-09-27,8:30,8:30,,DEN,3,3,Sun,L 12-24,,9,75,9,94,18,169
1794,DET,2015,2015-10-11,4:05,4:05,,ARI,5,5,Sun,L 17-42,,9,85,9,70,18,155
1795,DET,2015,2015-12-03,8:26,8:26,,GNB,13,12,Thu,L 23-27,,9,108,7,55,16,163
1796,DET,2017,2017-09-24,1:00,1:00,,ATL,3,3,Sun,L 26-30,,9,98,8,68,17,166
1797,DET,2017,2017-12-24,1:00,1:00,@,CIN,16,15,Sun,L 17-26,,9,74,5,60,14,134
1798,DET,2019,2019-09-08,4:25,2:25,@,ARI,1,1,Sun,T 27-27,OT,9,59,7,35,16,94
1799,DET,2019,2019-09-22,1:00,1:00,@,PHI,3,3,Sun,W 27-24,,9,61,4,30,13,91
1800,DET,2019,2019-11-28,12:30,12:30,,CHI,13,12,Thu,L 20-24,,9,85,10,89,19,174
1801,DET,2020,2020-11-15,1:00,1:00,,WAS,10,9,Sun,W 30-27,,9,55,6,58,15,113
1802,DET,2021,2021-09-20,8:15,7:15,@,GNB,2,2,Mon,L 17-35,,9,78,5,50,14,128
1803,DET,2021,2021-10-17,1:00,1:00,,CIN,6,6,Sun,L 11-34,,9,77,4,31,13,108
1804,GNB,2000,2000-10-15,4:15,3:15,,SFO,7,7,Sun,W 31-28,,9,65,4,53,13,118
1805,GNB,2001,2001-12-03,9:07,9:07,@,JAX,12,11,Mon,W 28-21,,9,81,13,111,22,192
1806,GNB,2002,2002-11-04,9:08,8:08,,MIA,9,8,Mon,W 24-10,,9,71,6,55,15,126
1807,GNB,2003,2003-12-14,4:15,1:15,@,SDG,15,14,Sun,W 38-21,,9,96,9,69,18,165
1808,GNB,2004,2004-10-31,1:03,1:03,@,WAS,8,8,Sun,W 28-14,,9,73,10,82,19,155
1809,GNB,2004,2004-12-12,4:15,3:15,,DET,14,13,Sun,W 16-13,,9,94,10,85,19,179
1810,GNB,2005,2005-12-04,1:05,12:05,@,CHI,13,12,Sun,L 7-19,,9,70,4,61,13,131
1811,GNB,2005,2005-12-25,5:11,4:11,,CHI,16,15,Sun,L 17-24,,9,69,8,55,17,124
1812,GNB,2006,2006-10-22,1:02,1:02,@,MIA,7,6,Sun,W 34-24,,9,74,8,70,17,144
1813,GNB,2006,2006-12-17,1:02,12:02,,DET,15,14,Sun,W 17-9,,9,69,6,37,15,106
1814,GNB,2007,2007-11-22,12:36,12:36,@,DET,12,11,Thu,W 37-26,,9,81,7,59,16,140
1815,GNB,2007,2007-11-29,8:16,7:16,@,DAL,13,12,Thu,L 27-37,,9,142,10,65,19,207
1816,GNB,2007,2007-12-09,1:02,12:02,,OAK,14,13,Sun,W 38-7,,9,84,9,62,18,146
1817,GNB,2008,2008-10-05,1:02,12:02,,ATL,5,5,Sun,L 24-27,,9,97,2,15,11,112
1818,GNB,2008,2008-10-19,4:15,3:15,,IND,7,7,Sun,W 34-14,,9,70,12,110,21,180
1819,GNB,2010,2010-10-10,1:02,1:02,@,WAS,5,5,Sun,L 13-16,OT,9,63,4,28,13,91
1820,GNB,2012,2012-10-07,1:03,1:03,@,IND,5,5,Sun,L 27-30,,9,89,9,100,18,189
1821,GNB,2012,2012-11-18,1:02,1:02,@,DET,11,10,Sun,W 24-20,,9,80,7,50,16,130
1822,GNB,2013,2013-12-22,4:25,3:25,,PIT,16,15,Sun,L 31-38,,9,90,7,58,16,148
1823,GNB,2014,2014-09-28,1:02,12:02,@,CHI,4,4,Sun,W 38-17,,9,70,6,46,15,116
1824,GNB,2014,2014-12-14,1:02,1:02,@,BUF,15,14,Sun,L 13-21,,9,70,10,75,19,145
1825,GNB,2016,2016-10-20,8:26,7:26,,CHI,7,6,Thu,W 26-10,,9,56,10,108,19,164
1826,GNB,2019,2019-10-06,4:25,3:25,@,DAL,5,5,Sun,W 34-24,,9,78,11,124,20,202
1827,GNB,2019,2019-12-29,1:00,1:00,@,DET,17,16,Sun,W 23-20,,9,97,4,50,13,147
1828,GNB,2020,2020-11-01,1:00,12:00,,MIN,8,7,Sun,L 22-28,,9,85,7,36,16,121
1829,HOU,2002,2002-09-22,1:01,12:01,,IND,3,3,Sun,L 3-23,,9,67,4,45,13,112
1830,HOU,2002,2002-10-27,4:15,4:15,@,JAX,8,7,Sun,W 21-19,,9,60,5,50,14,110
1831,HOU,2002,2002-12-15,1:02,12:02,,BAL,15,14,Sun,L 19-23,,9,58,2,15,11,73
1832,HOU,2003,2003-12-14,1:01,1:01,@,TAM,15,14,Sun,L 3-16,,9,62,3,25,12,87
1833,HOU,2004,2004-09-19,1:04,1:04,@,DET,2,2,Sun,L 16-28,,9,74,8,65,17,139
1834,HOU,2004,2004-11-07,4:15,2:15,@,DEN,9,8,Sun,L 13-31,,9,109,4,50,13,159
1835,HOU,2005,2005-10-02,1:02,1:02,@,CIN,4,3,Sun,L 10-16,,9,90,14,117,23,207
1836,HOU,2007,2007-11-04,4:15,1:15,@,OAK,9,9,Sun,W 24-17,,9,56,6,40,15,96
1837,HOU,2010,2010-12-19,1:02,12:02,@,TEN,15,14,Sun,L 17-31,,9,66,12,76,21,142
1838,HOU,2011,2011-10-02,1:03,12:03,,PIT,4,4,Sun,W 17-10,,9,64,5,45,14,109
1839,HOU,2012,2012-09-23,4:25,2:25,@,DEN,3,3,Sun,W 31-25,,9,69,7,75,16,144
1840,HOU,2012,2012-12-16,1:02,12:02,,IND,15,14,Sun,W 29-17,,9,69,8,79,17,148
1841,HOU,2012,2012-12-23,1:03,12:03,,MIN,16,15,Sun,L 6-23,,9,60,5,52,14,112
1842,HOU,2012,2012-12-30,1:02,1:02,@,IND,17,16,Sun,L 16-28,,9,64,3,24,12,88
1843,HOU,2013,2013-11-17,1:03,12:03,,OAK,11,10,Sun,L 23-28,,9,50,8,77,17,127
1844,HOU,2014,2014-11-02,1:03,12:03,,PHI,9,9,Sun,L 21-31,,9,54,7,55,16,109
1845,HOU,2015,2016-01-03,1:02,12:02,,JAX,17,16,Sun,W 30-6,,9,55,7,53,16,108
1846,HOU,2016,2016-11-27,1:00,12:00,,SDG,12,11,Sun,L 13-21,,9,58,10,78,19,136
1847,HOU,2017,2017-09-10,1:00,12:00,,JAX,1,1,Sun,L 7-29,,9,94,10,89,19,183
1848,HOU,2017,2017-09-14,8:25,8:25,@,CIN,2,2,Thu,W 13-9,,9,61,7,45,16,106
1849,HOU,2019,2019-10-06,1:00,12:00,,ATL,5,5,Sun,W 53-32,,9,89,7,63,16,152
1850,HOU,2019,2019-12-08,1:00,12:00,,DEN,14,13,Sun,L 24-38,,9,44,7,50,16,94
1851,HOU,2021,2021-09-19,1:00,1:00,@,CLE,2,2,Sun,L 21-31,,9,78,5,62,14,140
1852,HOU,2021,2021-12-19,1:00,1:00,@,JAX,15,14,Sun,W 30-16,,9,65,4,40,13,105
1853,JAX,2000,2000-12-03,4:16,4:16,,CLE,14,13,Sun,W 48-0,,9,59,9,85,18,144
1854,JAX,2001,2001-11-25,4:15,4:15,,BAL,11,10,Sun,L 21-24,,9,58,6,39,15,97
1855,JAX,2001,2001-12-16,1:03,1:03,@,CLE,14,13,Sun,W 15-10,,9,85,5,72,14,157
1856,JAX,2003,2003-09-28,1:05,12:05,@,HOU,4,4,Sun,L 20-24,,9,48,4,43,13,91
1857,JAX,2003,2003-12-28,1:03,1:03,@,ATL,17,16,Sun,L 14-21,,9,48,4,35,13,83
1858,JAX,2004,2004-09-12,1:04,1:04,@,BUF,1,1,Sun,W 13-10,,9,50,7,78,16,128
1859,JAX,2004,2004-09-26,1:02,12:02,@,TEN,3,3,Sun,W 15-12,,9,87,6,56,15,143
1860,JAX,2005,2005-09-25,1:03,1:03,@,NYJ,3,3,Sun,W 26-20,OT,9,85,6,44,15,129
1861,JAX,2006,2006-10-08,4:05,4:05,,NYJ,5,5,Sun,W 41-0,,9,62,6,59,15,121
1862,JAX,2006,2006-11-12,1:03,1:03,,HOU,10,9,Sun,L 10-13,,9,65,6,51,15,116
1863,JAX,2006,2006-11-20,8:40,8:40,,NYG,11,10,Mon,W 26-10,,9,65,5,35,14,100
1864,JAX,2008,2008-11-16,4:15,4:15,,TEN,11,10,Sun,L 14-24,,9,61,10,63,19,124
1865,JAX,2009,2009-10-11,4:16,1:16,@,SEA,5,5,Sun,L 0-41,,9,73,1,10,10,83
1866,JAX,2011,2011-11-20,1:02,1:02,@,CLE,11,10,Sun,L 10-14,,9,81,9,70,18,151
1867,JAX,2013,2013-09-29,1:06,1:06,,IND,4,4,Sun,L 3-37,,9,65,7,58,16,123
1868,JAX,2015,2015-09-20,4:05,4:05,,MIA,2,2,Sun,W 23-20,,9,93,13,112,22,205
1869,JAX,2016,2016-09-11,1:04,1:04,,GNB,1,1,Sun,L 23-27,,9,79,5,24,14,103
1870,JAX,2017,2017-09-24,9:30,2:30,,BAL,3,3,Sun,W 44-7,,9,70,10,88,19,158
1871,JAX,2017,2017-11-12,1:00,1:00,,LAC,10,9,Sun,W 20-17,OT,9,106,7,77,16,183
1872,JAX,2018,2018-09-30,1:00,1:00,,NYJ,4,4,Sun,W 31-12,,9,89,6,43,15,132
1873,JAX,2019,2019-09-15,1:00,12:00,@,HOU,2,2,Sun,L 12-13,,9,70,7,47,16,117
1874,JAX,2019,2019-10-06,1:00,1:00,@,CAR,5,5,Sun,L 27-34,,9,84,8,70,17,154
1875,JAX,2019,2019-10-27,1:00,1:00,,NYJ,8,8,Sun,W 29-15,,9,70,10,83,19,153
1876,JAX,2021,2021-12-12,1:00,12:00,@,TEN,14,13,Sun,L 0-20,,9,79,2,15,11,94
1877,KAN,2000,2000-11-05,1:15,1:15,@,OAK,10,9,Sun,L 31-49,,9,80,9,81,18,161
1878,KAN,2001,2001-12-16,1:00,12:00,,DEN,14,13,Sun,W 26-23,OT,9,68,8,146,17,214
1879,KAN,2002,2002-09-08,1:04,1:04,@,CLE,1,1,Sun,W 40-39,,9,87,4,38,13,125
1880,KAN,2004,2004-09-12,8:39,6:39,@,DEN,1,1,Sun,L 24-34,,9,70,4,35,13,105
1881,KAN,2004,2004-09-26,1:00,12:00,,HOU,3,3,Sun,L 21-24,,9,87,7,60,16,147
1882,KAN,2005,2005-09-18,8:30,5:30,@,OAK,2,2,Sun,W 23-17,,9,78,7,84,16,162
1883,KAN,2005,2005-10-30,4:05,1:05,@,SDG,8,7,Sun,L 20-28,,9,59,4,38,13,97
1884,KAN,2005,2005-12-17,5:11,5:11,@,NYG,15,14,Sat,L 17-27,,9,75,7,70,16,145
1885,KAN,2005,2006-01-01,1:00,12:00,,CIN,17,16,Sun,W 37-3,,9,80,6,50,15,130
1886,KAN,2007,2007-09-16,4:15,3:15,@,CHI,2,2,Sun,L 10-20,,9,60,5,55,14,115
1887,KAN,2007,2007-10-14,1:00,12:00,,CIN,6,6,Sun,W 27-20,,9,55,6,59,15,114
1888,KAN,2008,2008-11-23,1:00,12:00,,BUF,12,11,Sun,L 31-54,,9,75,6,45,15,120
1889,KAN,2009,2009-09-20,1:00,12:00,,OAK,2,2,Sun,L 10-13,,9,70,7,45,16,115
1890,KAN,2011,2011-10-31,8:40,7:40,,SDG,8,7,Mon,W 23-20,OT,9,53,12,105,21,158
1891,KAN,2012,2012-09-30,1:03,12:03,,SDG,4,4,Sun,L 20-37,,9,80,7,75,16,155
1892,KAN,2012,2012-12-23,1:03,12:03,,IND,16,15,Sun,L 13-20,,9,75,4,48,13,123
1893,KAN,2013,2013-09-19,8:29,8:29,@,PHI,3,3,Thu,W 26-16,,9,65,6,45,15,110
1894,KAN,2013,2013-10-06,1:03,12:03,@,TEN,5,5,Sun,W 26-17,,9,61,6,35,15,96
1895,KAN,2013,2013-11-17,8:30,6:30,@,DEN,11,10,Sun,L 17-27,,9,53,13,82,22,135
1896,KAN,2013,2013-12-01,4:26,3:26,,DEN,13,12,Sun,L 28-35,,9,102,10,75,19,177
1897,KAN,2014,2014-12-07,4:05,2:05,@,ARI,14,13,Sun,L 14-17,,9,75,6,40,15,115
1898,KAN,2015,2015-09-17,8:29,7:29,,DEN,2,2,Thu,L 24-31,,9,60,8,85,17,145
1899,KAN,2016,2016-09-18,1:02,12:02,@,HOU,2,2,Sun,L 12-19,,9,77,5,44,14,121
1900,KAN,2016,2016-11-13,1:00,1:00,@,CAR,10,9,Sun,W 20-17,,9,45,6,53,15,98
1901,KAN,2016,2016-11-27,8:30,6:30,@,DEN,12,11,Sun,W 30-27,OT,9,71,15,97,24,168
1902,KAN,2016,2016-12-08,8:25,7:25,,OAK,14,13,Thu,W 21-13,,9,73,10,82,19,155
1903,KAN,2017,2017-11-19,1:00,1:00,@,NYG,11,10,Sun,L 9-12,OT,9,87,5,48,14,135
1904,KAN,2019,2019-11-10,1:00,12:00,@,TEN,10,10,Sun,L 32-35,,9,80,8,64,17,144
1905,KAN,2019,2019-12-22,8:20,7:20,@,CHI,16,15,Sun,W 26-3,,9,71,7,50,16,121
1906,KAN,2021,2021-10-24,1:00,12:00,@,TEN,7,7,Sun,L 3-27,,9,77,6,31,15,108
1907,MIA,2001,2001-09-09,8:36,7:36,@,TEN,1,1,Sun,W 31-23,,9,128,12,77,21,205
1908,MIA,2001,2001-10-28,4:15,1:15,@,SEA,7,6,Sun,W 24-20,,9,57,5,40,14,97
1909,MIA,2001,2001-11-11,1:00,1:00,@,IND,9,8,Sun,W 27-24,,9,65,5,25,14,90
1910,MIA,2001,2001-12-22,1:35,1:35,@,NWE,15,14,Sat,L 13-20,,9,67,7,75,16,142
1911,MIA,2002,2002-09-29,1:00,12:00,@,KAN,4,4,Sun,L 30-48,,9,86,10,71,19,157
1912,MIA,2004,2004-12-20,9:09,9:09,,NWE,15,14,Mon,W 29-28,,9,67,4,53,13,120
1913,MIA,2005,2005-10-16,1:02,1:02,@,TAM,6,5,Sun,L 13-27,,9,60,9,65,18,125
1914,MIA,2005,2006-01-01,1:02,1:02,@,NWE,17,16,Sun,W 28-26,,9,77,6,45,15,122
1915,MIA,2007,2007-09-23,1:02,1:02,@,NYJ,3,3,Sun,L 28-31,,9,56,5,26,14,82
1916,MIA,2015,2015-10-04,9:37,2:37,,NYJ,4,4,Sun,L 14-27,,9,80,14,163,23,243
1917,MIA,2015,2015-10-18,1:03,12:03,@,TEN,6,5,Sun,W 38-10,,9,97,7,50,16,147
1918,MIA,2015,2015-11-22,1:03,1:03,,DAL,11,10,Sun,L 14-24,,9,74,10,79,19,153
1919,MIA,2015,2015-12-20,4:25,1:25,@,SDG,15,14,Sun,L 14-30,,9,72,7,48,16,120
1920,MIA,2015,2015-12-27,1:02,1:02,,IND,16,15,Sun,L 12-18,,9,50,6,60,15,110
1921,MIA,2016,2016-12-17,8:25,8:25,@,NYJ,15,14,Sat,W 34-13,,9,70,3,42,12,112
1922,MIA,2016,2017-01-01,1:00,1:00,,NWE,17,16,Sun,L 14-35,,9,73,7,64,16,137
1923,MIA,2017,2017-10-22,1:00,1:00,,NYJ,7,6,Sun,W 31-28,,9,76,12,124,21,200
1924,MIA,2018,2018-09-23,1:00,1:00,,OAK,3,3,Sun,W 28-20,,9,74,8,38,17,112
1925,MIA,2018,2018-10-07,1:00,1:00,@,CIN,5,5,Sun,L 17-27,,9,85,6,47,15,132
1926,MIA,2019,2019-09-08,1:00,1:00,,BAL,1,1,Sun,L 10-59,,9,64,4,40,13,104
1927,MIA,2021,2021-09-19,1:00,1:00,,BUF,2,2,Sun,L 0-35,,9,83,6,53,15,136
1928,MIA,2021,2021-10-31,1:00,1:00,@,BUF,8,8,Sun,L 11-26,,9,58,9,80,18,138
1929,MIN,2000,2000-10-22,1:02,12:02,,BUF,8,7,Sun,W 31-27,,9,55,11,72,20,127
1930,MIN,2001,2001-11-19,9:10,8:10,,NYG,10,9,Mon,W 28-16,,9,75,15,150,24,225
1931,MIN,2003,2003-10-26,1:00,12:00,,NYG,8,7,Sun,L 17-29,,9,52,10,75,19,127
1932,MIN,2004,2004-10-31,1:00,12:00,,NYG,8,7,Sun,L 13-34,,9,83,7,87,16,170
1933,MIN,2004,2004-12-19,1:03,1:03,@,DET,15,14,Sun,W 28-27,,9,70,4,25,13,95
1934,MIN,2004,2004-12-24,3:00,2:00,,GNB,16,15,Fri,L 31-34,,9,78,4,25,13,103
1935,MIN,2005,2005-09-11,1:05,12:05,,TAM,1,1,Sun,L 13-24,,9,70,13,99,22,169
1936,MIN,2006,2006-09-11,7:11,7:11,@,WAS,1,1,Mon,W 19-16,,9,60,7,55,16,115
1937,MIN,2006,2006-09-17,1:03,12:03,,CAR,2,2,Sun,W 16-13,OT,9,54,6,32,15,86
1938,MIN,2008,2008-09-08,7:10,6:10,@,GNB,1,1,Mon,L 19-24,,9,42,12,118,21,160
1939,MIN,2008,2008-09-21,1:05,12:05,,CAR,3,3,Sun,W 20-10,,9,100,12,67,21,167
1940,MIN,2009,2009-09-27,1:03,12:03,,SFO,3,3,Sun,W 27-24,,9,52,7,60,16,112
1941,MIN,2009,2009-12-13,1:05,12:05,,CIN,14,13,Sun,W 30-10,,9,69,11,85,20,154
1942,MIN,2011,2011-09-11,4:20,1:20,@,SDG,1,1,Sun,L 17-24,,9,78,4,26,13,104
1943,MIN,2011,2011-10-23,4:15,3:15,,GNB,7,7,Sun,L 27-33,,9,91,6,44,15,135
1944,MIN,2011,2011-11-20,1:05,12:05,,OAK,11,10,Sun,L 21-27,,9,50,12,117,21,167
1945,MIN,2014,2014-10-02,8:26,7:26,@,GNB,5,5,Thu,L 10-42,,9,91,5,30,14,121
1946,MIN,2014,2014-10-12,1:02,12:02,,DET,6,6,Sun,L 3-17,,9,60,5,40,14,100
1947,MIN,2014,2014-11-02,1:03,12:03,,WAS,9,9,Sun,W 29-26,,9,60,6,55,15,115
1948,MIN,2015,2015-10-04,4:25,2:25,@,DEN,4,4,Sun,L 20-23,,9,63,8,40,17,103
1949,MIN,2015,2015-11-29,1:02,1:02,@,ATL,12,11,Sun,W 20-10,,9,53,6,78,15,131
1950,MIN,2015,2015-12-06,1:02,12:02,,SEA,13,12,Sun,L 7-38,,9,95,9,65,18,160
1951,MIN,2016,2016-10-09,1:05,12:05,,HOU,5,5,Sun,W 31-13,,9,97,4,15,13,112
1952,MIN,2017,2017-10-09,8:30,7:30,@,CHI,5,5,Mon,W 20-17,,9,69,8,55,17,124
1953,MIN,2017,2017-11-23,12:30,12:30,@,DET,12,11,Thu,W 30-23,,9,74,8,54,17,128
1954,MIN,2018,2018-10-14,1:00,3:00,,ARI,6,6,Sun,W 27-17,,9,52,5,30,14,82
1955,MIN,2020,2020-11-08,1:00,3:00,,DET,9,8,Sun,W 34-20,,9,69,3,37,12,106
1956,NOR,2002,2002-09-15,1:04,12:04,,GNB,2,2,Sun,W 35-20,,9,59,7,73,16,132
1957,NOR,2002,2002-10-27,1:03,12:03,,ATL,8,8,Sun,L 35-37,,9,96,10,95,19,191
1958,NOR,2003,2003-09-14,1:02,12:02,,HOU,2,2,Sun,W 31-10,,9,78,11,86,20,164
1959,NOR,2004,2004-09-19,1:03,12:03,,SFO,2,2,Sun,W 30-27,,9,86,10,125,19,211
1960,NOR,2004,2004-12-12,1:05,12:05,@,DAL,14,13,Sun,W 27-13,,9,136,11,76,20,212
1961,NOR,2005,2005-09-11,1:06,1:06,@,CAR,1,1,Sun,W 23-20,,9,74,11,84,20,158
1962,NOR,2005,2005-10-23,1:02,12:02,@,STL,7,7,Sun,L 17-28,,9,102,8,65,17,167
1963,NOR,2005,2005-12-18,1:03,12:03,,CAR,15,14,Sun,L 10-27,,9,72,3,25,12,97
1964,NOR,2006,2006-10-08,1:03,12:03,,TAM,5,5,Sun,W 24-21,,9,49,8,66,17,115
1965,NOR,2009,2009-09-27,4:05,4:05,@,BUF,3,3,Sun,W 27-7,,9,97,12,116,21,213
1966,NOR,2010,2010-10-17,1:02,1:02,@,TAM,6,6,Sun,W 31-6,,9,80,5,30,14,110
1967,NOR,2011,2011-10-09,1:04,1:04,@,CAR,5,5,Sun,W 30-27,,9,82,7,65,16,147
1968,NOR,2013,2013-11-03,1:04,1:04,@,NYJ,9,8,Sun,L 20-26,,9,59,8,62,17,121
1969,NOR,2013,2013-12-29,4:25,3:25,,TAM,17,16,Sun,W 42-17,,9,94,8,78,17,172
1970,NOR,2018,2018-12-17,8:15,8:15,@,CAR,15,14,Mon,W 12-9,,9,80,4,48,13,128
1971,NOR,2018,2018-12-23,4:25,3:25,,PIT,16,15,Sun,W 31-28,,9,91,6,79,15,170
1972,NOR,2019,2019-09-29,8:20,7:20,,DAL,4,4,Sun,W 12-10,,9,80,6,64,15,144
1973,NOR,2019,2019-11-17,1:00,1:00,@,TAM,11,10,Sun,W 34-17,,9,76,7,55,16,131
1974,NOR,2019,2019-11-28,8:20,8:20,@,ATL,13,12,Thu,W 26-18,,9,121,4,18,13,139
1975,NOR,2021,2021-11-14,1:00,12:00,@,TEN,10,9,Sun,L 21-23,,9,65,8,49,17,114
1976,NWE,2000,2000-09-17,4:15,4:15,,MIN,3,3,Sun,L 13-21,,9,64,5,61,14,125
1977,NWE,2000,2000-11-19,1:02,1:02,,CIN,12,11,Sun,W 16-13,,9,69,8,75,17,144
1978,NWE,2000,2000-11-23,12:36,12:36,@,DET,13,12,Thu,L 9-34,,9,81,10,99,19,180
1979,NWE,2000,2000-12-17,1:02,1:02,@,BUF,16,15,Sun,W 13-10,OT,9,75,6,54,15,129
1980,NWE,2001,2001-09-23,4:15,4:15,,NYJ,2,2,Sun,L 3-10,,9,85,6,49,15,134
1981,NWE,2002,2002-11-28,12:38,12:38,@,DET,13,12,Thu,W 20-12,,9,55,8,60,17,115
1982,NWE,2002,2002-12-08,1:02,1:02,,BUF,14,13,Sun,W 27-17,,9,65,4,29,13,94
1983,NWE,2003,2003-09-21,1:02,1:02,,NYJ,3,3,Sun,W 23-16,,9,87,6,52,15,139
1984,NWE,2003,2003-10-05,1:02,1:02,,TEN,5,5,Sun,W 38-30,,9,55,8,66,17,121
1985,NWE,2005,2005-12-11,1:02,1:02,@,BUF,14,13,Sun,W 35-7,,9,83,7,50,16,133
1986,NWE,2006,2006-10-30,8:38,7:38,@,MIN,8,7,Mon,W 31-7,,9,85,6,39,15,124
1987,NWE,2006,2006-12-10,1:02,1:02,@,MIA,14,13,Sun,L 0-21,,9,71,3,30,12,101
1988,NWE,2006,2006-12-31,1:02,12:02,@,TEN,17,16,Sun,W 40-23,,9,129,10,119,19,248
1989,NWE,2010,2010-10-17,1:02,1:02,,BAL,6,5,Sun,W 23-20,OT,9,78,8,67,17,145
1990,NWE,2011,2011-11-13,8:31,8:31,@,NYJ,10,9,Sun,W 37-16,,9,80,5,56,14,136
1991,NWE,2013,2013-09-29,8:30,8:30,@,ATL,4,4,Sun,W 30-23,,9,93,6,55,15,148
1992,NWE,2014,2014-09-07,1:03,1:03,@,MIA,1,1,Sun,L 20-33,,9,100,4,26,13,126
1993,NWE,2014,2014-10-12,1:02,1:02,@,BUF,6,6,Sun,W 37-22,,9,60,8,107,17,167
1994,NWE,2014,2014-10-16,8:25,8:25,,NYJ,7,7,Thu,W 27-25,,9,64,7,70,16,134
1995,NWE,2014,2014-11-02,4:25,4:25,,DEN,9,9,Sun,W 43-21,,9,71,10,72,19,143
1996,NWE,2015,2015-10-11,4:25,3:25,@,DAL,5,4,Sun,W 30-6,,9,65,7,50,16,115
1997,NWE,2016,2016-10-02,1:02,1:02,,BUF,4,4,Sun,L 0-16,,9,74,6,60,15,134
1998,NWE,2017,2017-09-17,1:00,12:00,@,NOR,2,2,Sun,W 36-20,,9,66,5,35,14,101
1999,NWE,2017,2017-12-03,1:00,1:00,@,BUF,13,12,Sun,W 23-3,,9,66,3,34,12,100
2000,NWE,2017,2017-12-11,8:30,8:30,@,MIA,14,13,Mon,L 20-27,,9,78,8,102,17,180
2001,NYG,2000,2000-09-03,1:04,1:04,,ARI,1,1,Sun,W 21-16,,9,68,1,5,10,73
2002,NYG,2000,2000-10-15,1:03,1:03,,DAL,7,7,Sun,W 19-14,,9,72,9,81,18,153
2003,NYG,2002,2002-10-28,9:08,9:08,@,PHI,8,7,Mon,L 3-17,,9,75,9,65,18,140
2004,NYG,2002,2002-11-10,1:00,12:00,@,MIN,10,9,Sun,W 27-20,,9,84,10,84,19,168
2005,NYG,2002,2002-11-24,4:15,3:15,@,HOU,12,11,Sun,L 14-16,,9,65,8,68,17,133
2006,NYG,2003,2003-11-09,1:04,1:04,,ATL,10,9,Sun,L 7-27,,9,70,7,60,16,130
2007,NYG,2003,2003-11-24,9:10,9:10,@,TAM,12,11,Mon,L 13-19,,9,71,5,45,14,116
2008,NYG,2004,2004-10-10,1:03,12:03,@,DAL,5,5,Sun,W 26-10,,9,60,11,74,20,134
2009,NYG,2004,2004-12-12,1:01,1:01,@,BAL,14,13,Sun,L 14-37,,9,65,6,86,15,151
2010,NYG,2004,2004-12-26,1:03,1:03,@,CIN,16,15,Sun,L 22-23,,9,85,3,20,12,105
2011,NYG,2005,2005-09-19,7:36,7:36,@,NOR,2,2,Mon,W 27-10,,9,86,13,92,22,178
2012,NYG,2005,2005-10-30,1:06,1:06,,WAS,8,7,Sun,W 36-0,,9,73,10,88,19,161
2013,NYG,2005,2005-11-13,1:03,1:03,,MIN,10,9,Sun,L 21-24,,9,75,7,90,16,165
2014,NYG,2005,2005-12-24,1:03,1:03,@,WAS,16,15,Sat,L 20-35,,9,64,6,81,15,145
2015,NYG,2005,2005-12-31,8:05,5:05,@,OAK,17,16,Sat,W 30-21,,9,70,8,54,17,124
2016,NYG,2006,2006-09-17,1:02,1:02,@,PHI,2,2,Sun,W 30-24,OT,9,75,10,66,19,141
2017,NYG,2006,2006-12-03,4:15,4:15,,DAL,13,12,Sun,L 20-23,,9,94,7,58,16,152
2018,NYG,2008,2008-11-23,4:16,2:16,@,ARI,12,11,Sun,W 37-29,,9,76,3,29,12,105
2019,NYG,2009,2009-10-18,1:03,12:03,@,NOR,6,6,Sun,L 27-48,,9,110,6,55,15,165
2020,NYG,2009,2009-11-08,4:15,4:15,,SDG,9,9,Sun,L 20-21,,9,104,3,20,12,124
2021,NYG,2010,2010-09-12,1:04,1:04,,CAR,1,1,Sun,W 31-18,,9,95,7,63,16,158
2022,NYG,2010,2010-10-10,1:03,12:03,@,HOU,5,5,Sun,W 34-10,,9,84,8,67,17,151
2023,NYG,2012,2012-12-03,8:40,8:40,@,WAS,13,12,Mon,L 16-17,,9,73,4,56,13,129
2024,NYG,2014,2014-09-14,1:04,1:04,,ARI,2,2,Sun,L 14-25,,9,70,7,71,16,141
2025,NYG,2014,2014-12-14,1:02,1:02,,WAS,15,14,Sun,W 24-13,,9,60,10,135,19,195
2026,NYG,2016,2016-11-27,1:00,1:00,@,CLE,12,11,Sun,W 27-13,,9,100,5,35,14,135
2027,NYG,2020,2020-10-22,8:20,8:20,@,PHI,7,7,Thu,L 21-22,,9,62,7,75,16,137
2028,NYJ,2001,2001-10-21,1:02,1:02,,STL,6,6,Sun,L 14-34,,9,66,4,33,13,99
2029,NYJ,2004,2004-11-28,4:16,2:16,@,ARI,12,11,Sun,W 13-3,,9,85,6,51,15,136
2030,NYJ,2005,2005-12-26,9:09,9:09,,NWE,16,15,Mon,L 21-31,,9,69,4,30,13,99
2031,NYJ,2007,2007-09-30,1:02,1:02,@,BUF,4,4,Sun,L 14-17,,9,66,6,38,15,104
2032,NYJ,2010,2010-09-26,8:30,8:30,@,MIA,3,3,Sun,W 31-23,,9,81,6,52,15,133
2033,NYJ,2010,2010-11-14,1:02,1:02,@,CLE,10,9,Sun,W 26-20,OT,9,70,4,52,13,122
2034,NYJ,2011,2011-10-02,8:30,8:30,@,BAL,4,4,Sun,L 17-34,,9,69,7,46,16,115
2035,NYJ,2011,2011-11-06,1:03,1:03,@,BUF,9,8,Sun,W 27-11,,9,60,6,84,15,144
2036,NYJ,2012,2012-09-23,1:03,1:03,@,MIA,3,3,Sun,W 23-20,OT,9,108,11,65,20,173
2037,NYJ,2013,2013-10-20,1:03,1:03,,NWE,7,7,Sun,W 30-27,OT,9,45,7,100,16,145
2038,NYJ,2014,2014-11-09,1:02,1:02,,PIT,10,10,Sun,W 20-13,,9,75,3,20,12,95
2039,NYJ,2014,2014-11-24,7:05,7:05,@,BUF,12,11,Mon,L 3-38,,9,60,4,24,13,84
2040,NYJ,2016,2016-12-11,4:05,1:05,@,SFO,14,13,Sun,W 23-17,OT,9,56,3,25,12,81
2041,NYJ,2017,2017-10-08,1:00,1:00,@,CLE,5,5,Sun,W 17-14,,9,80,6,60,15,140
2042,NYJ,2017,2017-12-31,1:00,1:00,@,NWE,17,16,Sun,L 6-26,,9,84,4,49,13,133
2043,NYJ,2018,2018-12-15,4:30,4:30,,HOU,15,14,Sat,L 22-29,,9,60,5,43,14,103
2044,NYJ,2019,2019-10-06,1:00,1:00,@,PHI,5,4,Sun,L 6-31,,9,52,9,76,18,128
2045,NYJ,2020,2020-09-13,1:00,1:00,@,BUF,1,1,Sun,L 17-27,,9,95,7,79,16,174
2046,NYJ,2021,2021-09-26,4:05,2:05,@,DEN,3,3,Sun,L 0-26,,9,90,6,50,15,140
2047,NYJ,2021,2021-11-14,1:00,1:00,,BUF,10,9,Sun,L 17-45,,9,69,7,50,16,119
2048,TEN,2001,2001-10-07,1:02,1:02,@,BAL,4,3,Sun,L 7-26,,9,107,5,30,14,137
2049,TEN,2001,2001-12-02,1:02,1:02,@,CLE,12,11,Sun,W 31-15,,9,72,7,52,16,124
2050,TEN,2002,2002-11-24,1:02,1:02,@,BAL,12,11,Sun,L 12-13,,9,69,6,65,15,134
2051,TEN,2002,2002-12-16,9:08,8:08,,NWE,15,14,Mon,W 24-7,,9,80,2,15,11,95
2052,TEN,2003,2003-11-23,4:15,4:15,@,ATL,12,11,Sun,W 38-31,,9,62,5,40,14,102
2053,TEN,2004,2004-12-05,1:02,1:02,@,IND,13,12,Sun,L 24-51,,9,105,7,88,16,193
2054,TEN,2005,2005-10-02,1:02,12:02,,IND,4,4,Sun,L 10-31,,9,76,1,10,10,86
2055,TEN,2005,2005-10-30,1:02,12:02,,OAK,8,8,Sun,L 25-34,,9,79,7,55,16,134
2056,TEN,2007,2007-11-11,1:03,12:03,,JAX,10,9,Sun,L 13-28,,9,56,4,35,13,91
2057,TEN,2008,2008-11-27,12:37,12:37,@,DET,13,12,Thu,W 47-10,,9,65,5,38,14,103
2058,TEN,2009,2009-10-11,8:30,7:30,,IND,5,5,Sun,L 9-31,,9,89,7,48,16,137
2059,TEN,2009,2009-12-25,7:34,6:34,,SDG,16,15,Fri,L 17-42,,9,74,6,45,15,119
2060,TEN,2009,2010-01-03,4:16,1:16,@,SEA,17,16,Sun,W 17-13,,9,76,5,40,14,116
2061,TEN,2010,2010-12-26,1:03,12:03,@,KAN,16,15,Sun,L 14-34,,9,74,7,84,16,158
2062,TEN,2011,2011-10-09,1:02,1:02,@,PIT,5,5,Sun,L 17-38,,9,70,5,51,14,121
2063,TEN,2011,2011-11-13,1:04,1:04,@,CAR,10,9,Sun,W 30-3,,9,92,12,99,21,191
2064,TEN,2012,2012-11-04,1:04,12:04,,CHI,9,9,Sun,L 20-51,,9,68,5,37,14,105
2065,TEN,2012,2012-12-09,1:02,1:02,@,IND,14,13,Sun,L 23-27,,9,70,6,43,15,113
2066,TEN,2013,2013-09-15,1:03,12:03,@,HOU,2,2,Sun,L 24-30,OT,9,70,5,40,14,110
2067,TEN,2014,2014-11-09,1:03,1:03,@,BAL,10,9,Sun,L 7-21,,9,67,5,40,14,107
2068,TEN,2014,2014-12-14,4:05,3:05,,NYJ,15,14,Sun,L 11-16,,9,76,7,46,16,122
2069,TEN,2015,2015-09-20,1:02,1:02,@,CLE,2,2,Sun,L 14-28,,9,85,4,40,13,125
2070,TEN,2015,2015-10-11,1:03,12:03,,BUF,5,4,Sun,L 13-14,,9,74,7,62,16,136
2071,TEN,2015,2015-11-08,1:02,12:02,@,NOR,9,8,Sun,W 34-28,OT,9,66,8,75,17,141
2072,TEN,2017,2017-11-16,8:25,8:25,@,PIT,11,10,Thu,L 17-40,,9,65,7,61,16,126
2073,TEN,2018,2018-12-30,8:20,12:00,,IND,17,16,Sun,L 17-33,,9,75,12,96,21,171
2074,TEN,2019,2019-09-19,8:20,8:20,@,JAX,3,3,Thu,L 7-20,,9,101,4,30,13,131
2075,TEN,2020,2020-11-29,1:00,1:00,@,IND,12,11,Sun,W 45-26,,9,63,6,50,15,113
2076,PHI,2000,2000-10-01,8:36,8:36,,ATL,5,5,Sun,W 38-10,,9,110,2,10,11,120
2077,PHI,2000,2000-11-12,1:01,1:01,@,PIT,11,11,Sun,W 26-23,OT,9,61,13,141,22,202
2078,PHI,2002,2002-10-28,9:08,9:08,,NYG,8,7,Mon,W 17-3,,9,65,9,75,18,140
2079,PHI,2002,2002-12-01,4:15,4:15,,STL,13,12,Sun,W 10-3,,9,65,5,35,14,100
2080,PHI,2004,2004-11-15,9:09,8:09,@,DAL,10,9,Mon,W 49-21,,9,59,7,50,16,109
2081,PHI,2004,2004-11-21,4:16,4:16,,WAS,11,10,Sun,W 28-6,,9,69,12,115,21,184
2082,PHI,2005,2005-09-25,1:03,1:03,,OAK,3,3,Sun,W 23-20,,9,70,13,94,22,164
2083,PHI,2005,2005-12-11,4:05,4:05,,NYG,14,13,Sun,L 23-26,OT,9,101,10,71,19,172
2084,PHI,2006,2006-09-24,4:15,1:15,@,SFO,3,3,Sun,W 38-24,,9,72,8,64,17,136
2085,PHI,2008,2008-12-07,1:04,1:04,@,NYG,14,13,Sun,W 20-14,,9,73,6,43,15,116
2086,PHI,2009,2009-09-13,1:04,1:04,@,CAR,1,1,Sun,W 38-10,,9,76,5,30,14,106
2087,PHI,2009,2009-11-15,4:15,1:15,@,SDG,10,9,Sun,L 23-31,,9,70,3,31,12,101
2088,PHI,2009,2009-12-27,4:16,4:16,,DEN,16,15,Sun,W 30-27,,9,59,9,95,18,154
2089,PHI,2010,2010-09-19,1:02,1:02,@,DET,2,2,Sun,W 35-32,,9,75,9,51,18,126
2090,PHI,2010,2010-10-17,1:02,1:02,,ATL,6,6,Sun,W 31-17,,9,78,2,30,11,108
2091,PHI,2012,2012-10-14,1:03,1:03,,DET,6,6,Sun,L 23-26,OT,9,60,16,132,25,192
2092,PHI,2012,2012-11-18,1:03,1:03,@,WAS,11,10,Sun,L 6-31,,9,70,13,80,22,150
2093,PHI,2012,2012-12-13,8:30,8:30,,CIN,15,14,Thu,L 13-34,,9,76,11,94,20,170
2094,PHI,2013,2013-09-15,1:02,1:02,,SDG,2,2,Sun,L 30-33,,9,77,4,32,13,109
2095,PHI,2013,2013-11-17,1:02,1:02,,WAS,11,11,Sun,W 24-16,,9,68,4,39,13,107
2096,PHI,2013,2013-12-15,1:02,12:02,@,MIN,15,14,Sun,L 30-48,,9,94,3,25,12,119
2097,PHI,2014,2014-09-21,1:02,1:02,,WAS,3,3,Sun,W 37-34,,9,70,10,131,19,201
2098,PHI,2014,2014-11-23,1:02,1:02,,TEN,12,11,Sun,W 43-24,,9,69,7,56,16,125
2099,PHI,2015,2015-10-19,8:30,8:30,,NYG,6,6,Mon,W 27-7,,9,72,12,92,21,164
2100,PHI,2017,2017-09-24,1:00,1:00,,NYG,3,3,Sun,W 27-24,,9,103,10,137,19,240
2101,PHI,2017,2017-10-01,4:05,1:05,@,LAC,4,4,Sun,W 26-24,,9,58,9,39,18,97
2102,PHI,2017,2017-10-23,8:30,8:30,,WAS,7,7,Mon,W 34-24,,9,55,5,55,14,110
2103,PHI,2019,2019-09-26,8:20,7:20,@,GNB,4,4,Thu,W 34-27,,9,93,5,50,14,143
2104,PHI,2019,2019-10-06,1:00,1:00,,NYJ,5,5,Sun,W 31-6,,9,76,9,52,18,128
2105,PHI,2020,2020-10-11,1:00,1:00,@,PIT,5,5,Sun,L 29-38,,9,84,8,86,17,170
2106,PHI,2020,2020-11-30,8:15,8:15,,SEA,12,11,Mon,L 17-23,,9,79,8,83,17,162
2107,PHI,2020,2020-12-20,4:05,2:05,@,ARI,15,14,Sun,L 26-33,,9,69,9,83,18,152
2108,PHI,2021,2021-10-03,1:00,1:00,,KAN,4,4,Sun,L 30-42,,9,49,7,46,16,95
2109,PIT,2001,2001-11-18,4:05,4:05,,JAX,10,9,Sun,W 20-7,,9,65,7,35,16,100
2110,PIT,2003,2003-09-07,1:04,1:04,,BAL,1,1,Sun,W 34-15,,9,138,10,81,19,219
2111,PIT,2003,2003-10-12,4:15,2:15,@,DEN,6,6,Sun,L 14-17,,9,85,6,37,15,122
2112,PIT,2003,2003-12-07,1:01,1:01,,OAK,14,13,Sun,W 27-7,,9,85,5,50,14,135
2113,PIT,2004,2004-09-19,1:02,1:02,@,BAL,2,2,Sun,L 13-30,,9,75,10,123,19,198
2114,PIT,2004,2004-10-31,4:15,4:15,,NWE,8,7,Sun,W 34-20,,9,90,6,55,15,145
2115,PIT,2006,2006-10-22,1:05,1:05,@,ATL,7,6,Sun,L 38-41,OT,9,65,6,40,15,105
2116,PIT,2010,2010-12-05,8:30,8:30,@,BAL,13,12,Sun,W 13-10,,9,61,9,53,18,114
2117,PIT,2010,2010-12-12,1:02,1:02,,CIN,14,13,Sun,W 23-7,,9,89,4,25,13,114
2118,PIT,2011,2011-10-23,4:05,1:05,@,ARI,7,7,Sun,W 32-20,,9,69,9,74,18,143
2119,PIT,2011,2011-12-19,9:00,6:00,@,SFO,15,14,Mon,L 3-20,,9,72,7,49,16,121
2120,PIT,2012,2012-10-07,1:02,1:02,,PHI,5,4,Sun,W 16-14,,9,106,5,35,14,141
2121,PIT,2012,2012-11-25,1:02,1:02,@,CLE,12,11,Sun,L 14-20,,9,68,10,90,19,158
2122,PIT,2013,2013-12-08,1:02,1:02,,MIA,14,13,Sun,L 28-34,,9,63,5,36,14,99
2123,PIT,2014,2014-09-11,8:28,8:28,@,BAL,2,2,Thu,L 6-26,,9,75,4,35,13,110
2124,PIT,2015,2015-12-20,4:25,4:25,,DEN,15,14,Sun,W 34-27,,9,63,12,127,21,190
2125,PIT,2015,2016-01-03,1:02,1:02,@,CLE,17,16,Sun,W 28-12,,9,45,8,47,17,92
2126,PIT,2016,2016-10-02,8:30,8:30,,KAN,4,4,Sun,W 43-14,,9,68,7,40,16,108
2127,PIT,2016,2017-01-01,1:00,1:00,,CLE,17,16,Sun,W 27-24,OT,9,43,5,37,14,80
2128,PIT,2017,2017-11-12,1:00,1:00,@,IND,10,9,Sun,W 20-17,,9,70,9,82,18,152
2129,PIT,2018,2018-10-14,1:00,1:00,@,CIN,6,6,Sun,W 28-21,,9,69,6,30,15,99
2130,PIT,2018,2018-12-30,4:25,1:00,,CIN,17,16,Sun,W 16-13,,9,70,9,85,18,155
2131,PIT,2019,2019-10-28,8:15,8:15,,MIA,8,7,Mon,W 27-14,,9,70,5,45,14,115
2132,OAK,2000,2000-11-05,1:15,1:15,,KAN,10,9,Sun,W 49-31,,9,81,9,80,18,161
2133,OAK,2000,2000-11-13,9:09,7:09,@,DEN,11,10,Mon,L 24-27,,9,54,5,45,14,99
2134,OAK,2002,2002-12-15,1:02,1:02,@,MIA,15,14,Sun,L 17-23,,9,55,4,30,13,85
2135,OAK,2003,2003-12-14,4:05,1:05,,BAL,15,14,Sun,W 20-12,,9,70,8,55,17,125
2136,OAK,2004,2004-10-10,1:00,12:00,@,IND,5,5,Sun,L 14-35,,9,59,2,20,11,79
2137,OAK,2004,2004-10-17,4:15,1:15,,DEN,6,6,Sun,L 3-31,,9,81,9,85,18,166
2138,OAK,2004,2004-12-12,1:03,1:03,@,ATL,14,13,Sun,L 10-35,,9,59,9,75,18,134
2139,OAK,2005,2005-11-06,1:00,12:00,@,KAN,9,8,Sun,L 23-27,,9,84,11,87,20,171
2140,OAK,2005,2005-11-13,4:05,1:05,,DEN,10,9,Sun,L 17-31,,9,58,4,30,13,88
2141,OAK,2006,2006-12-17,4:15,1:15,,STL,15,14,Sun,L 0-20,,9,75,10,56,19,131
2142,OAK,2007,2007-12-09,1:02,12:02,@,GNB,14,13,Sun,L 7-38,,9,62,9,84,18,146
2143,OAK,2008,2008-09-14,1:00,12:00,@,KAN,2,2,Sun,W 23-8,,9,61,5,36,14,97
2144,OAK,2009,2009-10-04,1:02,12:02,@,HOU,4,4,Sun,L 6-29,,9,60,1,5,10,65
2145,OAK,2009,2009-12-06,1:02,1:02,@,PIT,13,12,Sun,W 27-24,,9,70,4,41,13,111
2146,OAK,2009,2009-12-20,4:05,2:05,@,DEN,15,14,Sun,W 20-19,,9,62,7,72,16,134
2147,OAK,2010,2010-12-19,4:15,1:15,,DEN,15,14,Sun,W 39-23,,9,84,10,93,19,177
2148,OAK,2011,2011-10-02,4:15,1:15,,NWE,4,4,Sun,L 19-31,,9,85,5,45,14,130
2149,OAK,2012,2012-10-21,4:25,1:25,,JAX,7,6,Sun,W 26-23,OT,9,58,6,92,15,150
2150,OAK,2012,2012-11-04,4:05,1:05,,TAM,9,8,Sun,L 32-42,,9,80,14,116,23,196
2151,OAK,2012,2012-12-02,4:25,1:25,,CLE,13,12,Sun,L 17-20,,9,65,2,25,11,90
2152,OAK,2012,2012-12-30,4:21,1:21,@,SDG,17,16,Sun,L 21-24,,9,67,8,60,17,127
2153,OAK,2014,2014-09-28,1:06,6:06,,MIA,4,4,Sun,L 14-38,,9,80,5,35,14,115
2154,OAK,2014,2014-12-28,4:25,2:25,@,DEN,17,16,Sun,L 14-47,,9,86,1,16,10,102
2155,OAK,2016,2016-09-18,4:25,1:25,,ATL,2,2,Sun,L 28-35,,9,58,7,73,16,131
2156,OAK,2017,2017-09-17,4:05,1:05,,NYJ,2,2,Sun,W 45-20,,9,79,5,47,14,126
2157,OAK,2019,2019-09-09,10:20,7:20,,DEN,1,1,Mon,W 24-16,,9,62,6,44,15,106
2158,LVR,2021,2021-11-14,8:20,5:20,,KAN,10,9,Sun,L 14-41,,9,68,4,34,13,102
2159,LVR,2021,2021-12-12,1:00,12:00,@,KAN,14,13,Sun,L 9-48,,9,85,8,63,17,148
2160,STL,2000,2000-12-03,1:04,1:04,@,CAR,14,13,Sun,L 3-16,,9,72,1,10,10,82
2161,STL,2001,2001-09-30,12:03,12:03,,MIA,3,3,Sun,W 42-10,,9,59,5,30,14,89
2162,STL,2002,2002-11-03,4:15,2:15,@,ARI,9,8,Sun,W 27-14,,9,80,6,40,15,120
2163,STL,2004,2004-12-19,4:05,2:05,@,ARI,15,14,Sun,L 7-31,,9,74,7,67,16,141
2164,STL,2005,2005-10-17,8:08,8:08,@,IND,6,6,Mon,L 28-45,,9,50,3,15,12,65
2165,STL,2005,2005-10-30,1:02,12:02,,JAX,8,8,Sun,W 24-21,,9,59,4,25,13,84
2166,STL,2005,2005-11-20,1:02,12:02,,ARI,11,10,Sun,L 28-38,,9,54,10,111,19,165
2167,STL,2005,2005-11-27,1:03,12:03,@,HOU,12,11,Sun,W 33-27,OT,9,65,4,54,13,119
2168,STL,2005,2005-12-11,1:05,12:05,@,MIN,14,13,Sun,L 13-27,,9,60,5,60,14,120
2169,STL,2007,2007-10-07,1:02,12:02,,ARI,5,5,Sun,L 31-34,,9,86,11,98,20,184
2170,STL,2008,2008-09-07,1:02,1:02,@,PHI,1,1,Sun,L 3-38,,9,66,4,41,13,107
2171,STL,2008,2008-10-26,1:02,1:02,@,NWE,8,7,Sun,L 16-23,,9,63,0,0,9,63
2172,STL,2010,2010-09-26,4:05,3:05,,WAS,3,3,Sun,W 30-16,,9,99,9,65,18,164
2173,STL,2010,2010-12-19,1:00,12:00,,KAN,15,14,Sun,L 13-27,,9,60,5,40,14,100
2174,STL,2011,2011-09-11,1:00,12:00,,PHI,1,1,Sun,L 13-31,,9,60,8,91,17,151
2175,STL,2011,2011-10-02,1:00,12:00,,WAS,4,4,Sun,L 10-17,,9,65,10,96,19,161
2176,STL,2011,2011-10-30,1:00,12:00,,NOR,8,7,Sun,W 31-21,,9,64,5,32,14,96
2177,STL,2011,2011-11-06,4:15,2:15,@,ARI,9,8,Sun,L 13-19,OT,9,71,6,45,15,116
2178,STL,2012,2012-12-23,1:03,1:03,@,TAM,16,15,Sun,W 28-13,,9,64,1,5,10,69
2179,STL,2013,2013-10-13,1:03,12:03,@,HOU,6,6,Sun,W 38-13,,9,74,7,95,16,169
2180,STL,2014,2014-11-02,4:05,1:05,@,SFO,9,8,Sun,W 13-10,,9,83,9,44,18,127
2181,STL,2014,2014-11-23,4:05,1:05,@,SDG,12,11,Sun,L 24-27,,9,90,8,85,17,175
2182,STL,2014,2014-12-21,4:05,3:05,,NYG,16,15,Sun,L 27-37,,9,76,12,149,21,225
2183,STL,2015,2015-09-20,1:03,1:03,@,WAS,2,2,Sun,L 10-24,,9,80,7,53,16,133
2184,STL,2015,2015-10-25,1:00,12:00,,CLE,7,6,Sun,W 24-6,,9,75,11,98,20,173
2185,LAR,2016,2016-09-18,4:08,1:08,,SEA,2,2,Sun,W 9-3,,9,78,10,114,19,192
2186,LAR,2016,2016-10-02,4:25,1:25,@,ARI,4,4,Sun,W 17-13,,9,84,6,45,15,129
2187,LAR,2016,2017-01-01,4:25,1:25,,ARI,17,16,Sun,L 6-44,,9,61,4,51,13,112
2188,LAR,2017,2017-11-26,4:25,1:05,,NOR,12,11,Sun,W 26-20,,9,90,7,112,16,202
2189,LAR,2018,2018-12-09,8:20,12:00,@,CHI,14,13,Sun,L 6-15,,9,57,6,45,15,102
2190,LAR,2019,2019-10-27,1:00,6:00,,CIN,8,8,Sun,W 24-10,,9,59,6,40,15,99
2191,BAL,2002,2002-09-30,9:08,9:08,,DEN,4,3,Mon,W 34-23,,9,62,9,91,18,153
2192,BAL,2002,2002-12-29,1:02,1:02,@,PIT,17,16,Sun,L 31-34,,9,82,5,41,14,123
2193,BAL,2003,2003-10-26,1:02,1:02,,DEN,8,7,Sun,W 26-6,,9,62,7,49,16,111
2194,BAL,2004,2004-09-26,1:02,1:02,@,CIN,3,3,Sun,W 23-9,,9,71,5,25,14,96
2195,BAL,2005,2005-11-13,1:01,1:01,@,JAX,10,9,Sun,L 3-30,,9,86,5,42,14,128
2196,BAL,2005,2005-11-27,1:03,1:03,@,CIN,12,11,Sun,L 29-42,,9,91,5,45,14,136
2197,BAL,2006,2006-10-29,1:04,12:04,@,NOR,8,7,Sun,W 35-22,,9,69,10,68,19,137
2198,BAL,2006,2006-11-30,8:04,8:04,@,CIN,13,12,Thu,L 7-13,,9,64,5,35,14,99
2199,BAL,2008,2008-09-07,1:06,1:06,,CIN,1,1,Sun,W 17-10,,9,64,5,40,14,104
2200,BAL,2009,2009-10-04,1:02,1:02,@,NWE,4,4,Sun,L 21-27,,9,85,5,41,14,126
2201,BAL,2009,2009-11-29,8:30,8:30,,PIT,12,11,Sun,W 20-17,OT,9,80,5,59,14,139
2202,BAL,2010,2010-12-05,8:30,8:30,,PIT,13,12,Sun,L 10-13,,9,53,9,61,18,114
2203,BAL,2012,2012-11-04,1:03,1:03,@,CLE,9,8,Sun,W 25-15,,9,82,4,31,13,113
2204,BAL,2012,2012-12-23,4:25,4:25,,NYG,16,15,Sun,W 33-14,,9,92,6,52,15,144
2205,BAL,2013,2013-10-20,4:25,4:25,@,PIT,7,7,Sun,L 16-19,,9,67,7,50,16,117
2206,BAL,2013,2013-11-03,4:25,4:25,@,CLE,9,8,Sun,L 18-24,,9,80,6,55,15,135
2207,BAL,2013,2013-11-28,8:31,8:31,,PIT,13,12,Thu,W 22-20,,9,55,4,51,13,106
2208,BAL,2013,2013-12-22,4:25,4:25,,NWE,16,15,Sun,L 7-41,,9,83,7,58,16,141
2209,BAL,2014,2014-10-19,1:02,1:02,,ATL,7,7,Sun,W 29-7,,9,72,7,76,16,148
2210,BAL,2014,2014-12-14,1:02,1:02,,JAX,15,14,Sun,W 20-12,,9,70,5,60,14,130
2211,BAL,2015,2015-10-26,8:30,5:30,@,ARI,7,7,Mon,L 18-26,,9,64,4,40,13,104
2212,BAL,2015,2015-11-15,1:05,1:05,,JAX,10,9,Sun,L 20-22,,9,121,4,30,13,151
2213,BAL,2015,2015-12-13,1:02,1:02,,SEA,14,13,Sun,L 6-35,,9,94,6,42,15,136
2214,BAL,2016,2016-10-09,1:03,1:03,,WAS,5,5,Sun,L 10-16,,9,65,4,46,13,111
2215,BAL,2018,2018-09-09,1:00,1:00,,BUF,1,1,Sun,W 47-3,,9,78,10,100,19,178
2216,BAL,2018,2018-10-28,1:00,1:00,@,CAR,8,8,Sun,L 21-36,,9,68,4,30,13,98
2217,BAL,2018,2018-12-02,1:00,1:00,@,ATL,13,12,Sun,W 26-16,,9,88,8,82,17,170
2218,BAL,2019,2019-12-08,1:00,1:00,@,BUF,14,13,Sun,W 24-17,,9,99,5,49,14,148
2219,BAL,2020,2020-11-01,1:00,1:00,,PIT,8,7,Sun,L 24-28,,9,110,3,30,12,140
2220,SDG,2000,2000-09-24,4:15,1:15,,SEA,4,4,Sun,L 12-20,,9,71,5,45,14,116
2221,SDG,2000,2000-11-05,4:15,1:15,@,SEA,10,9,Sun,L 15-17,,9,53,5,34,14,87
2222,SDG,2000,2000-11-19,4:05,2:05,@,DEN,12,11,Sun,L 37-38,,9,62,7,63,16,125
2223,SDG,2002,2002-12-15,1:02,1:02,@,BUF,15,14,Sun,L 13-20,,9,121,4,60,13,181
2224,SDG,2002,2002-12-22,1:00,12:00,@,KAN,16,15,Sun,L 22-24,,9,50,1,1,10,51
2225,SDG,2003,2003-09-28,4:05,1:05,@,OAK,4,4,Sun,L 31-34,OT,9,111,7,57,16,168
2226,SDG,2003,2003-11-16,4:05,2:05,@,DEN,11,10,Sun,L 8-37,,9,83,7,60,16,143
2227,SDG,2003,2003-12-14,4:15,1:15,,GNB,15,14,Sun,L 21-38,,9,69,9,96,18,165
2228,SDG,2004,2004-11-21,4:05,1:05,@,OAK,11,10,Sun,W 23-17,,9,80,8,76,17,156
2229,SDG,2004,2004-11-28,1:00,12:00,@,KAN,12,11,Sun,W 34-31,,9,60,5,26,14,86
2230,SDG,2005,2005-10-10,9:00,6:00,,PIT,5,5,Mon,L 22-24,,9,100,11,104,20,204
2231,SDG,2005,2005-10-23,1:02,1:02,@,PHI,7,7,Sun,L 17-20,,9,72,10,72,19,144
2232,SDG,2008,2008-11-30,4:05,1:05,,ATL,13,12,Sun,L 16-22,,9,84,2,20,11,104
2233,SDG,2008,2008-12-04,8:15,5:15,,OAK,14,13,Thu,W 34-7,,9,51,6,70,15,121
2234,SDG,2009,2009-09-14,10:16,7:16,@,OAK,1,1,Mon,W 24-20,,9,60,6,40,15,100
2235,SDG,2009,2009-10-25,1:00,12:00,@,KAN,7,6,Sun,W 37-7,,9,59,7,41,16,100
2236,SDG,2012,2012-09-10,10:25,7:25,@,OAK,1,1,Mon,W 22-14,,9,78,6,35,15,113
2237,SDG,2012,2012-10-15,8:40,5:40,,DEN,6,6,Mon,L 24-35,,9,64,10,81,19,145
2238,SDG,2012,2012-12-16,4:05,1:05,,CAR,15,14,Sun,L 7-31,,9,70,6,48,15,118
2239,SDG,2013,2013-11-24,1:03,12:03,@,KAN,12,11,Sun,W 41-38,,9,97,7,62,16,159
2240,SDG,2015,2015-10-18,4:25,3:25,@,GNB,6,6,Sun,L 20-27,,9,76,6,50,15,126
2241,SDG,2015,2015-10-25,4:05,1:05,,OAK,7,7,Sun,L 29-37,,9,86,14,136,23,222
2242,SDG,2015,2015-12-24,8:26,5:26,@,OAK,16,15,Thu,L 20-23,OT,9,75,16,121,25,196
2243,SDG,2016,2016-12-24,1:00,1:00,@,CLE,16,15,Sat,L 17-20,,9,92,4,44,13,136
2244,LAC,2017,2017-10-01,4:05,1:05,,PHI,4,4,Sun,L 24-26,,9,39,9,58,18,97
2245,LAC,2017,2017-10-22,4:25,1:25,,DEN,7,7,Sun,W 21-0,,9,81,10,68,19,149
2246,LAC,2017,2017-12-16,8:25,7:25,@,KAN,15,14,Sat,L 13-30,,9,61,7,71,16,132
2247,LAC,2018,2018-10-07,4:05,1:05,,OAK,5,5,Sun,W 26-10,,9,82,7,55,16,137
2248,LAC,2019,2019-09-15,1:00,1:00,@,DET,2,2,Sun,L 10-13,,9,70,8,71,17,141
2249,LAC,2019,2019-11-18,8:15,7:15,,KAN,11,11,Mon,L 17-24,,9,60,8,102,17,162
2250,LAC,2020,2020-11-22,4:05,1:05,,NYJ,11,10,Sun,W 34-28,,9,78,8,88,17,166
2251,LAC,2021,2021-11-28,4:05,2:05,@,DEN,12,11,Sun,L 13-28,,9,75,5,35,14,110
2252,SEA,2003,2003-12-14,1:02,12:02,@,STL,15,14,Sun,L 22-27,,9,64,7,50,16,114
2253,SEA,2004,2004-11-21,4:06,1:06,,MIA,11,10,Sun,W 24-17,,9,70,8,98,17,168
2254,SEA,2005,2005-10-23,4:06,1:06,,DAL,7,7,Sun,W 13-10,,9,83,9,81,18,164
2255,SEA,2007,2007-12-30,1:04,1:04,@,ATL,17,16,Sun,L 41-44,,9,85,5,41,14,126
2256,SEA,2009,2009-11-15,4:15,2:15,@,ARI,10,9,Sun,L 20-31,,9,113,11,136,20,249
2257,SEA,2010,2010-11-07,4:05,1:05,,NYG,9,8,Sun,L 7-41,,9,70,5,40,14,110
2258,SEA,2011,2011-11-27,4:07,1:07,,WAS,12,11,Sun,L 17-23,,9,91,10,115,19,206
2259,SEA,2011,2011-12-12,8:40,5:40,,STL,14,13,Mon,W 30-13,,9,61,5,30,14,91
2260,SEA,2013,2013-09-08,1:04,1:04,@,CAR,1,1,Sun,W 12-7,,9,99,4,46,13,145
2261,SEA,2013,2013-09-29,1:03,12:03,@,HOU,4,4,Sun,W 23-20,OT,9,62,6,86,15,148
2262,SEA,2013,2013-11-10,1:03,1:03,@,ATL,10,10,Sun,W 33-10,,9,80,1,15,10,95
2263,SEA,2013,2013-12-08,4:26,1:26,@,SFO,14,13,Sun,L 17-19,,9,85,7,70,16,155
2264,SEA,2013,2013-12-22,4:06,1:06,,ARI,16,15,Sun,L 10-17,,9,102,7,46,16,148
2265,SEA,2014,2014-10-12,4:26,1:26,,DAL,6,5,Sun,L 23-30,,9,58,6,46,15,104
2266,SEA,2014,2014-11-02,4:26,1:26,,OAK,9,8,Sun,W 30-24,,9,65,5,69,14,134
2267,SEA,2015,2015-12-06,1:02,12:02,@,MIN,13,12,Sun,W 38-7,,9,65,9,95,18,160
2268,SEA,2017,2017-09-17,4:25,1:25,,SFO,2,2,Sun,W 12-9,,9,71,6,66,15,137
2269,SEA,2017,2017-11-20,8:30,5:30,,ATL,11,10,Mon,L 31-34,,9,106,7,69,16,175
2270,SEA,2017,2017-12-17,4:05,1:05,,LAR,15,14,Sun,L 7-42,,9,60,3,25,12,85
2271,SEA,2019,2019-10-27,1:00,1:00,@,ATL,8,8,Sun,W 27-20,,9,60,5,40,14,100
2272,SEA,2019,2019-11-11,8:15,5:15,@,SFO,10,10,Mon,W 27-24,OT,9,75,5,40,14,115
2273,SEA,2020,2020-09-20,8:20,5:20,,NWE,2,2,Sun,W 35-30,,9,68,2,12,11,80
2274,SFO,2000,2000-09-10,4:15,1:15,,CAR,2,2,Sun,L 22-38,,9,67,6,50,15,117
2275,SFO,2000,2000-11-19,4:16,1:16,,ATL,12,12,Sun,W 16-6,,9,85,6,40,15,125
2276,SFO,2000,2000-12-17,4:00,1:00,,CHI,16,15,Sun,W 17-0,,9,80,4,30,13,110
2277,SFO,2002,2002-11-25,9:00,6:00,,PHI,12,11,Mon,L 17-38,,9,86,5,41,14,127
2278,SFO,2002,2002-12-08,1:02,12:02,@,DAL,14,13,Sun,W 31-27,,9,69,4,35,13,104
2279,SFO,2003,2003-09-28,1:03,12:03,@,MIN,4,4,Sun,L 7-35,,9,55,4,29,13,84
2280,SFO,2006,2006-10-15,4:15,1:15,,SDG,6,6,Sun,L 19-48,,9,116,6,51,15,167
2281,SFO,2007,2007-09-30,4:05,1:05,,SEA,4,4,Sun,L 3-23,,9,65,3,15,12,80
2282,SFO,2008,2008-09-14,4:06,1:06,@,SEA,2,2,Sun,W 33-30,OT,9,60,10,75,19,135
2283,SFO,2008,2008-09-28,1:03,12:03,@,NOR,4,4,Sun,L 17-31,,9,63,13,123,22,186
2284,SFO,2009,2009-11-12,8:20,5:20,,CHI,10,9,Thu,W 10-6,,9,77,10,75,19,152
2285,SFO,2011,2011-09-11,4:22,1:22,,SEA,1,1,Sun,W 33-17,,9,102,11,72,20,174
2286,SFO,2011,2011-11-06,1:03,1:03,@,WAS,9,8,Sun,W 19-11,,9,55,3,35,12,90
2287,SFO,2013,2013-12-01,4:05,1:05,,STL,13,12,Sun,W 23-13,,9,85,11,105,20,190
2288,SFO,2014,2014-09-21,4:05,1:05,@,ARI,3,3,Sun,L 14-23,,9,107,5,36,14,143
2289,SFO,2014,2014-11-02,4:05,1:05,,STL,9,8,Sun,L 10-13,,9,44,9,83,18,127
2290,SFO,2014,2014-12-20,8:26,5:26,,SDG,16,15,Sat,L 35-38,OT,9,92,8,38,17,130
2291,SFO,2016,2016-11-06,4:05,1:05,,NOR,9,8,Sun,L 23-41,,9,78,4,40,13,118
2292,SFO,2016,2016-11-13,4:25,2:25,@,ARI,10,9,Sun,L 20-23,,9,100,2,10,11,110
2293,SFO,2018,2018-09-16,4:05,1:05,,DET,2,2,Sun,W 30-27,,9,86,10,105,19,191
2294,SFO,2018,2018-10-07,4:25,1:25,,ARI,5,5,Sun,L 18-28,,9,65,5,46,14,111
2295,SFO,2019,2019-09-15,1:00,1:00,@,CIN,2,2,Sun,W 41-17,,9,75,7,60,16,135
2296,SFO,2019,2019-11-24,8:20,5:20,,GNB,12,11,Sun,W 37-8,,9,78,5,50,14,128
2297,SFO,2021,2021-11-15,8:15,5:15,,LAR,10,9,Mon,W 31-10,,9,53,5,35,14,88
2298,TAM,2001,2001-11-04,1:02,12:02,@,GNB,8,7,Sun,L 20-21,,9,66,7,67,16,133
2299,TAM,2002,2002-12-15,1:04,1:04,@,DET,15,14,Sun,W 23-20,,9,67,6,36,15,103
2300,TAM,2003,2003-11-09,1:02,1:02,@,CAR,10,9,Sun,L 24-27,,9,95,7,64,16,159
2301,TAM,2003,2003-12-07,1:03,12:03,@,NOR,14,13,Sun,W 14-7,,9,85,4,44,13,129
2302,TAM,2004,2004-10-03,4:15,4:15,,DEN,4,4,Sun,L 13-16,,9,97,7,50,16,147
2303,TAM,2005,2005-10-16,1:02,1:02,,MIA,6,6,Sun,W 27-13,,9,65,9,60,18,125
2304,TAM,2006,2006-10-15,1:02,1:02,,CIN,6,5,Sun,W 14-13,,9,75,10,84,19,159
2305,TAM,2006,2006-11-13,8:40,8:40,@,CAR,10,9,Mon,L 10-24,,9,71,9,70,18,141
2306,TAM,2006,2006-12-17,1:05,12:05,@,CHI,15,14,Sun,L 31-34,OT,9,73,8,79,17,152
2307,TAM,2007,2007-11-04,1:00,1:00,,ARI,9,9,Sun,W 17-10,,9,70,8,64,17,134
2308,TAM,2009,2009-11-15,1:03,1:03,@,MIA,10,9,Sun,L 23-25,,9,77,3,30,12,107
2309,TAM,2010,2010-10-31,4:15,1:15,@,ARI,8,7,Sun,W 38-35,,9,80,3,12,12,92
2310,TAM,2010,2010-11-28,4:15,4:15,@,BAL,12,11,Sun,L 10-17,,9,78,4,30,13,108
2311,TAM,2010,2010-12-05,4:16,4:16,,ATL,13,12,Sun,L 24-28,,9,102,6,55,15,157
2312,TAM,2010,2010-12-19,1:03,1:03,,DET,15,14,Sun,L 20-23,OT,9,65,7,57,16,122
2313,TAM,2011,2011-09-25,4:16,4:16,,ATL,3,3,Sun,W 16-13,,9,66,7,50,16,116
2314,TAM,2011,2011-10-09,4:05,1:05,@,SFO,5,5,Sun,L 3-48,,9,96,3,30,12,126
2315,TAM,2011,2011-11-06,1:03,12:03,@,NOR,9,8,Sun,L 16-27,,9,80,8,63,17,143
2316,TAM,2011,2011-11-20,1:02,12:02,@,GNB,11,10,Sun,L 26-35,,9,55,5,37,14,92
2317,TAM,2011,2011-12-04,1:02,1:02,,CAR,13,12,Sun,L 19-38,,9,73,2,20,11,93
2318,TAM,2013,2013-11-11,8:40,8:40,,MIA,10,9,Mon,W 22-19,,9,70,4,70,13,140
2319,TAM,2013,2013-11-24,1:03,1:03,@,DET,12,11,Sun,W 24-21,,9,67,5,39,14,106
2320,TAM,2014,2014-09-28,1:03,1:03,@,PIT,4,4,Sun,W 27-24,,9,50,13,125,22,175
2321,TAM,2014,2014-11-23,1:02,12:02,@,CHI,12,11,Sun,L 13-21,,9,87,6,45,15,132
2322,TAM,2015,2015-11-08,4:05,4:05,,NYG,9,8,Sun,L 18-32,,9,79,6,49,15,128
2323,TAM,2015,2015-11-22,1:02,1:02,@,PHI,11,10,Sun,W 45-17,,9,82,5,25,14,107
2324,TAM,2015,2015-12-17,8:25,7:25,@,STL,15,14,Thu,L 23-31,,9,56,5,35,14,91
2325,TAM,2016,2016-09-25,4:05,4:05,,LAR,3,3,Sun,L 32-37,,9,80,8,69,17,149
2326,TAM,2016,2016-10-02,4:05,4:05,,DEN,4,4,Sun,L 7-27,,9,69,9,88,18,157
2327,TAM,2016,2016-11-13,1:00,1:00,,CHI,10,9,Sun,W 36-10,,9,85,9,74,18,159
2328,TAM,2017,2017-10-05,8:25,8:25,,NWE,5,4,Thu,L 14-19,,9,70,12,108,21,178
2329,TAM,2017,2017-10-15,4:05,2:05,@,ARI,6,5,Sun,L 33-38,,9,49,7,61,16,110
2330,TAM,2017,2017-11-19,1:00,1:00,@,MIA,11,10,Sun,W 30-20,,9,82,17,123,26,205
2331,TAM,2018,2018-09-24,8:15,8:15,,PIT,3,3,Mon,L 27-30,,9,80,13,155,22,235
2332,TAM,2018,2018-11-25,1:00,1:00,,SFO,12,11,Sun,W 27-9,,9,70,8,68,17,138
2333,TAM,2018,2018-12-02,1:00,1:00,,CAR,13,12,Sun,W 24-17,,9,69,7,104,16,173
2334,TAM,2018,2018-12-23,1:00,12:00,@,DAL,16,15,Sun,L 20-27,,9,72,10,67,19,139
2335,TAM,2019,2019-10-13,9:30,2:30,,CAR,6,6,Sun,L 26-37,,9,70,3,30,12,100
2336,TAM,2019,2019-10-27,1:00,12:00,@,TEN,8,7,Sun,L 23-27,,9,87,6,77,15,164
2337,TAM,2019,2019-11-10,1:00,1:00,,ARI,10,9,Sun,W 30-27,,9,94,11,87,20,181
2338,TAM,2019,2019-12-15,1:00,1:00,@,DET,15,14,Sun,W 38-17,,9,70,2,10,11,80
2339,TAM,2020,2020-09-13,4:25,3:25,@,NOR,1,1,Sun,L 23-34,,9,103,6,119,15,222
2340,TAM,2020,2020-09-27,4:25,2:25,@,DEN,3,3,Sun,W 28-10,,9,71,4,30,13,101
2341,TAM,2021,2021-09-19,4:05,4:05,,ATL,2,2,Sun,W 48-25,,9,83,6,49,15,132
2342,WAS,2000,2000-11-20,9:08,8:08,@,STL,12,11,Mon,W 33-20,,9,67,8,52,17,119
2343,WAS,2002,2002-12-15,1:02,1:02,@,PHI,15,14,Sun,L 21-34,,9,73,11,91,20,164
2344,WAS,2003,2003-09-28,1:03,1:03,,NWE,4,4,Sun,W 20-17,,9,75,8,64,17,139
2345,WAS,2003,2003-10-12,1:03,1:03,,TAM,6,6,Sun,L 13-35,,9,72,6,59,15,131
2346,WAS,2003,2003-10-19,4:15,4:15,@,BUF,7,7,Sun,L 7-24,,9,77,9,95,18,172
2347,WAS,2003,2003-12-27,8:36,8:36,,PHI,17,16,Sat,L 7-31,,9,78,7,48,16,126
2348,WAS,2008,2008-12-14,1:03,1:03,@,CIN,15,14,Sun,L 13-20,,9,75,6,41,15,116
2349,WAS,2009,2009-09-27,1:02,1:02,@,DET,3,3,Sun,L 14-19,,9,97,8,58,17,155
2350,WAS,2010,2010-09-26,4:05,3:05,@,STL,3,3,Sun,L 16-30,,9,65,9,99,18,164
2351,WAS,2011,2011-10-16,1:05,1:05,,PHI,6,5,Sun,L 13-20,,9,75,8,60,17,135
2352,WAS,2013,2013-12-15,1:03,1:03,@,ATL,15,14,Sun,L 26-27,,9,66,7,73,16,139
2353,WAS,2014,2014-11-16,1:03,1:03,,TAM,11,10,Sun,L 7-27,,9,67,11,101,20,168
2354,WAS,2014,2014-12-28,1:05,1:05,,DAL,17,16,Sun,L 17-44,,9,101,7,48,16,149
2355,WAS,2015,2015-11-22,1:02,1:02,@,CAR,11,10,Sun,L 16-44,,9,68,8,66,17,134
2356,WAS,2015,2015-12-07,8:31,8:31,,DAL,13,12,Mon,L 16-19,,9,73,8,70,17,143
2357,WAS,2016,2016-09-12,7:11,7:11,,PIT,1,1,Mon,L 16-38,,9,55,4,81,13,136
2358,WAS,2016,2016-10-02,1:05,1:05,,CLE,4,4,Sun,W 31-20,,9,75,7,101,16,176
2359,WAS,2016,2016-10-16,1:03,1:03,,PHI,6,6,Sun,W 27-20,,9,75,13,114,22,189
2360,WAS,2017,2017-11-19,1:00,12:00,@,NOR,11,10,Sun,L 31-34,OT,9,67,7,54,16,121
2361,WAS,2018,2018-09-09,4:25,2:25,@,ARI,1,1,Sun,W 24-6,,9,63,9,67,18,130
2362,WAS,2019,2019-09-23,8:15,8:15,,CHI,3,3,Mon,L 15-31,,9,61,9,59,18,120
2363,WAS,2020,2020-12-07,5:00,5:00,@,PIT,13,12,Mon,W 23-17,,9,62,6,45,15,107
2364,WAS,2021,2021-09-16,8:20,8:20,,NYG,2,2,Thu,W 30-29,,9,80,11,81,20,161
2365,ATL,2000,2000-10-15,1:02,12:02,@,STL,7,7,Sun,L 29-45,,8,40,11,96,19,136
2366,ATL,2000,2000-10-29,1:02,1:02,,CAR,9,9,Sun,W 13-12,,8,98,9,58,17,156
2367,ATL,2003,2003-11-02,4:15,4:15,,PHI,9,8,Sun,L 16-23,,8,61,11,90,19,151
2368,ATL,2004,2004-10-10,1:05,1:05,,DET,5,5,Sun,L 10-17,,8,74,12,80,20,154
2369,ATL,2004,2005-01-02,4:06,1:06,@,SEA,17,16,Sun,L 26-28,,8,53,1,5,9,58
2370,ATL,2005,2005-10-02,4:17,4:17,,MIN,4,4,Sun,W 30-10,,8,65,11,84,19,149
2371,ATL,2005,2005-10-09,1:05,1:05,,NWE,5,5,Sun,L 28-31,,8,84,11,83,19,167
2372,ATL,2005,2005-11-13,4:15,4:15,,GNB,10,9,Sun,L 25-33,,8,58,4,58,12,116
2373,ATL,2006,2006-09-17,1:05,1:05,,TAM,2,2,Sun,W 14-3,,8,83,8,99,16,182
2374,ATL,2006,2006-11-12,1:05,1:05,,CLE,10,9,Sun,L 13-17,,8,76,7,52,15,128
2375,ATL,2006,2006-12-16,8:05,8:05,,DAL,15,14,Sat,L 28-38,,8,68,4,32,12,100
2376,ATL,2007,2007-10-07,1:04,12:04,@,TEN,5,5,Sun,L 13-20,,8,66,6,40,14,106
2377,ATL,2007,2007-12-02,1:00,12:00,@,STL,13,12,Sun,L 16-28,,8,55,5,46,13,101
2378,ATL,2008,2008-09-14,4:05,4:05,@,TAM,2,2,Sun,L 9-24,,8,60,11,94,19,154
2379,ATL,2009,2009-10-11,4:05,1:05,@,SFO,5,4,Sun,W 45-10,,8,90,8,92,16,182
2380,ATL,2012,2012-09-17,8:41,8:41,,DEN,2,2,Mon,W 27-21,,8,72,10,96,18,168
2381,ATL,2013,2013-12-01,4:05,4:05,@,BUF,13,12,Sun,W 34-31,OT,8,75,6,49,14,124
2382,ATL,2014,2014-10-05,1:03,1:03,@,NYG,5,5,Sun,L 20-30,,8,81,3,15,11,96
2383,ATL,2016,2016-10-02,1:04,1:04,,CAR,4,4,Sun,W 48-33,,8,77,6,55,14,132
2384,ATL,2016,2016-10-16,4:26,1:26,@,SEA,6,6,Sun,L 24-26,,8,66,3,30,11,96
2385,ATL,2016,2016-11-13,1:00,1:00,@,PHI,10,10,Sun,L 15-24,,8,67,10,77,18,144
2386,ATL,2017,2017-09-10,1:00,12:00,@,CHI,1,1,Sun,W 23-17,,8,73,4,40,12,113
2387,ATL,2017,2017-09-24,1:00,1:00,@,DET,3,3,Sun,W 30-26,,8,68,9,98,17,166
2388,ATL,2017,2017-11-05,1:00,1:00,@,CAR,9,8,Sun,L 17-20,,8,70,5,29,13,99
2389,ATL,2018,2018-12-02,1:00,1:00,,BAL,13,12,Sun,L 16-26,,8,82,9,88,17,170
2390,ATL,2019,2019-10-13,4:05,2:05,@,ARI,6,6,Sun,L 33-34,,8,72,8,57,16,129
2391,ATL,2020,2020-09-20,1:00,12:00,@,DAL,2,2,Sun,L 39-40,,8,51,7,75,15,126
2392,ATL,2020,2020-10-25,1:00,1:00,,DET,7,7,Sun,L 22-23,,8,53,5,50,13,103
2393,BUF,2000,2000-10-01,1:01,1:01,,IND,5,4,Sun,L 16-18,,8,60,3,20,11,80
2394,BUF,2000,2000-11-26,1:00,1:00,@,TAM,13,12,Sun,L 17-31,,8,70,7,71,15,141
2395,BUF,2003,2003-11-30,1:02,1:02,@,NYG,13,12,Sun,W 24-7,,8,60,5,58,13,118
2396,BUF,2004,2004-11-07,1:02,1:02,,NYJ,9,8,Sun,W 22-17,,8,66,7,40,15,106
2397,BUF,2006,2006-11-05,1:02,1:02,,GNB,9,8,Sun,W 24-10,,8,50,5,36,13,86
2398,BUF,2007,2007-12-02,1:02,1:02,@,WAS,13,12,Sun,W 17-16,,8,101,4,34,12,135
2399,BUF,2007,2007-12-09,1:02,1:02,,MIA,14,13,Sun,W 38-17,,8,64,6,55,14,119
2400,BUF,2009,2009-10-18,4:15,4:15,@,NYJ,6,6,Sun,W 16-13,OT,8,64,14,96,22,160
2401,BUF,2011,2011-12-24,1:02,1:02,,DEN,16,15,Sat,W 40-14,,8,69,7,58,15,127
2402,BUF,2012,2012-10-21,1:02,1:02,,TEN,7,7,Sun,L 34-35,,8,65,3,25,11,90
2403,BUF,2013,2013-11-17,1:02,1:02,,NYJ,11,11,Sun,W 37-14,,8,64,4,24,12,88
2404,BUF,2014,2014-09-28,1:02,12:02,@,HOU,4,4,Sun,L 17-23,,8,40,8,90,16,130
2405,BUF,2014,2014-10-12,1:02,1:02,,NWE,6,6,Sun,L 22-37,,8,107,9,60,17,167
2406,BUF,2014,2014-10-19,1:02,1:02,,MIN,7,7,Sun,W 17-16,,8,48,7,50,15,98
2407,BUF,2015,2015-10-18,1:02,1:02,,CIN,6,6,Sun,L 21-34,,8,93,3,20,11,113
2408,BUF,2015,2015-12-20,1:03,1:03,@,WAS,15,14,Sun,L 25-35,,8,56,5,6,13,62
2409,BUF,2016,2016-09-11,1:04,1:04,@,BAL,1,1,Sun,L 7-13,,8,89,6,35,14,124
2410,BUF,2016,2016-12-04,4:05,1:05,@,OAK,13,12,Sun,L 24-38,,8,73,7,65,15,138
2411,BUF,2017,2017-09-24,1:00,1:00,,DEN,3,3,Sun,W 26-16,,8,69,10,79,18,148
2412,BUF,2017,2017-11-12,1:00,1:00,,NOR,10,9,Sun,L 10-47,,8,56,4,41,12,97
2413,BUF,2019,2019-09-29,1:00,1:00,,NWE,4,4,Sun,L 10-16,,8,76,8,58,16,134
2414,BUF,2019,2019-10-27,1:00,1:00,,PHI,8,7,Sun,L 13-31,,8,57,4,44,12,101
2415,BUF,2019,2019-12-15,8:20,8:20,@,PIT,15,14,Sun,W 17-10,,8,70,6,30,14,100
2416,BUF,2020,2020-12-19,4:30,2:30,@,DEN,15,14,Sat,W 48-19,,8,75,7,33,15,108
2417,BUF,2021,2021-09-12,1:00,1:00,,PIT,1,1,Sun,L 16-23,,8,81,5,32,13,113
2418,BUF,2021,2021-10-18,8:15,7:15,@,TEN,6,6,Mon,L 31-34,,8,60,7,91,15,151
2419,BUF,2021,2021-12-19,1:00,1:00,,CAR,15,14,Sun,W 31-14,,8,67,5,55,13,122
2420,CAR,2001,2001-10-07,8:38,5:38,@,SFO,4,4,Sun,L 14-24,,8,95,8,47,16,142
2421,CAR,2001,2001-11-18,1:02,1:02,,SFO,10,10,Sun,L 22-25,OT,8,60,10,70,18,130
2422,CAR,2003,2003-12-28,4:05,4:05,@,NYG,17,16,Sun,W 37-24,,8,82,8,45,16,127
2423,CAR,2004,2004-10-17,1:04,1:04,@,PHI,6,5,Sun,L 8-30,,8,45,4,38,12,83
2424,CAR,2004,2004-10-24,1:02,1:02,,SDG,7,6,Sun,L 6-17,,8,94,7,83,15,177
2425,CAR,2004,2004-11-07,1:02,1:02,,OAK,9,8,Sun,L 24-27,,8,83,8,53,16,136
2426,CAR,2005,2005-10-03,9:07,9:07,,GNB,4,4,Mon,W 32-29,,8,75,8,86,16,161
2427,CAR,2006,2006-09-10,1:03,1:03,,ATL,1,1,Sun,L 6-20,,8,45,2,20,10,65
2428,CAR,2006,2006-10-22,1:03,1:03,@,CIN,7,7,Sun,L 14-17,,8,41,5,55,13,96
2429,CAR,2006,2006-12-17,1:02,1:02,,PIT,15,14,Sun,L 3-37,,8,65,2,10,10,75
2430,CAR,2006,2006-12-24,1:03,1:03,@,ATL,16,15,Sun,W 10-3,,8,62,4,35,12,97
2431,CAR,2007,2007-10-28,1:02,1:02,,IND,8,7,Sun,L 7-31,,8,55,5,27,13,82
2432,CAR,2008,2008-10-05,1:04,1:04,,KAN,5,5,Sun,W 34-0,,8,56,4,35,12,91
2433,CAR,2008,2008-11-23,4:15,4:15,@,ATL,12,11,Sun,L 28-45,,8,48,3,25,11,73
2434,CAR,2010,2010-11-28,1:03,1:03,@,CLE,12,11,Sun,L 23-24,,8,68,5,46,13,114
2435,CAR,2010,2010-12-05,4:16,1:16,@,SEA,13,12,Sun,L 14-31,,8,53,4,20,12,73
2436,CAR,2011,2011-09-25,1:02,1:02,,JAX,3,3,Sun,W 16-10,,8,69,8,60,16,129
2437,CAR,2011,2011-10-02,1:04,12:04,@,CHI,4,4,Sun,L 29-34,,8,52,5,45,13,97
2438,CAR,2011,2011-12-24,1:04,1:04,,TAM,16,15,Sat,W 48-16,,8,77,7,64,15,141
2439,CAR,2013,2013-11-24,1:03,1:03,@,MIA,12,11,Sun,W 20-16,,8,56,6,55,14,111
2440,CAR,2014,2014-10-12,1:03,1:03,@,CIN,6,6,Sun,T 37-37,OT,8,60,13,119,21,179
2441,CAR,2015,2015-11-22,1:02,1:02,,WAS,11,10,Sun,W 44-16,,8,66,9,68,17,134
2442,CAR,2015,2015-11-26,4:31,3:31,@,DAL,12,11,Thu,W 33-14,,8,53,5,40,13,93
2443,CAR,2015,2015-12-06,4:25,3:25,@,NOR,13,12,Sun,W 41-38,,8,87,11,104,19,191
2444,CAR,2016,2016-09-08,8:40,6:40,@,DEN,1,1,Thu,L 20-21,,8,85,4,22,12,107
2445,CAR,2016,2016-09-18,1:03,1:03,,SFO,2,2,Sun,W 46-27,,8,50,6,50,14,100
2446,CAR,2018,2018-10-14,1:00,1:00,@,WAS,6,5,Sun,L 17-23,,8,55,5,43,13,98
2447,CAR,2019,2019-10-06,1:00,1:00,,JAX,5,5,Sun,W 34-27,,8,70,9,84,17,154
2448,CAR,2019,2019-11-17,1:00,1:00,,ATL,11,10,Sun,L 3-29,,8,68,3,20,11,88
2449,CAR,2020,2020-10-18,1:00,1:00,,CHI,6,6,Sun,L 16-23,,8,69,10,92,18,161
2450,CAR,2021,2021-09-23,8:20,7:20,@,HOU,3,3,Thu,W 24-9,,8,64,7,51,15,115
2451,CAR,2021,2021-10-31,1:00,1:00,@,ATL,8,8,Sun,W 19-13,,8,76,3,15,11,91
2452,CHI,2000,2000-10-01,4:15,3:15,@,GNB,5,5,Sun,W 27-24,,8,65,4,35,12,100
2453,CHI,2000,2000-10-15,8:35,7:35,,MIN,7,7,Sun,L 16-28,,8,53,7,73,15,126
2454,CHI,2000,2000-11-05,1:02,12:02,,IND,10,9,Sun,W 27-24,,8,58,7,81,15,139
2455,CHI,2002,2002-12-15,1:05,12:05,,NYJ,15,14,Sun,W 20-13,,8,74,7,54,15,128
2456,CHI,2003,2003-12-28,1:00,12:00,@,KAN,17,16,Sun,L 3-31,,8,78,6,55,14,133
2457,CHI,2004,2004-10-31,8:36,7:36,,SFO,8,7,Sun,W 23-13,,8,58,5,30,13,88
2458,CHI,2004,2004-12-26,1:03,1:03,@,DET,16,15,Sun,L 13-19,,8,55,6,47,14,102
2459,CHI,2005,2005-09-11,1:06,1:06,@,WAS,1,1,Sun,L 7-9,,8,86,5,45,13,131
2460,CHI,2005,2005-10-16,1:03,12:03,,MIN,6,5,Sun,W 28-3,,8,58,14,91,22,149
2461,CHI,2005,2005-11-06,4:05,3:05,@,NOR,9,8,Sun,W 20-17,,8,60,6,70,14,130
2462,CHI,2005,2005-12-25,5:11,4:11,@,GNB,16,15,Sun,W 24-17,,8,55,9,69,17,124
2463,CHI,2005,2006-01-01,4:15,3:15,@,MIN,17,16,Sun,L 10-34,,8,45,7,45,15,90
2464,CHI,2006,2006-12-17,1:05,12:05,,TAM,15,14,Sun,W 34-31,OT,8,79,9,73,17,152
2465,CHI,2008,2008-09-21,1:02,12:02,,TAM,3,3,Sun,L 24-27,OT,8,64,6,61,14,125
2466,CHI,2008,2008-11-16,1:02,12:02,@,GNB,11,10,Sun,L 3-37,,8,65,6,55,14,120
2467,CHI,2010,2010-10-03,8:31,8:31,@,NYG,4,4,Sun,L 3-17,,8,40,6,44,14,84
2468,CHI,2011,2011-09-11,1:06,12:06,,ATL,1,1,Sun,W 30-12,,8,56,9,65,17,121
2469,CHI,2011,2011-12-11,4:05,2:05,@,DEN,14,13,Sun,L 10-13,OT,8,69,4,29,12,98
2470,CHI,2012,2012-09-13,8:29,7:29,@,GNB,2,2,Thu,L 10-23,,8,65,4,54,12,119
2471,CHI,2014,2014-12-28,1:02,12:02,@,MIN,17,16,Sun,L 9-13,,8,50,4,25,12,75
2472,CHI,2015,2015-12-06,1:02,12:02,,SFO,13,12,Sun,L 20-26,OT,8,72,6,50,14,122
2473,CHI,2016,2016-10-02,1:00,12:00,,DET,4,4,Sun,W 17-14,,8,55,10,76,18,131
2474,CHI,2017,2017-09-17,1:00,1:00,@,TAM,2,2,Sun,L 7-29,,8,59,4,34,12,93
2475,CHI,2017,2017-09-28,8:25,7:25,@,GNB,4,4,Thu,L 14-35,,8,62,7,55,15,117
2476,CHI,2017,2017-10-09,8:30,7:30,,MIN,5,5,Mon,L 17-20,,8,55,9,69,17,124
2477,CHI,2017,2017-11-12,1:00,12:00,,GNB,10,9,Sun,L 16-23,,8,78,5,35,13,113
2478,CHI,2018,2018-12-02,1:00,1:00,@,NYG,13,12,Sun,L 27-30,OT,8,58,12,107,20,165
2479,CHI,2020,2020-10-04,1:00,12:00,,IND,4,4,Sun,L 11-19,,8,103,8,76,16,179
2480,CHI,2021,2021-09-19,1:00,12:00,,CIN,2,2,Sun,W 20-17,,8,70,4,57,12,127
2481,CHI,2021,2021-10-10,4:05,1:05,@,LVR,5,5,Sun,W 20-9,,8,70,10,82,18,152
2482,CHI,2021,2021-12-26,4:05,1:05,@,SEA,16,15,Sun,W 25-24,,8,73,7,88,15,161
2483,CIN,2000,2000-09-24,1:02,1:02,@,BAL,4,3,Sun,L 0-37,,8,53,10,90,18,143
2484,CIN,2000,2000-11-19,1:02,1:02,@,NWE,12,11,Sun,L 13-16,,8,75,9,69,17,144
2485,CIN,2001,2001-09-23,1:11,1:11,,BAL,2,2,Sun,W 21-10,,8,46,7,45,15,91
2486,CIN,2001,2001-11-18,1:02,1:02,,TEN,10,9,Sun,L 7-20,,8,70,11,93,19,163
2487,CIN,2001,2001-12-02,1:02,1:02,,TAM,12,11,Sun,L 13-16,OT,8,47,7,52,15,99
2488,CIN,2002,2002-09-22,8:35,8:35,@,ATL,3,3,Sun,L 3-30,,8,72,7,70,15,142
2489,CIN,2003,2003-10-19,1:02,1:02,,BAL,7,6,Sun,W 34-26,,8,65,13,113,21,178
2490,CIN,2004,2004-11-28,1:02,1:02,,CLE,12,11,Sun,W 58-48,,8,63,12,87,20,150
2491,CIN,2006,2006-11-26,1:04,1:04,@,CLE,12,11,Sun,W 30-0,,8,75,9,93,17,168
2492,CIN,2006,2006-12-24,4:16,2:16,@,DEN,16,15,Sun,L 23-24,,8,46,3,10,11,56
2493,CIN,2007,2007-10-01,8:40,8:40,,NWE,4,4,Mon,L 13-34,,8,65,3,20,11,85
2494,CIN,2007,2007-12-02,8:24,8:24,@,PIT,13,12,Sun,L 10-24,,8,45,7,37,15,82
2495,CIN,2008,2008-09-21,1:02,1:02,@,NYG,3,3,Sun,L 23-26,OT,8,57,6,40,14,97
2496,CIN,2009,2009-11-22,4:15,1:15,@,OAK,11,10,Sun,L 17-20,,8,59,3,13,11,72
2497,CIN,2010,2010-09-26,1:02,1:02,@,CAR,3,3,Sun,W 20-7,,8,74,6,45,14,119
2498,CIN,2010,2010-10-03,1:02,1:02,@,CLE,4,4,Sun,L 20-23,,8,79,7,44,15,123
2499,CIN,2012,2012-09-23,1:03,1:03,@,WAS,3,3,Sun,W 38-31,,8,80,6,60,14,140
2500,CIN,2012,2012-11-04,1:02,1:02,,DEN,9,8,Sun,L 23-31,,8,83,5,29,13,112
2501,CIN,2012,2012-11-18,1:03,12:03,@,KAN,11,10,Sun,W 28-6,,8,54,6,30,14,84
2502,CIN,2012,2012-12-02,4:25,1:25,@,SDG,13,12,Sun,W 20-13,,8,55,8,55,16,110
2503,CIN,2012,2012-12-09,1:03,1:03,,DAL,14,13,Sun,L 19-20,,8,70,6,49,14,119
2504,CIN,2013,2013-09-08,1:02,12:02,@,CHI,1,1,Sun,L 21-24,,8,84,4,59,12,143
2505,CIN,2013,2013-10-13,1:02,1:02,@,BUF,6,6,Sun,W 27-24,OT,8,78,4,27,12,105
2506,CIN,2013,2013-11-17,1:02,1:02,,CLE,11,11,Sun,W 41-20,,8,64,5,40,13,104
2507,CIN,2016,2016-12-18,1:00,1:00,,PIT,15,14,Sun,L 20-24,,8,86,7,104,15,190
2508,CIN,2017,2017-10-01,1:00,1:00,@,CLE,4,4,Sun,W 31-7,,8,66,4,28,12,94
2509,CIN,2017,2017-11-05,1:00,1:00,@,JAX,9,8,Sun,L 7-23,,8,77,5,50,13,127
2510,CIN,2018,2018-09-09,1:00,1:00,@,IND,1,1,Sun,W 34-23,,8,94,7,91,15,185
2511,CIN,2018,2018-10-21,8:20,12:00,@,KAN,7,7,Sun,L 10-45,,8,58,8,49,16,107
2512,CIN,2019,2019-09-22,1:00,1:00,@,BUF,3,3,Sun,L 17-21,,8,54,7,55,15,109
2513,CIN,2019,2019-09-30,8:15,8:15,@,PIT,4,4,Mon,L 3-27,,8,60,4,37,12,97
2514,CIN,2019,2019-12-08,1:00,1:00,@,CLE,14,13,Sun,L 19-27,,8,99,6,30,14,129
2515,CLE,2000,2000-09-24,4:17,1:17,@,OAK,4,4,Sun,L 10-36,,8,46,5,40,13,86
2516,CLE,2000,2000-10-01,1:03,1:03,,BAL,5,5,Sun,L 0-12,,8,60,6,62,14,122
2517,CLE,2000,2000-10-08,4:15,1:15,@,ARI,6,6,Sun,L 21-29,,8,86,3,20,11,106
2518,CLE,2000,2000-10-22,4:05,4:05,@,PIT,8,8,Sun,L 0-22,,8,77,5,47,13,124
2519,CLE,2002,2002-10-13,1:01,1:01,@,TAM,6,6,Sun,L 3-17,,8,66,5,45,13,111
2520,CLE,2004,2004-09-26,1:02,1:02,@,NYG,3,3,Sun,L 10-27,,8,80,8,59,16,139
2521,CLE,2004,2004-10-03,1:02,1:02,,WAS,4,4,Sun,W 17-13,,8,66,7,58,15,124
2522,CLE,2004,2004-10-10,1:02,1:02,@,PIT,5,5,Sun,L 23-34,,8,54,6,63,14,117
2523,CLE,2005,2005-10-16,1:02,1:02,@,BAL,6,5,Sun,L 3-16,,8,53,11,97,19,150
2524,CLE,2005,2005-10-23,1:04,1:04,,DET,7,6,Sun,L 10-13,,8,50,11,72,19,122
2525,CLE,2008,2008-11-02,1:02,1:02,,BAL,9,8,Sun,L 27-37,,8,37,7,42,15,79
2526,CLE,2008,2008-12-07,1:04,12:04,@,TEN,14,13,Sun,L 9-28,,8,68,13,131,21,199
2527,CLE,2009,2009-09-13,1:03,1:03,,MIN,1,1,Sun,L 20-34,,8,66,3,38,11,104
2528,CLE,2009,2009-11-22,1:02,1:02,@,DET,11,10,Sun,L 37-38,,8,69,8,41,16,110
2529,CLE,2010,2010-09-26,1:02,1:02,@,BAL,3,3,Sun,L 17-24,,8,60,8,60,16,120
2530,CLE,2011,2011-09-25,1:02,1:02,,MIA,3,3,Sun,W 17-16,,8,85,10,93,18,178
2531,CLE,2014,2014-09-07,1:02,1:02,@,PIT,1,1,Sun,L 27-30,,8,55,11,96,19,151
2532,CLE,2014,2014-10-19,1:02,1:02,@,JAX,7,6,Sun,L 6-24,,8,50,3,25,11,75
2533,CLE,2014,2014-11-16,1:03,1:03,,HOU,11,10,Sun,L 7-23,,8,67,5,55,13,122
2534,CLE,2015,2015-12-13,1:02,1:02,,SFO,14,13,Sun,W 24-10,,8,71,5,40,13,111
2535,CLE,2015,2015-12-27,1:03,12:03,@,KAN,16,15,Sun,L 13-17,,8,83,5,33,13,116
2536,CLE,2015,2016-01-03,1:02,1:02,,PIT,17,16,Sun,L 12-28,,8,47,9,45,17,92
2537,CLE,2016,2016-09-18,1:02,1:02,,BAL,2,2,Sun,L 20-25,,8,59,4,29,12,88
2538,CLE,2017,2017-12-24,1:00,12:00,@,CHI,16,15,Sun,L 3-20,,8,60,4,25,12,85
2539,CLE,2018,2018-09-30,4:05,1:05,@,OAK,4,4,Sun,L 42-45,OT,8,55,6,65,14,120
2540,CLE,2019,2019-09-22,8:20,8:20,,LAR,3,3,Sun,L 13-20,,8,60,7,49,15,109
2541,CLE,2019,2019-11-14,8:20,8:20,,PIT,11,10,Thu,W 21-7,,8,121,6,41,14,162
2542,CLE,2020,2020-09-13,1:00,1:00,@,BAL,1,1,Sun,L 6-38,,8,80,7,66,15,146
2543,CLE,2020,2020-09-17,8:20,8:20,,CIN,2,2,Thu,W 35-30,,8,76,4,45,12,121
2544,CLE,2020,2020-12-14,8:15,8:15,,BAL,14,13,Mon,L 42-47,,8,75,8,69,16,144
2545,IND,2000,2000-10-22,1:00,12:00,,NWE,8,7,Sun,W 30-23,,8,106,6,48,14,154
2546,IND,2001,2001-09-23,1:00,12:00,,BUF,2,2,Sun,W 42-26,,8,59,19,133,27,192
2547,IND,2004,2004-11-08,9:00,9:00,,MIN,9,8,Mon,W 31-28,,8,65,6,53,14,118
2548,IND,2004,2004-12-12,1:02,12:02,@,HOU,14,13,Sun,W 23-14,,8,50,6,30,14,80
2549,IND,2005,2005-12-18,1:02,1:02,,SDG,15,14,Sun,L 17-26,,8,67,11,75,19,142
2550,IND,2006,2006-12-03,1:03,12:03,@,TEN,13,12,Sun,L 17-20,,8,59,5,34,13,93
2551,IND,2012,2012-12-16,1:02,12:02,@,HOU,15,14,Sun,L 17-29,,8,79,9,69,17,148
2552,IND,2014,2014-09-21,1:02,1:02,@,JAX,3,3,Sun,W 44-17,,8,46,2,15,10,61
2553,IND,2014,2014-10-19,1:02,1:02,,CIN,7,7,Sun,W 27-0,,8,57,4,20,12,77
2554,IND,2014,2014-12-21,4:26,3:26,@,DAL,16,15,Sun,L 7-42,,8,55,7,67,15,122
2555,IND,2015,2015-12-13,1:02,1:02,@,JAX,14,13,Sun,L 16-51,,8,85,5,40,13,125
2556,IND,2015,2015-12-20,1:02,1:02,,HOU,15,14,Sun,L 10-16,,8,94,6,48,14,142
2557,IND,2016,2016-09-18,4:25,2:25,@,DEN,2,2,Sun,L 20-34,,8,94,8,54,16,148
2558,IND,2016,2016-11-20,1:00,1:00,,TEN,11,10,Sun,W 24-17,,8,70,11,109,19,179
2559,IND,2017,2017-09-17,1:00,1:00,,ARI,2,2,Sun,L 13-16,OT,8,70,6,41,14,111
2560,IND,2018,2018-10-14,1:00,1:00,@,NYJ,6,6,Sun,L 34-42,,8,66,7,49,15,115
2561,IND,2019,2019-09-15,1:00,12:00,@,TEN,2,2,Sun,W 19-17,,8,65,5,75,13,140
2562,IND,2020,2020-10-04,1:00,12:00,@,CHI,4,4,Sun,W 19-11,,8,76,8,103,16,179
2563,IND,2020,2020-11-22,4:25,4:25,,GNB,11,10,Sun,W 34-31,OT,8,116,7,45,15,161
2564,IND,2021,2021-10-03,1:00,1:00,@,MIA,4,4,Sun,W 27-17,,8,86,5,32,13,118
2565,ARI,2000,2000-11-05,4:05,2:05,,WAS,10,9,Sun,W 16-15,,8,74,8,59,16,133
2566,ARI,2000,2000-11-12,1:00,12:00,@,MIN,11,10,Sun,L 14-31,,8,65,4,35,12,100
2567,ARI,2001,2001-12-09,4:04,2:04,,WAS,13,12,Sun,L 10-20,,8,49,13,99,21,148
2568,ARI,2002,2002-12-15,8:35,7:35,@,STL,15,14,Sun,L 28-30,,8,75,7,43,15,118
2569,ARI,2003,2003-11-02,4:05,2:05,,CIN,9,8,Sun,W 17-14,,8,57,5,43,13,100
2570,ARI,2003,2003-11-09,1:02,1:02,@,PIT,10,9,Sun,L 15-28,,8,81,6,69,14,150
2571,ARI,2003,2003-11-23,4:06,2:06,,STL,12,11,Sun,L 27-30,OT,8,60,3,25,11,85
2572,ARI,2004,2004-09-12,1:04,12:04,@,STL,1,1,Sun,L 10-17,,8,59,7,55,15,114
2573,ARI,2004,2004-09-26,1:05,1:05,@,ATL,3,3,Sun,L 3-6,,8,66,3,15,11,81
2574,ARI,2004,2004-10-10,4:15,1:15,@,SFO,5,5,Sun,L 28-31,OT,8,60,11,85,19,145
2575,ARI,2005,2005-09-18,4:05,1:05,,STL,2,2,Sun,L 12-17,,8,72,4,30,12,102
2576,ARI,2005,2005-10-09,4:15,1:15,,CAR,5,5,Sun,L 20-24,,8,55,4,30,12,85
2577,ARI,2005,2005-10-30,1:02,12:02,@,DAL,8,7,Sun,L 13-34,,8,56,0,0,8,56
2578,ARI,2005,2005-12-11,4:05,2:05,,WAS,14,13,Sun,L 13-17,,8,65,5,63,13,128
2579,ARI,2006,2006-11-26,1:05,12:05,@,MIN,12,11,Sun,L 26-31,,8,64,8,63,16,127
2580,ARI,2007,2007-11-04,1:00,1:00,@,TAM,9,8,Sun,L 10-17,,8,64,9,70,17,134
2581,ARI,2007,2007-12-30,4:15,2:15,,STL,17,16,Sun,W 48-19,,8,63,7,50,15,113
2582,ARI,2008,2008-09-14,4:15,1:15,,MIA,2,2,Sun,W 31-10,,8,45,6,42,14,87
2583,ARI,2008,2008-11-16,4:06,1:06,@,SEA,11,10,Sun,W 26-20,,8,52,1,15,9,67
2584,ARI,2009,2009-12-20,1:02,1:02,@,DET,15,14,Sun,W 31-24,,8,65,7,45,15,110
2585,ARI,2010,2011-01-02,4:15,1:15,@,SFO,17,16,Sun,L 7-38,,8,43,5,25,13,68
2586,ARI,2012,2012-11-04,1:02,12:02,@,GNB,9,9,Sun,L 17-31,,8,57,1,5,9,62
2587,ARI,2013,2013-10-27,4:25,1:25,,ATL,8,8,Sun,W 27-13,,8,52,10,55,18,107
2588,ARI,2014,2014-12-11,8:25,7:25,@,STL,15,14,Thu,W 12-6,,8,59,6,69,14,128
2589,ARI,2015,2015-09-20,1:00,12:00,@,CHI,2,2,Sun,W 48-23,,8,58,14,170,22,228
2590,ARI,2016,2016-09-25,1:02,1:02,@,BUF,3,3,Sun,L 18-33,,8,50,9,75,17,125
2591,ARI,2016,2016-11-20,1:00,3:00,@,MIN,11,10,Sun,L 24-30,,8,96,10,73,18,169
2592,ARI,2016,2016-11-27,1:00,1:00,@,ATL,12,11,Sun,L 19-38,,8,60,4,23,12,83
2593,ARI,2017,2017-12-17,1:00,1:00,@,WAS,15,14,Sun,L 15-20,,8,71,7,82,15,153
2594,ARI,2018,2018-12-09,4:25,2:25,,DET,14,13,Sun,L 3-17,,8,83,7,68,15,151
2595,ARI,2018,2018-12-16,1:00,1:00,@,ATL,15,14,Sun,L 14-40,,8,75,6,50,14,125
2596,ARI,2019,2019-09-15,1:00,1:00,@,BAL,2,2,Sun,L 17-23,,8,70,10,62,18,132
2597,ARI,2019,2019-10-13,4:05,2:05,,ATL,6,6,Sun,W 34-33,,8,57,8,72,16,129
2598,ARI,2019,2019-12-29,4:25,1:25,@,LAR,17,16,Sun,L 24-31,,8,63,10,91,18,154
2599,ARI,2021,2021-09-12,1:00,12:00,@,TEN,1,1,Sun,W 38-13,,8,59,7,57,15,116
2600,ARI,2021,2021-12-05,1:00,12:00,@,CHI,13,12,Sun,W 33-22,,8,63,6,45,14,108
2601,DAL,2002,2002-09-29,1:02,12:02,@,STL,4,4,Sun,W 13-10,,8,60,8,65,16,125
2602,DAL,2005,2005-09-11,4:15,1:15,@,SDG,1,1,Sun,W 28-24,,8,46,8,62,16,108
2603,DAL,2006,2006-11-12,4:16,2:16,@,ARI,10,9,Sun,W 27-10,,8,69,5,35,13,104
2604,DAL,2008,2008-10-19,1:00,12:00,@,STL,7,7,Sun,L 14-34,,8,56,5,32,13,88
2605,DAL,2008,2008-11-23,1:03,12:03,,SFO,12,11,Sun,W 35-22,,8,65,2,10,10,75
2606,DAL,2009,2009-10-25,4:15,3:15,,ATL,7,6,Sun,W 37-21,,8,50,3,30,11,80
2607,DAL,2010,2010-09-26,1:02,12:02,@,HOU,3,3,Sun,W 27-13,,8,49,5,32,13,81
2608,DAL,2011,2011-09-18,4:05,1:05,@,SFO,2,2,Sun,W 27-24,OT,8,83,5,25,13,108
2609,DAL,2011,2011-11-13,1:02,12:02,,BUF,10,9,Sun,W 44-7,,8,74,3,12,11,86
2610,DAL,2012,2012-12-16,4:25,3:25,,PIT,15,14,Sun,W 27-24,OT,8,61,0,0,8,61
2611,DAL,2014,2014-12-04,8:26,7:26,@,CHI,14,13,Thu,W 41-28,,8,97,9,54,17,151
2612,DAL,2015,2015-11-08,8:31,7:31,,PHI,9,8,Sun,L 27-33,OT,8,58,10,70,18,128
2613,DAL,2015,2015-12-07,8:31,8:31,@,WAS,13,12,Mon,W 19-16,,8,70,9,73,17,143
2614,DAL,2015,2015-12-27,1:02,1:02,@,BUF,16,15,Sun,L 6-16,,8,65,7,62,15,127
2615,DAL,2016,2016-12-18,8:30,7:30,,TAM,15,14,Sun,W 26-20,,8,91,3,35,11,126
2616,DAL,2016,2016-12-26,8:30,7:30,,DET,16,15,Mon,W 42-21,,8,47,5,62,13,109
2617,DAL,2017,2017-09-17,4:25,2:25,@,DEN,2,2,Sun,L 17-42,,8,69,8,61,16,130
2618,DAL,2017,2017-10-29,4:25,4:25,@,WAS,8,7,Sun,W 33-19,,8,89,5,32,13,121
2619,DAL,2017,2017-12-10,1:00,1:00,@,NYG,14,13,Sun,W 30-10,,8,51,7,69,15,120
2620,DAL,2018,2018-10-21,4:25,4:25,@,WAS,7,7,Sun,L 17-20,,8,65,5,35,13,100
2621,DAL,2018,2018-11-29,8:20,7:20,,NOR,13,12,Thu,W 13-10,,8,80,5,48,13,128
2622,DAL,2019,2019-09-15,1:00,1:00,@,WAS,2,2,Sun,W 31-21,,8,67,6,44,14,111
2623,DAL,2019,2019-09-22,1:00,12:00,,MIA,3,3,Sun,W 31-6,,8,100,5,35,13,135
2624,DAL,2021,2021-09-09,8:20,8:20,@,TAM,1,1,Thu,L 29-31,,8,55,11,106,19,161
2625,DAL,2021,2021-09-19,4:25,1:25,@,LAC,2,2,Sun,W 20-17,,8,76,12,99,20,175
2626,DAL,2021,2021-10-10,4:25,3:25,,NYG,5,5,Sun,W 44-20,,8,58,5,48,13,106
2627,DAL,2021,2021-11-14,1:00,12:00,,ATL,10,9,Sun,W 43-3,,8,80,6,41,14,121
2628,DEN,2000,2000-12-23,4:17,2:17,,SFO,17,16,Sat,W 38-9,,8,90,11,110,19,200
2629,DEN,2001,2001-10-07,2:05,2:05,,KAN,4,4,Sun,W 20-6,,8,53,2,15,10,68
2630,DEN,2001,2001-10-21,1:05,1:05,@,SDG,6,6,Sun,L 10-27,,8,61,5,34,13,95
2631,DEN,2001,2001-12-16,1:00,12:00,@,KAN,14,14,Sun,L 23-26,OT,8,146,9,68,17,214
2632,DEN,2002,2002-10-20,1:00,12:00,@,KAN,7,7,Sun,W 37-34,OT,8,75,5,50,13,125
2633,DEN,2002,2002-12-29,4:16,2:16,,ARI,17,16,Sun,W 37-7,,8,53,6,36,14,89
2634,DEN,2003,2003-11-23,4:05,2:05,,CHI,12,11,Sun,L 10-19,,8,114,6,29,14,143
2635,DEN,2004,2004-10-25,9:09,9:09,@,CIN,7,7,Mon,L 10-23,,8,88,9,65,17,153
2636,DEN,2004,2004-12-05,4:05,1:05,@,SDG,13,12,Sun,L 17-20,,8,57,11,94,19,151
2637,DEN,2005,2005-12-04,4:15,3:15,@,KAN,13,12,Sun,L 27-31,,8,55,6,45,14,100
2638,DEN,2006,2006-11-05,4:15,4:15,@,PIT,9,8,Sun,W 31-20,,8,60,5,50,13,110
2639,DEN,2006,2006-12-31,4:16,2:16,,SFO,17,16,Sun,L 23-26,OT,8,49,8,61,16,110
2640,DEN,2008,2008-10-20,8:40,8:40,@,NWE,7,7,Mon,L 7-41,,8,87,5,65,13,152
2641,DEN,2009,2009-11-26,8:21,6:21,,NYG,12,11,Thu,W 26-6,,8,61,4,45,12,106
2642,DEN,2010,2010-10-31,1:07,5:07,@,SFO,8,8,Sun,L 16-24,,8,60,6,67,14,127
2643,DEN,2010,2010-11-22,8:40,5:40,@,SDG,11,10,Mon,L 14-35,,8,56,5,40,13,96
2644,DEN,2010,2010-12-12,4:15,2:15,@,ARI,14,13,Sun,L 13-43,,8,66,7,62,15,128
2645,DEN,2011,2011-11-13,1:03,12:03,@,KAN,10,9,Sun,W 17-10,,8,65,4,40,12,105
2646,DEN,2011,2011-12-04,1:05,12:05,@,MIN,13,12,Sun,W 35-32,,8,73,6,54,14,127
2647,DEN,2012,2012-12-02,4:05,2:05,,TAM,13,12,Sun,W 31-23,,8,75,11,80,19,155
2648,DEN,2013,2013-09-05,9:13,7:13,,BAL,1,1,Thu,W 49-27,,8,61,7,53,15,114
2649,DEN,2013,2013-12-22,1:02,12:02,@,HOU,16,15,Sun,W 37-13,,8,67,4,57,12,124
2650,DEN,2014,2014-10-19,8:30,6:30,,SFO,7,6,Sun,W 42-17,,8,75,6,62,14,137
2651,DEN,2014,2014-11-16,1:00,12:00,@,STL,11,10,Sun,L 7-22,,8,62,3,25,11,87
2652,DEN,2015,2015-09-13,4:25,2:25,,BAL,1,1,Sun,W 19-13,,8,45,3,15,11,60
2653,DEN,2015,2015-09-17,8:29,7:29,@,KAN,2,2,Thu,W 31-24,,8,85,9,60,17,145
2654,DEN,2015,2015-10-04,4:25,2:25,,MIN,4,4,Sun,W 23-20,,8,40,9,63,17,103
2655,DEN,2015,2015-10-18,1:02,1:02,@,CLE,6,6,Sun,W 26-23,OT,8,81,6,30,14,111
2656,DEN,2015,2015-11-08,4:25,4:25,@,IND,9,8,Sun,L 24-27,,8,56,4,30,12,86
2657,DEN,2015,2015-11-22,1:02,12:02,@,CHI,11,10,Sun,W 17-15,,8,118,0,0,8,118
2658,DEN,2016,2016-09-18,4:25,2:25,,IND,2,2,Sun,W 34-20,,8,54,8,94,16,148
2659,DEN,2016,2016-10-09,4:05,2:05,,ATL,5,5,Sun,L 16-23,,8,57,7,78,15,135
2660,DEN,2017,2017-09-17,4:25,2:25,,DAL,2,2,Sun,W 42-17,,8,61,8,69,16,130
2661,DEN,2018,2018-11-04,4:05,2:05,,HOU,9,9,Sun,L 17-19,,8,50,7,60,15,110
2662,DEN,2018,2018-12-15,8:20,2:30,,CLE,15,14,Sat,L 16-17,,8,51,6,75,14,126
2663,DEN,2019,2019-10-13,4:25,2:25,,TEN,6,6,Sun,W 16-0,,8,51,6,40,14,91
2664,DEN,2020,2020-10-01,8:20,8:20,@,NYJ,4,4,Thu,W 37-28,,8,94,11,118,19,212
2665,DEN,2020,2020-11-01,4:05,2:05,,LAC,8,7,Sun,W 31-30,,8,70,6,67,14,137
2666,DEN,2020,2020-11-22,4:05,2:05,,MIA,11,10,Sun,W 20-13,,8,70,5,50,13,120
2667,DET,2000,2000-09-03,1:03,12:03,@,NOR,1,1,Sun,W 14-10,,8,74,12,89,20,163
2668,DET,2001,2001-10-08,9:07,9:07,,STL,4,3,Mon,L 0-35,,8,68,3,15,11,83
2669,DET,2001,2001-10-14,1:00,12:00,@,MIN,5,4,Sun,L 26-31,,8,90,8,70,16,160
2670,DET,2001,2001-10-21,1:00,1:00,,TEN,6,5,Sun,L 24-27,,8,77,5,45,13,122
2671,DET,2001,2001-11-04,4:05,1:05,@,SFO,8,7,Sun,L 13-21,,8,62,6,83,14,145
2672,DET,2002,2002-10-27,1:02,1:02,@,BUF,8,7,Sun,L 17-24,,8,71,6,51,14,122
2673,DET,2002,2002-11-28,12:38,12:38,,NWE,13,12,Thu,L 12-20,,8,60,9,55,17,115
2674,DET,2003,2003-09-28,4:15,2:15,@,DEN,4,4,Sun,L 16-20,,8,74,6,44,14,118
2675,DET,2003,2003-11-16,4:16,1:16,@,SEA,11,10,Sun,L 14-35,,8,56,6,49,14,105
2676,DET,2003,2003-12-07,1:03,1:03,,SDG,14,13,Sun,L 7-14,,8,71,11,95,19,166
2677,DET,2004,2004-09-19,1:04,1:04,,HOU,2,2,Sun,W 28-16,,8,65,9,74,17,139
2678,DET,2004,2004-11-14,1:04,1:04,@,JAX,10,9,Sun,L 17-23,OT,8,45,10,99,18,144
2679,DET,2005,2005-10-02,1:02,1:02,@,TAM,4,3,Sun,L 13-17,,8,55,7,55,15,110
2680,DET,2009,2009-09-13,1:03,12:03,@,NOR,1,1,Sun,L 27-45,,8,80,7,36,15,116
2681,DET,2009,2009-09-27,1:02,1:02,,WAS,3,3,Sun,W 19-14,,8,58,9,97,17,155
2682,DET,2009,2009-11-01,1:03,1:03,,STL,8,7,Sun,L 10-17,,8,67,5,27,13,94
2683,DET,2009,2009-11-22,1:02,1:02,,CLE,11,10,Sun,W 38-37,,8,41,8,69,16,110
2684,DET,2010,2010-09-26,1:05,12:05,@,MIN,3,3,Sun,L 10-24,,8,67,12,100,20,167
2685,DET,2010,2010-11-25,12:38,12:38,,NWE,12,11,Thu,L 24-45,,8,66,5,50,13,116
2686,DET,2011,2011-09-11,1:06,1:06,@,TAM,1,1,Sun,W 27-20,,8,68,6,39,14,107
2687,DET,2011,2011-11-20,1:02,1:02,,CAR,11,10,Sun,W 49-35,,8,56,7,70,15,126
2688,DET,2012,2012-09-16,8:30,5:30,@,SFO,2,2,Sun,L 19-27,,8,67,5,62,13,129
2689,DET,2012,2012-12-02,1:03,1:03,,IND,13,12,Sun,L 33-35,,8,61,4,36,12,97
2690,DET,2013,2013-09-15,4:05,1:05,@,ARI,2,2,Sun,L 21-25,,8,101,7,40,15,141
2691,DET,2013,2013-09-22,1:03,1:03,@,WAS,3,3,Sun,W 27-20,,8,71,6,45,14,116
2692,DET,2013,2013-10-13,1:02,1:02,@,CLE,6,6,Sun,W 31-17,,8,65,9,87,17,152
2693,DET,2013,2013-10-27,1:03,1:03,,DAL,8,8,Sun,W 31-30,,8,61,2,31,10,92
2694,DET,2013,2013-11-17,1:02,1:02,@,PIT,11,10,Sun,L 27-37,,8,45,4,23,12,68
2695,DET,2013,2013-12-16,8:40,8:40,,BAL,15,14,Mon,L 16-18,,8,89,7,60,15,149
2696,DET,2014,2014-09-08,7:11,7:11,,NYG,1,1,Mon,W 35-14,,8,85,4,25,12,110
2697,DET,2014,2014-10-05,1:03,1:03,,BUF,5,5,Sun,L 14-17,,8,62,11,74,19,136
2698,DET,2014,2014-10-26,9:37,1:37,@,ATL,8,8,Sun,W 22-21,,8,85,5,39,13,124
2699,DET,2015,2015-11-01,9:36,2:36,@,KAN,8,8,Sun,L 10-45,,8,81,3,20,11,101
2700,DET,2016,2016-09-11,4:27,4:27,@,IND,1,1,Sun,W 39-35,,8,70,5,45,13,115
2701,DET,2016,2016-10-30,1:03,12:03,@,HOU,8,8,Sun,L 13-20,,8,75,6,49,14,124
2702,DET,2017,2017-11-23,12:30,12:30,,MIN,12,11,Thu,L 23-30,,8,54,9,74,17,128
2703,DET,2017,2017-12-10,1:00,1:00,@,TAM,14,13,Sun,W 24-21,,8,105,7,65,15,170
2704,DET,2017,2017-12-16,4:30,4:30,,CHI,15,14,Sat,W 20-10,,8,58,13,97,21,155
2705,DET,2018,2018-09-30,1:00,12:00,@,DAL,4,4,Sun,L 24-26,,8,58,2,20,10,78
2706,DET,2018,2018-10-07,1:00,1:00,,GNB,5,5,Sun,W 31-23,,8,71,12,112,20,183
2707,DET,2018,2018-11-04,1:00,3:00,@,MIN,9,8,Sun,L 9-24,,8,66,3,15,11,81
2708,DET,2018,2018-12-02,1:00,1:00,,LAR,13,12,Sun,L 16-30,,8,54,7,105,15,159
2709,DET,2019,2019-09-15,1:00,1:00,,LAC,2,2,Sun,W 13-10,,8,71,9,70,17,141
2710,DET,2019,2019-09-29,1:00,1:00,,KAN,4,4,Sun,L 30-34,,8,48,7,51,15,99
2711,DET,2019,2019-10-14,8:15,7:15,@,GNB,6,5,Mon,L 22-23,,8,50,6,48,14,98
2712,DET,2019,2019-10-20,1:00,1:00,,MIN,7,6,Sun,L 30-42,,8,67,6,60,14,127
2713,DET,2019,2019-11-10,1:00,12:00,@,CHI,10,9,Sun,L 13-20,,8,76,7,57,15,133
2714,DET,2020,2020-09-13,1:00,1:00,,CHI,1,1,Sun,L 23-27,,8,77,6,48,14,125
2715,DET,2021,2021-10-24,4:05,1:05,@,LAR,7,7,Sun,L 19-28,,8,77,4,35,12,112
2716,DET,2021,2021-10-31,1:00,1:00,,PHI,8,8,Sun,L 6-44,,8,50,2,15,10,65
2717,DET,2021,2021-11-14,1:00,1:00,@,PIT,10,9,Sun,T 16-16,OT,8,84,7,59,15,143
2718,GNB,2000,2000-11-06,9:09,8:09,,MIN,10,9,Mon,W 26-20,OT,8,63,11,129,19,192
2719,GNB,2001,2001-11-22,12:36,12:36,@,DET,11,10,Thu,W 29-27,,8,63,11,117,19,180
2720,GNB,2002,2002-11-10,1:02,12:02,,DET,10,9,Sun,W 40-14,,8,53,1,10,9,63
2721,GNB,2003,2003-12-07,1:02,12:02,,CHI,14,13,Sun,W 34-21,,8,57,5,45,13,102
2722,GNB,2004,2004-09-13,9:09,9:09,@,CAR,1,1,Mon,W 24-14,,8,77,9,59,17,136
2723,GNB,2005,2005-09-25,1:02,12:02,,TAM,3,3,Sun,L 16-17,,8,65,8,103,16,168
2724,GNB,2005,2005-10-03,9:07,9:07,@,CAR,4,4,Mon,L 29-32,,8,86,8,75,16,161
2725,GNB,2005,2005-11-06,4:15,3:15,,PIT,9,8,Sun,L 10-20,,8,74,4,53,12,127
2726,GNB,2007,2007-09-16,1:04,1:04,@,NYG,2,2,Sun,W 35-13,,8,63,6,71,14,134
2727,GNB,2008,2008-09-14,1:03,1:03,@,DET,2,2,Sun,W 48-25,,8,62,5,40,13,102
2728,GNB,2008,2008-09-21,8:23,7:23,,DAL,3,3,Sun,L 16-27,,8,68,7,54,15,122
2729,GNB,2008,2008-11-30,1:02,12:02,,CAR,13,12,Sun,L 31-35,,8,49,2,12,10,61
2730,GNB,2009,2009-10-25,1:02,1:02,@,CLE,7,6,Sun,W 31-3,,8,70,5,40,13,110
2731,GNB,2010,2010-11-28,1:02,1:02,@,ATL,12,11,Sun,L 17-20,,8,66,4,50,12,116
2732,GNB,2012,2012-11-25,8:30,8:30,@,NYG,12,11,Sun,L 10-38,,8,49,4,24,12,73
2733,GNB,2012,2012-12-16,1:03,12:03,@,CHI,15,14,Sun,W 21-13,,8,104,10,91,18,195
2734,GNB,2013,2013-10-13,1:02,1:02,@,BAL,6,5,Sun,W 19-17,,8,55,6,40,14,95
2735,GNB,2014,2014-09-04,8:42,5:42,@,SEA,1,1,Thu,L 16-36,,8,65,4,69,12,134
2736,GNB,2014,2014-10-26,8:30,7:30,@,NOR,8,8,Sun,L 23-44,,8,84,4,35,12,119
2737,GNB,2014,2014-11-23,1:03,12:03,@,MIN,12,11,Sun,W 24-21,,8,75,7,77,15,152
2738,GNB,2015,2015-10-04,4:25,1:25,@,SFO,4,4,Sun,W 17-3,,8,65,4,30,12,95
2739,GNB,2015,2015-12-13,4:25,3:25,,DAL,14,13,Sun,W 28-7,,8,69,6,30,14,99
2740,GNB,2016,2016-12-18,1:00,12:00,@,CHI,15,14,Sun,W 30-27,,8,64,6,40,14,104
2741,GNB,2017,2017-09-10,4:25,3:25,,SEA,1,1,Sun,W 17-9,,8,70,8,50,16,120
2742,GNB,2017,2017-10-15,1:00,3:00,@,MIN,6,6,Sun,L 10-23,,8,92,7,65,15,157
2743,GNB,2017,2017-10-22,1:00,12:00,,NOR,7,7,Sun,L 17-26,,8,54,7,80,15,134
2744,GNB,2017,2017-12-31,1:00,1:00,@,DET,17,16,Sun,L 11-35,,8,68,5,62,13,130
2745,GNB,2018,2018-09-09,8:20,7:20,,CHI,1,1,Sun,W 24-23,,8,72,5,35,13,107
2746,GNB,2019,2019-11-03,4:25,1:25,@,LAC,9,9,Sun,L 11-26,,8,45,5,45,13,90
2747,GNB,2020,2020-09-20,1:00,12:00,,DET,2,2,Sun,W 42-21,,8,60,7,70,15,130
2748,GNB,2021,2021-11-21,1:00,11:00,@,MIN,11,11,Sun,L 31-34,,8,97,3,25,11,122
2749,GNB,2021,2021-12-19,1:00,1:00,@,BAL,15,14,Sun,W 31-30,,8,76,8,56,16,132
2750,HOU,2002,2002-11-03,1:01,12:01,,CIN,9,8,Sun,L 3-38,,8,60,9,100,17,160
2751,HOU,2002,2002-11-24,4:15,3:15,,NYG,12,11,Sun,W 16-14,,8,68,9,65,17,133
2752,HOU,2003,2003-09-07,1:06,1:06,@,MIA,1,1,Sun,W 21-20,,8,67,11,87,19,154
2753,HOU,2003,2003-10-19,4:05,3:05,,NYJ,7,6,Sun,L 14-19,,8,50,2,9,10,59
2754,HOU,2004,2004-10-31,1:02,12:02,,JAX,8,7,Sun,W 20-6,,8,75,11,80,19,155
2755,HOU,2004,2004-11-14,1:00,1:00,@,IND,10,9,Sun,L 14-49,,8,65,11,85,19,150
2756,HOU,2005,2005-12-11,1:03,12:03,@,TEN,14,13,Sun,L 10-13,,8,72,4,56,12,128
2757,HOU,2005,2006-01-01,4:05,1:05,@,SFO,17,16,Sun,L 17-20,OT,8,74,5,32,13,106
2758,HOU,2006,2006-09-17,1:03,1:03,@,IND,2,2,Sun,L 24-43,,8,58,7,60,15,118
2759,HOU,2006,2006-11-05,1:02,1:02,@,NYG,9,8,Sun,L 10-14,,8,65,6,53,14,118
2760,HOU,2007,2007-10-14,1:03,1:03,@,JAX,6,6,Sun,L 17-37,,8,58,3,28,11,86
2761,HOU,2010,2010-10-10,1:03,12:03,,NYG,5,5,Sun,L 10-34,,8,67,9,84,17,151
2762,HOU,2010,2010-11-14,1:04,1:04,@,JAX,10,9,Sun,L 24-31,,8,49,8,62,16,111
2763,HOU,2010,2010-12-13,8:40,7:40,,BAL,14,13,Mon,L 28-34,OT,8,51,3,15,11,66
2764,HOU,2011,2011-11-13,1:02,1:02,@,TAM,10,10,Sun,W 37-9,,8,54,6,49,14,103
2765,HOU,2012,2012-11-22,12:39,12:39,@,DET,12,11,Thu,W 34-31,OT,8,66,7,70,15,136
2766,HOU,2014,2014-09-28,1:02,12:02,,BUF,4,4,Sun,W 23-17,,8,90,8,40,16,130
2767,HOU,2014,2014-12-14,1:02,1:02,@,IND,15,14,Sun,L 10-17,,8,66,7,45,15,111
2768,HOU,2017,2017-10-29,4:05,1:05,@,SEA,8,7,Sun,L 38-41,,8,93,10,120,18,213
2769,HOU,2017,2017-11-12,4:05,1:05,@,LAR,10,9,Sun,L 7-33,,8,60,10,86,18,146
2770,HOU,2017,2017-12-10,1:00,12:00,,SFO,14,13,Sun,L 16-26,,8,81,11,87,19,168
2771,HOU,2018,2018-10-25,8:20,7:20,,MIA,8,8,Thu,W 42-23,,8,57,5,63,13,120
2772,HOU,2019,2019-09-09,7:10,6:10,@,NOR,1,1,Mon,L 28-30,,8,69,7,48,15,117
2773,HOU,2019,2019-12-01,8:20,7:20,,NWE,13,12,Sun,W 28-22,,8,79,8,60,16,139
2774,HOU,2021,2021-10-10,1:00,12:00,,NWE,5,5,Sun,L 22-25,,8,70,5,27,13,97
2775,HOU,2021,2021-10-24,4:25,2:25,@,ARI,7,7,Sun,L 5-31,,8,80,7,54,15,134
2776,HOU,2021,2021-11-07,1:00,1:00,@,MIA,9,9,Sun,L 9-17,,8,60,2,13,10,73
2777,JAX,2000,2000-10-29,4:15,3:15,@,DAL,9,9,Sun,W 23-17,OT,8,50,7,54,15,104
2778,JAX,2000,2000-11-19,8:35,8:35,@,PIT,12,11,Sun,W 34-24,,8,55,4,30,12,85
2779,JAX,2001,2001-09-30,4:15,4:15,,CLE,3,3,Sun,L 14-23,,8,63,5,47,13,110
2780,JAX,2002,2002-11-03,8:39,8:39,@,NYG,9,8,Sun,L 17-24,,8,63,7,59,15,122
2781,JAX,2002,2002-11-10,4:05,4:05,,WAS,10,9,Sun,W 26-7,,8,55,6,49,14,104
2782,JAX,2002,2002-12-22,1:03,1:03,,TEN,16,15,Sun,L 10-28,,8,51,4,30,12,81
2783,JAX,2003,2003-09-07,1:04,1:04,@,CAR,1,1,Sun,L 23-24,,8,82,9,83,17,165
2784,JAX,2003,2003-09-14,1:03,1:03,,BUF,2,2,Sun,L 17-38,,8,97,6,55,14,152
2785,JAX,2003,2003-10-05,4:05,4:05,,SDG,5,5,Sun,W 27-21,,8,89,10,61,18,150
2786,JAX,2003,2003-12-14,1:02,1:02,@,NWE,15,14,Sun,L 13-27,,8,60,4,55,12,115
2787,JAX,2004,2004-12-12,1:03,1:03,,CHI,14,13,Sun,W 22-3,,8,75,13,104,21,179
2788,JAX,2007,2007-12-02,1:02,1:02,@,IND,13,12,Sun,L 25-28,,8,64,2,15,10,79
2789,JAX,2007,2007-12-30,1:02,12:02,@,HOU,17,16,Sun,L 28-42,,8,45,3,20,11,65
2790,JAX,2008,2008-10-05,8:23,8:23,,PIT,5,5,Sun,L 21-26,,8,89,10,129,18,218
2791,JAX,2008,2008-11-23,1:05,1:05,,MIN,12,11,Sun,L 12-30,,8,81,5,49,13,130
2792,JAX,2008,2008-12-01,8:40,7:40,@,HOU,13,12,Mon,L 17-30,,8,60,5,30,13,90
2793,JAX,2009,2009-09-20,1:03,1:03,,ARI,2,2,Sun,L 17-31,,8,50,7,58,15,108
2794,JAX,2010,2010-11-14,1:04,1:04,,HOU,10,9,Sun,W 31-24,,8,62,8,49,16,111
2795,JAX,2011,2011-09-25,1:02,1:02,@,CAR,3,3,Sun,L 10-16,,8,60,8,69,16,129
2796,JAX,2011,2011-12-11,1:03,1:03,,TAM,14,13,Sun,W 41-14,,8,80,12,97,20,177
2797,JAX,2012,2012-09-16,1:03,1:03,,HOU,2,2,Sun,L 7-27,,8,71,10,64,18,135
2798,JAX,2012,2012-12-02,1:02,1:02,@,BUF,13,12,Sun,L 18-34,,8,74,9,100,17,174
2799,JAX,2013,2013-12-05,8:29,8:29,,HOU,14,13,Thu,W 27-20,,8,57,14,177,22,234
2800,JAX,2015,2015-11-19,8:26,8:26,,TEN,11,10,Thu,W 19-13,,8,88,6,59,14,147
2801,JAX,2015,2015-12-27,4:05,3:05,@,NOR,16,15,Sun,L 27-38,,8,55,5,40,13,95
2802,JAX,2016,2017-01-01,1:00,1:00,@,IND,17,16,Sun,L 20-24,,8,54,4,35,12,89
2803,JAX,2017,2017-12-17,1:00,1:00,,HOU,15,14,Sun,W 45-7,,8,54,14,127,22,181
2804,JAX,2018,2018-09-23,1:00,1:00,,TEN,3,3,Sun,L 6-9,,8,75,4,30,12,105
2805,JAX,2018,2018-11-11,1:00,1:00,@,IND,10,9,Sun,L 26-29,,8,61,7,45,15,106
2806,JAX,2018,2018-12-02,1:00,1:00,,IND,13,12,Sun,W 6-0,,8,74,6,65,14,139
2807,JAX,2018,2018-12-16,1:00,1:00,,WAS,15,14,Sun,L 13-16,,8,55,6,48,14,103
2808,JAX,2018,2018-12-30,1:00,12:00,@,HOU,17,16,Sun,L 3-20,,8,68,2,15,10,83
2809,JAX,2019,2019-11-17,1:00,1:00,@,IND,11,10,Sun,L 13-33,,8,81,3,20,11,101
2810,JAX,2019,2019-12-15,4:05,1:05,@,OAK,15,14,Sun,W 20-16,,8,87,6,51,14,138
2811,JAX,2020,2020-09-20,1:00,12:00,@,TEN,2,2,Sun,L 30-33,,8,60,4,30,12,90
2812,JAX,2020,2020-09-24,8:20,8:20,,MIA,3,3,Thu,L 13-31,,8,63,6,51,14,114
2813,JAX,2020,2020-11-22,1:00,1:00,,PIT,11,10,Sun,L 3-27,,8,105,6,42,14,147
2814,JAX,2021,2021-10-17,9:30,2:30,,MIA,6,6,Sun,W 23-20,,8,54,7,55,15,109
2815,JAX,2021,2021-11-07,1:00,1:00,,BUF,9,8,Sun,W 9-6,,8,54,12,118,20,172
2816,JAX,2021,2021-11-14,1:00,1:00,@,IND,10,9,Sun,L 17-23,,8,79,7,47,15,126
2817,JAX,2021,2021-11-21,1:00,1:00,,SFO,11,10,Sun,L 10-30,,8,56,1,12,9,68
2818,KAN,2000,2000-09-24,4:16,2:16,@,DEN,4,4,Sun,W 23-22,,8,48,6,71,14,119
2819,KAN,2004,2004-09-19,1:00,12:00,,CAR,2,2,Sun,L 17-28,,8,88,6,51,14,139
2820,KAN,2005,2005-11-13,1:02,1:02,@,BUF,10,9,Sun,L 3-14,,8,65,5,37,13,102
2821,KAN,2007,2007-12-16,1:00,12:00,,TEN,15,14,Sun,L 17-26,,8,61,5,35,13,96
2822,KAN,2007,2007-12-30,4:15,4:15,@,NYJ,17,16,Sun,L 10-13,OT,8,62,5,40,13,102
2823,KAN,2008,2008-10-19,1:00,12:00,,TEN,7,6,Sun,L 10-34,,8,60,8,55,16,115
2824,KAN,2010,2010-12-05,1:03,12:03,,DEN,13,12,Sun,W 10-6,,8,60,4,35,12,95
2825,KAN,2011,2011-09-18,1:02,1:02,@,DET,2,2,Sun,L 3-48,,8,70,4,35,12,105
2826,KAN,2011,2011-11-06,1:03,12:03,,MIA,9,8,Sun,L 3-31,,8,70,7,49,15,119
2827,KAN,2011,2011-12-04,1:03,12:03,@,CHI,13,12,Sun,W 10-3,,8,60,5,35,13,95
2828,KAN,2012,2012-10-07,1:02,12:02,,BAL,5,5,Sun,L 6-9,,8,60,5,33,13,93
2829,KAN,2013,2013-12-15,4:05,1:05,@,OAK,15,14,Sun,W 56-31,,8,91,10,90,18,181
2830,KAN,2015,2015-10-18,1:02,12:02,@,MIN,6,6,Sun,L 10-16,,8,95,5,50,13,145
2831,KAN,2015,2015-11-29,1:03,12:03,,BUF,12,11,Sun,W 30-22,,8,58,9,91,17,149
2832,KAN,2015,2015-12-13,1:03,12:03,,SDG,14,13,Sun,W 10-3,,8,53,7,48,15,101
2833,KAN,2016,2016-11-06,1:00,12:00,,JAX,9,8,Sun,W 19-14,,8,75,5,46,13,121
2834,KAN,2016,2016-12-25,8:30,7:30,,DEN,16,15,Sun,W 33-10,,8,65,9,70,17,135
2835,KAN,2017,2017-10-19,8:25,5:25,@,OAK,7,7,Thu,L 30-31,,8,108,10,97,18,205
2836,KAN,2017,2017-11-05,4:25,3:25,@,DAL,9,9,Sun,L 17-28,,8,52,5,65,13,117
2837,KAN,2017,2017-12-03,1:00,1:00,@,NYJ,13,12,Sun,L 31-38,,8,30,5,40,13,70
2838,KAN,2018,2018-10-21,8:20,12:00,,CIN,7,7,Sun,W 45-10,,8,49,8,58,16,107
2839,KAN,2018,2018-11-11,1:00,12:00,,ARI,10,10,Sun,W 26-14,,8,63,3,30,11,93
2840,KAN,2018,2018-12-23,8:20,5:20,@,SEA,16,15,Sun,L 31-38,,8,76,3,20,11,96
2841,KAN,2019,2019-11-18,8:15,7:15,@,LAC,11,11,Mon,W 24-17,,8,102,9,60,17,162
2842,KAN,2020,2020-10-19,5:00,5:00,@,BUF,6,6,Mon,W 26-17,,8,68,4,39,12,107
2843,KAN,2020,2020-11-08,1:00,12:00,,CAR,9,9,Sun,W 33-31,,8,75,12,82,20,157
2844,KAN,2020,2020-12-13,1:00,1:00,@,MIA,14,13,Sun,W 33-27,,8,56,3,35,11,91
2845,KAN,2021,2021-12-12,1:00,12:00,,LVR,14,13,Sun,W 48-9,,8,63,9,85,17,148
2846,MIA,2000,2000-10-01,4:05,4:05,@,CIN,5,5,Sun,W 31-16,,8,61,10,123,18,184
2847,MIA,2000,2000-11-12,4:05,1:05,@,SDG,11,10,Sun,W 17-7,,8,60,8,88,16,148
2848,MIA,2000,2000-12-17,4:16,4:16,,IND,16,15,Sun,L 13-20,,8,45,4,35,12,80
2849,MIA,2001,2001-11-25,1:02,1:02,@,BUF,11,10,Sun,W 34-27,,8,62,10,71,18,133
2850,MIA,2002,2002-10-13,8:35,6:35,@,DEN,6,6,Sun,W 24-22,,8,42,9,70,17,112
2851,MIA,2002,2002-12-09,9:09,9:09,,CHI,14,13,Mon,W 27-9,,8,58,5,55,13,113
2852,MIA,2002,2002-12-21,1:30,12:30,@,MIN,16,15,Sat,L 17-20,,8,65,7,54,15,119
2853,MIA,2003,2003-10-27,9:09,7:09,@,SDG,8,7,Mon,W 26-10,,8,47,6,35,14,82
2854,MIA,2004,2004-09-19,8:36,8:36,@,CIN,2,2,Sun,L 13-16,,8,69,3,19,11,88
2855,MIA,2004,2004-11-21,4:06,1:06,@,SEA,11,10,Sun,L 17-24,,8,98,9,70,17,168
2856,MIA,2005,2005-12-18,1:03,1:03,,NYJ,15,14,Sun,W 24-20,,8,92,5,39,13,131
2857,MIA,2006,2006-10-22,1:02,1:02,,GNB,7,7,Sun,L 24-34,,8,70,9,74,17,144
2858,MIA,2007,2007-09-09,1:02,1:02,@,WAS,1,1,Sun,L 13-16,OT,8,61,7,65,15,126
2859,MIA,2007,2007-10-14,1:03,1:03,@,CLE,6,6,Sun,L 31-41,,8,90,5,32,13,122
2860,MIA,2008,2008-11-23,1:02,1:02,,NWE,12,11,Sun,L 28-48,,8,60,6,38,14,98
2861,MIA,2008,2008-12-14,1:03,1:03,,SFO,15,14,Sun,W 14-9,,8,66,4,22,12,88
2862,MIA,2009,2009-10-12,8:38,8:38,,NYJ,5,5,Mon,W 31-27,,8,112,6,56,14,168
2863,MIA,2009,2009-10-25,4:15,4:15,,NOR,7,6,Sun,L 34-46,,8,55,6,25,14,80
2864,MIA,2009,2009-12-20,1:02,12:02,@,TEN,15,14,Sun,L 24-27,OT,8,60,4,46,12,106
2865,MIA,2010,2010-12-26,1:03,1:03,,DET,16,15,Sun,L 27-34,,8,63,6,53,14,116
2866,MIA,2011,2011-09-12,7:13,7:13,,NWE,1,1,Mon,L 24-38,,8,60,7,50,15,110
2867,MIA,2011,2011-12-04,1:03,1:03,,OAK,13,12,Sun,W 34-14,,8,79,10,91,18,170
2868,MIA,2012,2012-11-04,1:02,1:02,@,IND,9,8,Sun,L 20-23,,8,79,11,91,19,170
2869,MIA,2015,2015-10-25,1:02,1:02,,HOU,7,6,Sun,W 44-26,,8,52,3,25,11,77
2870,MIA,2015,2015-11-08,1:02,1:02,@,BUF,9,8,Sun,L 17-33,,8,62,13,94,21,156
2871,MIA,2015,2015-11-15,1:05,1:05,@,PHI,10,9,Sun,W 20-19,,8,84,7,54,15,138
2872,MIA,2016,2016-09-25,1:02,1:02,,CLE,3,3,Sun,W 30-24,OT,8,67,13,91,21,158
2873,MIA,2016,2016-10-09,1:02,1:02,,TEN,5,5,Sun,L 17-30,,8,83,5,40,13,123
2874,MIA,2016,2016-10-16,1:02,1:02,,PIT,6,6,Sun,W 30-15,,8,95,6,65,14,160
2875,MIA,2016,2016-11-06,1:00,1:00,,NYJ,9,8,Sun,W 27-23,,8,86,10,77,18,163
2876,MIA,2016,2016-11-20,4:05,1:05,@,LAR,11,10,Sun,W 14-10,,8,82,8,70,16,152
2877,MIA,2017,2017-09-24,1:00,1:00,@,NYJ,3,2,Sun,L 6-20,,8,51,10,94,18,145
2878,MIA,2017,2017-12-11,8:30,8:30,,NWE,14,13,Mon,W 27-20,,8,102,9,78,17,180
2879,MIA,2018,2018-12-02,1:00,1:00,,BUF,13,12,Sun,W 21-17,,8,89,13,120,21,209
2880,MIA,2018,2018-12-16,1:00,3:00,@,MIN,15,14,Sun,L 17-41,,8,49,6,45,14,94
2881,MIA,2019,2019-11-24,1:00,1:00,@,CLE,12,11,Sun,L 24-41,,8,94,7,70,15,164
2882,MIA,2020,2020-12-06,1:00,1:00,,CIN,13,12,Sun,W 19-7,,8,54,6,62,14,116
2883,MIA,2021,2021-09-26,4:05,1:05,@,LVR,3,3,Sun,L 28-31,OT,8,68,8,104,16,172
2884,MIA,2021,2021-11-21,1:00,1:00,@,NYJ,11,11,Sun,W 24-17,,8,62,7,48,15,110
2885,MIN,2000,2000-11-19,1:00,12:00,,CAR,12,11,Sun,W 31-17,,8,53,5,30,13,83
2886,MIN,2000,2000-12-17,1:00,12:00,,GNB,16,15,Sun,L 28-33,,8,67,3,25,11,92
2887,MIN,2001,2001-10-14,1:00,12:00,,DET,5,5,Sun,W 31-26,,8,70,8,90,16,160
2888,MIN,2001,2001-12-30,1:02,12:02,@,GNB,16,15,Sun,L 13-24,,8,43,6,60,14,103
2889,MIN,2002,2002-09-08,1:04,12:04,@,CHI,1,1,Sun,L 23-27,,8,52,4,33,12,85
2890,MIN,2002,2002-09-15,4:15,3:15,,BUF,2,2,Sun,L 39-45,OT,8,65,6,65,14,130
2891,MIN,2002,2002-09-29,8:35,5:35,@,SEA,4,4,Sun,L 23-48,,8,58,4,35,12,93
2892,MIN,2002,2002-11-24,1:02,1:02,@,NWE,12,11,Sun,L 17-24,,8,74,5,25,13,99
2893,MIN,2002,2002-12-15,1:04,12:04,@,NOR,15,14,Sun,W 32-31,,8,73,8,53,16,126
2894,MIN,2003,2003-10-05,1:05,1:05,@,ATL,5,5,Sun,W 39-26,,8,58,7,56,15,114
2895,MIN,2004,2004-10-24,1:00,12:00,,TEN,7,6,Sun,W 20-3,,8,66,12,85,20,151
2896,MIN,2005,2005-09-25,1:00,12:00,,NOR,3,3,Sun,W 33-16,,8,60,14,84,22,144
2897,MIN,2006,2006-09-24,1:05,12:05,,CHI,3,3,Sun,L 16-19,,8,83,10,82,18,165
2898,MIN,2006,2006-11-26,1:05,12:05,,ARI,12,11,Sun,W 31-26,,8,63,8,64,16,127
2899,MIN,2006,2006-12-17,1:05,12:05,,NYJ,15,14,Sun,L 13-26,,8,56,7,55,15,111
2900,MIN,2008,2008-10-19,1:02,12:02,@,CHI,7,7,Sun,L 41-48,,8,50,5,45,13,95
2901,MIN,2009,2010-01-03,1:05,12:05,,NYG,17,16,Sun,W 44-7,,8,45,13,95,21,140
2902,MIN,2010,2010-10-11,9:15,9:15,@,NYJ,5,4,Mon,L 20-29,,8,51,6,55,14,106
2903,MIN,2011,2011-09-18,1:05,12:05,,TAM,2,2,Sun,L 20-24,,8,65,6,53,14,118
2904,MIN,2011,2011-12-18,1:05,12:05,,NOR,15,14,Sun,L 20-42,,8,84,6,65,14,149
2905,MIN,2014,2014-12-21,1:03,1:03,@,MIA,16,15,Sun,L 35-37,,8,74,7,54,15,128
2906,MIN,2015,2015-11-22,4:25,3:25,,GNB,11,10,Sun,L 13-30,,8,110,4,19,12,129
2907,MIN,2016,2016-11-06,1:00,3:00,,DET,9,8,Sun,L 16-22,OT,8,54,6,57,14,111
2908,MIN,2016,2016-12-01,7:25,9:25,,DAL,13,12,Thu,L 15-17,,8,57,10,78,18,135
2909,MIN,2016,2016-12-24,1:00,12:00,@,GNB,16,15,Sat,L 25-38,,8,70,3,21,11,91
2910,MIN,2018,2018-09-16,1:00,12:00,@,GNB,2,2,Sun,T 29-29,OT,8,70,7,54,15,124
2911,MIN,2019,2019-09-15,1:00,12:00,@,GNB,2,2,Sun,L 16-21,,8,100,6,35,14,135
2912,MIN,2019,2019-12-08,1:00,3:00,,DET,14,13,Sun,W 20-7,,8,55,4,28,12,83
2913,MIN,2020,2020-11-22,4:25,6:25,,DAL,11,10,Sun,L 28-31,,8,80,4,30,12,110
2914,MIN,2020,2020-11-29,1:00,3:00,,CAR,12,11,Sun,W 28-27,,8,52,7,58,15,110
2915,MIN,2021,2021-11-07,1:00,1:00,@,BAL,9,8,Sun,L 31-34,OT,8,107,8,61,16,168
2916,NOR,2000,2000-10-15,1:04,12:04,,CAR,7,6,Sun,W 24-6,,8,59,7,45,15,104
2917,NOR,2000,2000-11-12,1:02,1:02,@,CAR,11,10,Sun,W 20-10,,8,99,3,22,11,121
2918,NOR,2001,2001-10-07,12:05,12:05,,MIN,4,3,Sun,W 28-15,,8,65,12,116,20,181
2919,NOR,2001,2001-11-04,8:37,7:37,,NYJ,8,7,Sun,L 9-16,,8,65,6,56,14,121
2920,NOR,2001,2001-11-11,4:15,1:15,@,SFO,9,8,Sun,L 27-28,,8,65,5,55,13,120
2921,NOR,2001,2001-12-30,8:36,7:36,,WAS,16,15,Sun,L 10-40,,8,75,4,34,12,109
2922,NOR,2002,2002-12-15,1:04,12:04,,MIN,15,14,Sun,L 31-32,,8,53,8,73,16,126
2923,NOR,2004,2004-09-12,1:06,12:06,,SEA,1,1,Sun,L 7-21,,8,68,5,45,13,113
2924,NOR,2004,2004-10-10,1:03,12:03,,TAM,5,5,Sun,L 17-20,,8,60,11,65,19,125
2925,NOR,2004,2004-11-14,1:02,12:02,,KAN,10,9,Sun,W 27-20,,8,57,12,94,20,151
2926,NOR,2004,2004-12-19,4:05,4:05,@,TAM,15,14,Sun,W 21-17,,8,69,5,45,13,114
2927,NOR,2004,2005-01-02,1:02,1:02,@,CAR,17,16,Sun,W 21-18,,8,87,6,45,14,132
2928,NOR,2005,2005-10-16,1:03,12:03,,ATL,6,6,Sun,L 31-34,,8,55,10,79,18,134
2929,NOR,2005,2005-10-30,4:05,3:05,,MIA,8,8,Sun,L 6-21,,8,77,5,34,13,111
2930,NOR,2007,2007-12-30,1:00,12:00,@,CHI,17,16,Sun,L 25-33,,8,72,5,34,13,106
2931,NOR,2010,2010-12-27,8:40,8:40,@,ATL,16,15,Mon,W 17-14,,8,92,1,10,9,102
2932,NOR,2011,2011-11-06,1:03,12:03,,TAM,9,9,Sun,W 27-16,,8,63,9,80,17,143
2933,NOR,2011,2011-11-13,1:03,1:03,@,ATL,10,10,Sun,W 26-23,OT,8,79,10,85,18,164
2934,NOR,2013,2013-10-27,1:02,12:02,,BUF,8,7,Sun,W 35-17,,8,59,6,45,14,104
2935,NOR,2013,2013-12-15,4:25,3:25,@,STL,15,14,Sun,L 16-27,,8,77,4,30,12,107
2936,NOR,2015,2015-09-27,1:03,1:03,@,CAR,3,3,Sun,L 22-27,,8,55,10,88,18,143
2937,NOR,2015,2015-10-04,8:30,7:30,,DAL,4,4,Sun,W 26-20,OT,8,64,6,30,14,94
2938,NOR,2015,2015-11-08,1:02,12:02,,TEN,9,9,Sun,L 28-34,OT,8,75,9,66,17,141
2939,NOR,2017,2017-10-01,9:30,2:30,@,MIA,4,4,Sun,W 20-0,,8,71,11,90,19,161
2940,NOR,2017,2017-12-17,1:00,12:00,,NYJ,15,14,Sun,W 31-19,,8,92,8,50,16,142
2941,NOR,2018,2018-09-09,1:00,12:00,,TAM,1,1,Sun,L 40-48,,8,77,7,70,15,147
2942,NOR,2018,2018-11-18,4:25,12:00,,PHI,11,10,Sun,W 48-7,,8,69,6,49,14,118
2943,NOR,2020,2020-09-27,8:20,7:20,,GNB,3,3,Sun,L 30-37,,8,83,2,10,10,93
2944,NOR,2020,2020-12-13,4:25,4:25,@,PHI,14,13,Sun,L 21-24,,8,52,6,27,14,79
2945,NWE,2000,2000-11-05,1:02,1:02,,BUF,10,9,Sun,L 13-16,OT,8,103,7,73,15,176
2946,NWE,2002,2002-10-27,4:15,4:15,,DEN,8,7,Sun,L 16-24,,8,83,2,51,10,134
2947,NWE,2002,2002-11-03,1:02,1:02,@,BUF,9,8,Sun,W 38-7,,8,59,5,59,13,118
2948,NWE,2003,2003-09-14,4:15,4:15,@,PHI,2,2,Sun,W 31-10,,8,84,7,53,15,137
2949,NWE,2003,2003-09-28,1:03,1:03,@,WAS,4,4,Sun,L 17-20,,8,64,9,75,17,139
2950,NWE,2004,2004-09-09,9:08,9:08,,IND,1,1,Thu,W 27-24,,8,55,3,20,11,75
2951,NWE,2005,2005-10-16,4:16,2:16,@,DEN,6,6,Sun,L 20-28,,8,55,11,82,19,137
2952,NWE,2005,2005-12-17,1:33,1:33,,TAM,15,14,Sat,W 28-0,,8,54,8,58,16,112
2953,NWE,2006,2006-11-05,8:20,8:20,,IND,9,8,Sun,L 20-27,,8,81,7,68,15,149
2954,NWE,2011,2011-09-18,4:15,4:15,,SDG,2,2,Sun,W 35-21,,8,80,6,44,14,124
2955,NWE,2011,2011-09-25,1:03,1:03,@,BUF,3,3,Sun,L 31-34,,8,93,9,77,17,170
2956,NWE,2012,2012-09-16,1:02,1:02,,ARI,2,2,Sun,L 18-20,,8,60,5,39,13,99
2957,NWE,2012,2012-10-28,1:06,5:06,@,STL,8,8,Sun,W 45-7,,8,42,12,102,20,144
2958,NWE,2012,2012-11-22,8:31,8:31,@,NYJ,12,11,Thu,W 49-19,,8,37,5,35,13,72
2959,NWE,2012,2012-12-16,8:30,8:30,,SFO,15,14,Sun,L 34-41,,8,73,6,88,14,161
2960,NWE,2015,2015-10-18,8:30,8:30,@,IND,6,5,Sun,W 34-27,,8,72,11,103,19,175
2961,NWE,2015,2015-10-29,8:26,8:26,,MIA,8,7,Thu,W 36-7,,8,69,7,40,15,109
2962,NWE,2016,2016-09-11,8:30,5:30,@,ARI,1,1,Sun,W 23-21,,8,69,6,58,14,127
2963,NWE,2016,2016-12-04,1:00,1:00,,LAR,13,12,Sun,W 26-10,,8,46,4,30,12,76
2964,NWE,2017,2017-10-22,8:30,8:30,,ATL,7,7,Sun,W 23-7,,8,65,6,40,14,105
2965,NWE,2019,2019-09-22,1:00,1:00,,NYJ,3,3,Sun,W 30-14,,8,70,5,67,13,137
2966,NWE,2019,2019-09-29,1:00,1:00,@,BUF,4,4,Sun,W 16-10,,8,58,8,76,16,134
2967,NWE,2019,2019-12-01,8:20,7:20,@,HOU,13,12,Sun,L 22-28,,8,60,8,79,16,139
2968,NWE,2021,2021-09-12,4:25,4:25,,MIA,1,1,Sun,L 16-17,,8,84,5,28,13,112
2969,NWE,2021,2021-10-03,8:20,8:20,,TAM,4,4,Sun,L 17-19,,8,77,7,74,15,151
2970,NWE,2021,2021-12-18,8:20,8:20,@,IND,15,14,Sat,L 17-27,,8,50,2,13,10,63
2971,NWE,2021,2022-01-09,1:00,1:00,@,MIA,18,17,Sun,L 24-33,,8,78,5,33,13,111
2972,NYG,2000,2000-10-08,4:05,4:05,@,ATL,6,6,Sun,W 13-6,,8,71,2,13,10,84
2973,NYG,2002,2002-11-17,1:04,1:04,,WAS,11,10,Sun,W 19-17,,8,75,7,39,15,114
2974,NYG,2002,2002-12-08,1:02,1:02,@,WAS,14,13,Sun,W 27-21,,8,61,12,90,20,151
2975,NYG,2003,2003-10-12,1:02,1:02,@,NWE,6,5,Sun,L 6-17,,8,50,10,110,18,160
2976,NYG,2003,2003-12-28,4:05,4:05,,CAR,17,16,Sun,L 24-37,,8,45,8,82,16,127
2977,NYG,2004,2004-09-19,1:04,1:04,,WAS,2,2,Sun,W 20-14,,8,50,7,50,15,100
2978,NYG,2004,2004-09-26,1:02,1:02,,CLE,3,3,Sun,W 27-10,,8,59,8,80,16,139
2979,NYG,2004,2004-10-03,1:02,12:02,@,GNB,4,4,Sun,W 14-7,,8,76,7,72,15,148
2980,NYG,2006,2006-09-24,4:16,1:16,@,SEA,3,3,Sun,L 30-42,,8,63,4,22,12,85
2981,NYG,2006,2006-10-08,1:03,1:03,,WAS,5,4,Sun,W 19-3,,8,76,5,35,13,111
2982,NYG,2007,2007-10-21,1:03,1:03,,SFO,7,7,Sun,W 33-15,,8,67,13,82,21,149
2983,NYG,2007,2007-11-11,4:15,4:15,,DAL,10,9,Sun,L 20-31,,8,70,10,84,18,154
2984,NYG,2008,2008-11-02,4:15,4:15,,DAL,9,8,Sun,W 35-14,,8,65,9,55,17,120
2985,NYG,2008,2008-11-16,1:02,1:02,,BAL,11,10,Sun,W 30-10,,8,65,10,66,18,131
2986,NYG,2009,2009-10-04,1:00,12:00,@,KAN,4,4,Sun,W 27-16,,8,54,7,55,15,109
2987,NYG,2009,2009-11-22,1:03,1:03,,ATL,11,10,Sun,W 34-31,OT,8,64,3,16,11,80
2988,NYG,2010,2010-11-14,4:15,4:15,,DAL,10,9,Sun,L 20-33,,8,69,5,60,13,129
2989,NYG,2011,2011-09-11,4:23,4:23,@,WAS,1,1,Sun,L 14-28,,8,63,3,25,11,88
2990,NYG,2011,2011-12-18,1:02,1:02,,WAS,15,14,Sun,L 10-23,,8,75,2,48,10,123
2991,NYG,2014,2014-12-28,1:02,1:02,,PHI,17,16,Sun,L 26-34,,8,106,5,35,13,141
2992,NYG,2015,2015-09-24,8:26,8:26,,WAS,3,3,Thu,W 32-21,,8,67,7,58,15,125
2993,NYG,2015,2015-11-15,4:31,4:31,,NWE,10,10,Sun,L 26-27,,8,49,7,93,15,142
2994,NYG,2015,2015-12-06,1:03,1:03,,NYJ,13,12,Sun,L 20-23,OT,8,60,8,61,16,121
2995,NYG,2016,2016-10-03,8:35,7:35,@,MIN,4,4,Mon,L 10-24,,8,69,6,37,14,106
2996,NYG,2018,2018-10-07,1:00,1:00,@,CAR,5,5,Sun,L 31-33,,8,62,4,22,12,84
2997,NYG,2018,2018-11-12,8:15,5:15,@,SFO,10,9,Mon,W 27-23,,8,78,10,97,18,175
2998,NYG,2018,2018-11-18,1:00,1:00,,TAM,11,10,Sun,W 38-35,,8,60,4,40,12,100
2999,NYG,2019,2019-09-08,4:25,3:25,@,DAL,1,1,Sun,L 17-35,,8,70,6,47,14,117
3000,NYG,2019,2019-11-04,8:15,8:15,,DAL,9,9,Mon,L 18-37,,8,71,10,104,18,175
3001,NYG,2020,2020-10-11,4:25,3:25,@,DAL,5,5,Sun,L 34-37,,8,81,3,25,11,106
3002,NYG,2021,2021-09-26,1:00,1:00,,ATL,3,3,Sun,L 14-17,,8,53,4,28,12,81
3003,NYG,2021,2021-10-24,1:00,1:00,,CAR,7,7,Sun,W 25-3,,8,60,7,37,15,97
3004,NYJ,2003,2003-11-16,4:05,4:05,@,IND,11,10,Sun,L 31-38,,8,56,4,30,12,86
3005,NYJ,2004,2004-10-10,4:06,4:06,,BUF,5,4,Sun,W 16-14,,8,45,7,83,15,128
3006,NYJ,2005,2005-09-11,1:00,12:00,@,KAN,1,1,Sun,L 7-27,,8,80,4,26,12,106
3007,NYJ,2006,2006-09-10,1:03,12:03,@,TEN,1,1,Sun,W 23-16,,8,53,8,70,16,123
3008,NYJ,2006,2006-09-24,1:02,1:02,@,BUF,3,3,Sun,W 28-20,,8,52,6,43,14,95
3009,NYJ,2006,2006-10-15,4:15,4:15,,MIA,6,6,Sun,W 20-17,,8,70,6,61,14,131
3010,NYJ,2008,2008-12-07,4:05,1:05,@,SFO,14,13,Sun,L 14-24,,8,57,3,25,11,82
3011,NYJ,2009,2009-09-20,1:02,1:02,,NWE,2,2,Sun,W 16-9,,8,55,11,89,19,144
3012,NYJ,2010,2010-11-25,8:30,8:30,,CIN,12,11,Thu,W 26-10,,8,64,2,25,10,89
3013,NYJ,2011,2011-10-09,4:15,4:15,@,NWE,5,5,Sun,L 21-30,,8,89,6,50,14,139
3014,NYJ,2011,2011-10-23,1:03,1:03,,SDG,7,7,Sun,W 27-21,,8,60,13,95,21,155
3015,NYJ,2012,2012-10-14,1:02,1:02,,IND,6,6,Sun,W 35-9,,8,110,3,27,11,137
3016,NYJ,2012,2012-10-21,4:25,4:25,@,NWE,7,7,Sun,L 26-29,OT,8,60,6,40,14,100
3017,NYJ,2013,2013-09-12,8:29,8:29,@,NWE,2,2,Thu,L 10-13,,8,66,3,30,11,96
3018,NYJ,2013,2013-11-03,1:04,1:04,,NOR,9,9,Sun,W 26-20,,8,62,9,59,17,121
3019,NYJ,2015,2015-09-21,8:30,8:30,@,IND,2,2,Mon,W 20-7,,8,90,11,84,19,174
3020,NYJ,2015,2015-12-06,1:03,1:03,@,NYG,13,12,Sun,W 23-20,OT,8,61,8,60,16,121
3021,NYJ,2015,2015-12-19,8:26,7:26,@,DAL,15,14,Sat,W 19-16,,8,61,6,54,14,115
3022,NYJ,2017,2017-11-12,1:00,1:00,@,TAM,10,10,Sun,L 10-15,,8,77,6,50,14,127
3023,NYJ,2017,2017-12-17,1:00,12:00,@,NOR,15,14,Sun,L 19-31,,8,50,8,92,16,142
3024,NYJ,2018,2018-10-21,1:00,1:00,,MIN,7,7,Sun,L 17-37,,8,71,6,55,14,126
3025,NYJ,2018,2018-10-28,1:00,12:00,@,CHI,8,8,Sun,L 10-24,,8,45,2,25,10,70
3026,NYJ,2018,2018-11-25,1:00,1:00,,NWE,12,11,Sun,L 13-27,,8,47,11,105,19,152
3027,NYJ,2019,2019-09-08,1:00,1:00,,BUF,1,1,Sun,L 16-17,,8,67,7,55,15,122
3028,NYJ,2019,2019-10-13,4:25,4:25,,DAL,6,5,Sun,W 24-22,,8,105,9,68,17,173
3029,NYJ,2019,2019-10-21,8:15,8:15,,NWE,7,6,Mon,L 0-33,,8,60,7,92,15,152
3030,NYJ,2019,2019-12-12,8:20,8:20,@,BAL,15,14,Thu,L 21-42,,8,94,6,35,14,129
3031,NYJ,2020,2020-11-22,4:05,1:05,@,LAC,11,10,Sun,L 28-34,,8,88,9,78,17,166
3032,NYJ,2021,2021-09-19,1:00,1:00,,NWE,2,2,Sun,L 6-25,,8,77,6,54,14,131
3033,NYJ,2021,2021-10-31,1:00,1:00,,CIN,8,7,Sun,W 34-31,,8,46,5,51,13,97
3034,TEN,2000,2000-11-12,1:03,12:03,,BAL,11,10,Sun,L 23-24,,8,64,8,72,16,136
3035,TEN,2001,2001-11-04,1:03,12:03,,JAX,8,7,Sun,W 28-24,,8,48,3,14,11,62
3036,TEN,2003,2003-10-05,1:02,1:02,@,NWE,5,5,Sun,L 30-38,,8,66,9,55,17,121
3037,TEN,2003,2003-10-12,1:03,12:03,,HOU,6,6,Sun,W 38-17,,8,69,6,50,14,119
3038,TEN,2003,2003-10-26,1:01,1:01,@,JAX,8,8,Sun,W 30-17,,8,49,5,45,13,94
3039,TEN,2004,2004-09-19,1:02,12:02,,IND,2,2,Sun,L 17-31,,8,71,2,21,10,92
3040,TEN,2006,2006-09-10,1:03,12:03,,NYJ,1,1,Sun,L 16-23,,8,70,8,53,16,123
3041,TEN,2006,2006-10-29,1:02,12:02,,HOU,8,7,Sun,W 28-22,,8,64,10,74,18,138
3042,TEN,2006,2006-12-10,1:02,12:02,@,HOU,14,13,Sun,W 26-20,OT,8,66,7,64,15,130
3043,TEN,2007,2007-09-24,8:40,7:40,@,NOR,3,3,Mon,W 31-14,,8,49,2,15,10,64
3044,TEN,2007,2007-10-14,1:03,1:03,@,TAM,6,5,Sun,L 10-13,,8,49,4,25,12,74
3045,TEN,2008,2008-09-21,1:02,12:02,,HOU,3,3,Sun,W 31-12,,8,75,2,10,10,85
3046,TEN,2008,2008-10-19,1:00,12:00,@,KAN,7,6,Sun,W 34-10,,8,55,8,60,16,115
3047,TEN,2008,2008-11-09,1:02,12:02,@,CHI,10,9,Sun,W 21-14,,8,55,3,20,11,75
3048,TEN,2008,2008-11-23,1:02,12:02,,NYJ,12,11,Sun,L 13-34,,8,60,3,27,11,87
3049,TEN,2009,2009-09-20,1:03,12:03,,HOU,2,2,Sun,L 31-34,,8,64,6,40,14,104
3050,TEN,2009,2009-11-08,4:15,1:15,@,SFO,9,8,Sun,W 34-27,,8,58,5,25,13,83
3051,TEN,2009,2009-11-15,1:02,12:02,,BUF,10,9,Sun,W 41-17,,8,75,10,65,18,140
3052,TEN,2010,2010-09-12,1:02,12:02,,OAK,1,1,Sun,W 38-13,,8,81,10,77,18,158
3053,TEN,2010,2010-09-26,1:02,1:02,@,NYG,3,3,Sun,W 29-10,,8,80,11,86,19,166
3054,TEN,2010,2010-10-18,8:40,8:40,@,JAX,6,6,Mon,W 30-3,,8,57,7,55,15,112
3055,TEN,2011,2011-10-23,1:02,12:02,,HOU,7,6,Sun,L 7-41,,8,76,6,68,14,144
3056,TEN,2011,2011-12-11,1:03,12:03,,NOR,14,13,Sun,L 17-22,,8,54,11,95,19,149
3057,TEN,2012,2012-09-16,4:25,1:25,@,SDG,2,2,Sun,L 10-38,,8,59,4,41,12,100
3058,TEN,2012,2012-10-28,1:06,12:06,,IND,8,8,Sun,L 13-19,OT,8,65,5,45,13,110
3059,TEN,2013,2013-12-08,4:05,2:05,@,DEN,14,13,Sun,L 28-51,,8,66,7,60,15,126
3060,TEN,2015,2015-09-13,4:25,4:25,@,TAM,1,1,Sun,W 42-14,,8,55,12,97,20,152
3061,TEN,2016,2016-09-25,1:02,12:02,,OAK,3,3,Sun,L 10-17,,8,70,8,58,16,128
3062,TEN,2016,2016-11-06,4:25,1:25,@,SDG,9,9,Sun,L 35-43,,8,57,14,107,22,164
3063,TEN,2018,2018-09-16,1:00,12:00,,HOU,2,2,Sun,W 20-17,,8,70,11,88,19,158
3064,TEN,2018,2018-11-18,1:00,1:00,@,IND,11,10,Sun,L 10-38,,8,112,7,60,15,172
3065,TEN,2018,2018-12-02,4:05,3:05,,NYJ,13,12,Sun,W 26-22,,8,75,11,96,19,171
3066,TEN,2019,2019-10-06,1:00,12:00,,BUF,5,5,Sun,L 7-14,,8,60,11,78,19,138
3067,TEN,2019,2019-11-10,1:00,12:00,,KAN,10,10,Sun,W 35-32,,8,64,9,80,17,144
3068,TEN,2021,2021-10-03,1:00,1:00,@,NYJ,4,4,Sun,L 24-27,OT,8,98,6,65,14,163
3069,TEN,2021,2021-11-14,1:00,12:00,,NOR,10,10,Sun,W 23-21,,8,49,9,65,17,114
3070,PHI,2000,2000-10-29,4:07,4:07,@,NYG,9,9,Sun,L 7-24,,8,74,5,35,13,109
3071,PHI,2001,2001-10-07,1:09,1:09,,ARI,4,4,Sun,L 20-21,,8,58,5,40,13,98
3072,PHI,2002,2002-10-20,4:15,4:15,,TAM,7,6,Sun,W 20-10,,8,56,7,59,15,115
3073,PHI,2002,2002-11-17,1:03,1:03,,ARI,11,10,Sun,W 38-14,,8,88,1,5,9,93
3074,PHI,2002,2002-12-28,1:36,1:36,@,NYG,17,16,Sat,L 7-10,OT,8,55,7,64,15,119
3075,PHI,2004,2004-09-12,4:21,4:21,,NYG,1,1,Sun,W 31-17,,8,50,5,30,13,80
3076,PHI,2004,2004-10-31,1:03,1:03,,BAL,8,7,Sun,W 15-10,,8,72,6,91,14,163
3077,PHI,2004,2004-12-05,4:15,4:15,,GNB,13,12,Sun,W 47-17,,8,89,12,99,20,188
3078,PHI,2005,2005-09-12,9:05,9:05,@,ATL,1,1,Mon,L 10-14,,8,55,7,88,15,143
3079,PHI,2005,2005-10-09,4:15,3:15,@,DAL,5,5,Sun,L 10-33,,8,54,5,48,13,102
3080,PHI,2006,2006-10-15,1:02,12:02,@,NOR,6,6,Sun,L 24-27,,8,67,7,64,15,131
3081,PHI,2006,2006-10-29,1:07,1:07,,JAX,8,8,Sun,L 6-13,,8,50,5,44,13,94
3082,PHI,2006,2006-11-19,1:01,1:01,,TEN,11,10,Sun,L 13-31,,8,64,2,15,10,79
3083,PHI,2006,2006-12-04,8:40,8:40,,CAR,13,12,Mon,W 27-24,,8,72,7,67,15,139
3084,PHI,2007,2007-09-09,1:02,12:02,@,GNB,1,1,Sun,L 13-16,,8,76,6,35,14,111
3085,PHI,2007,2007-10-28,1:05,12:05,@,MIN,8,7,Sun,W 23-16,,8,70,6,73,14,143
3086,PHI,2008,2008-11-16,1:03,1:03,@,CIN,11,10,Sun,T 13-13,OT,8,60,4,35,12,95
3087,PHI,2008,2008-11-27,8:16,8:16,,ARI,13,12,Thu,W 48-20,,8,61,1,2,9,63
3088,PHI,2009,2009-11-08,8:31,8:31,,DAL,9,8,Sun,L 16-20,,8,82,11,70,19,152
3089,PHI,2009,2009-11-22,8:30,7:30,@,CHI,11,10,Sun,W 24-20,,8,46,7,64,15,110
3090,PHI,2009,2009-12-06,1:03,1:03,@,ATL,13,12,Sun,W 34-7,,8,62,6,30,14,92
3091,PHI,2010,2010-10-03,4:15,4:15,,WAS,4,4,Sun,L 12-17,,8,80,5,30,13,110
3092,PHI,2011,2011-09-11,1:00,12:00,@,STL,1,1,Sun,W 31-13,,8,91,9,60,17,151
3093,PHI,2011,2011-10-16,1:05,1:05,@,WAS,6,6,Sun,W 20-13,,8,60,9,75,17,135
3094,PHI,2011,2012-01-01,1:02,1:02,,WAS,17,16,Sun,W 34-10,,8,75,6,71,14,146
3095,PHI,2013,2013-09-09,7:10,7:10,@,WAS,1,1,Mon,W 33-27,,8,65,10,75,18,140
3096,PHI,2013,2013-09-29,4:25,2:25,@,DEN,4,4,Sun,L 20-52,,8,62,2,25,10,87
3097,PHI,2013,2013-10-06,1:02,1:02,@,NYG,5,5,Sun,W 36-21,,8,88,12,136,20,224
3098,PHI,2014,2014-12-14,8:35,8:35,,DAL,15,14,Sun,L 27-38,,8,95,11,79,19,174
3099,PHI,2015,2015-09-20,4:25,4:25,,DAL,2,2,Sun,L 10-20,,8,60,18,142,26,202
3100,PHI,2015,2015-10-04,1:03,1:03,@,WAS,4,4,Sun,L 20-23,,8,72,10,110,18,182
3101,PHI,2015,2015-12-06,4:25,4:25,@,NWE,13,12,Sun,W 35-28,,8,97,3,30,11,127
3102,PHI,2015,2015-12-26,8:26,8:26,,WAS,16,15,Sat,L 24-38,,8,45,8,70,16,115
3103,PHI,2016,2016-11-20,4:25,1:25,@,SEA,11,10,Sun,L 15-26,,8,48,7,48,15,96
3104,PHI,2017,2017-09-10,1:00,1:00,@,WAS,1,1,Sun,W 30-17,,8,76,2,15,10,91
3105,PHI,2017,2017-12-25,8:30,8:30,,OAK,16,15,Mon,W 19-10,,8,60,7,50,15,110
3106,PHI,2018,2018-09-30,1:00,12:00,@,TEN,4,4,Sun,L 23-26,OT,8,77,4,30,12,107
3107,PHI,2018,2018-10-07,4:25,4:25,,MIN,5,5,Sun,L 21-23,,8,52,4,23,12,75
3108,PHI,2019,2019-11-03,1:00,1:00,,CHI,9,9,Sun,W 22-14,,8,75,9,70,17,145
3109,PHI,2021,2021-09-19,1:00,1:00,,SFO,2,2,Sun,L 11-17,,8,57,5,60,13,117
3110,PIT,2000,2000-10-15,1:01,1:01,,CIN,7,6,Sun,W 15-0,,8,65,6,46,14,111
3111,PIT,2001,2001-10-14,12:00,12:00,@,KAN,5,4,Sun,W 20-17,,8,67,2,10,10,77
3112,PIT,2002,2002-12-08,1:01,1:01,,HOU,14,13,Sun,L 6-24,,8,57,1,18,9,75
3113,PIT,2003,2003-09-14,1:00,12:00,@,KAN,2,2,Sun,L 20-41,,8,82,4,32,12,114
3114,PIT,2003,2003-09-28,1:01,1:01,,TEN,4,4,Sun,L 13-30,,8,80,10,77,18,157
3115,PIT,2004,2004-11-21,1:03,1:03,@,CIN,11,10,Sun,W 19-14,,8,56,10,97,18,153
3116,PIT,2007,2007-11-18,4:05,4:05,@,NYJ,11,10,Sun,L 16-19,OT,8,100,4,30,12,130
3117,PIT,2008,2008-10-26,4:15,4:15,,NYG,8,7,Sun,L 14-21,,8,59,7,71,15,130
3118,PIT,2008,2008-11-30,4:15,4:15,@,NWE,13,12,Sun,W 33-10,,8,88,6,45,14,133
3119,PIT,2008,2008-12-28,1:02,1:02,,CLE,17,16,Sun,W 31-0,,8,65,6,47,14,112
3120,PIT,2009,2009-11-22,1:00,12:00,@,KAN,11,10,Sun,L 24-27,OT,8,81,4,28,12,109
3121,PIT,2011,2011-10-16,1:02,1:02,,JAX,6,6,Sun,W 17-13,,8,65,4,22,12,87
3122,PIT,2011,2011-10-30,4:15,4:15,,NWE,8,8,Sun,W 25-17,,8,50,6,37,14,87
3123,PIT,2012,2012-09-09,8:31,6:31,@,DEN,1,1,Sun,L 19-31,,8,52,6,49,14,101
3124,PIT,2012,2012-12-09,1:02,1:02,,SDG,14,13,Sun,L 24-34,,8,52,6,51,14,103
3125,PIT,2013,2013-11-03,4:25,4:25,@,NWE,9,8,Sun,L 31-55,,8,96,3,30,11,126
3126,PIT,2015,2015-09-10,8:40,8:40,@,NWE,1,1,Thu,L 21-28,,8,77,7,64,15,141
3127,PIT,2015,2015-10-12,8:30,5:30,@,SDG,5,5,Mon,W 24-20,,8,86,7,54,15,140
3128,PIT,2016,2016-11-20,1:00,1:00,@,CLE,11,10,Sun,W 24-9,,8,70,9,52,17,122
3129,PIT,2017,2017-10-01,1:00,1:00,@,BAL,4,4,Sun,W 26-9,,8,60,6,55,14,115
3130,PIT,2018,2018-10-28,1:00,1:00,,CLE,8,7,Sun,W 33-18,,8,60,7,52,15,112
3131,PIT,2018,2018-11-04,1:00,1:00,@,BAL,9,8,Sun,W 23-16,,8,103,5,25,13,128
3132,PIT,2020,2020-10-11,1:00,1:00,,PHI,5,4,Sun,W 38-29,,8,86,9,84,17,170
3133,PIT,2020,2020-10-25,1:00,12:00,@,TEN,7,6,Sun,W 27-24,,8,69,7,73,15,142
3134,PIT,2021,2021-10-10,1:00,1:00,,DEN,5,5,Sun,W 27-19,,8,59,7,67,15,126
3135,PIT,2021,2021-10-31,1:00,1:00,@,CLE,8,7,Sun,W 15-10,,8,65,5,30,13,95
3136,PIT,2021,2021-11-21,8:20,5:20,@,LAC,11,10,Sun,L 37-41,,8,38,12,75,20,113
3137,OAK,2000,2000-09-03,4:15,1:15,,SDG,1,1,Sun,W 9-6,,8,60,4,35,12,95
3138,OAK,2000,2000-10-15,1:00,12:00,@,KAN,7,6,Sun,W 20-17,,8,69,6,40,14,109
3139,OAK,2000,2000-10-29,8:35,5:35,@,SDG,9,8,Sun,W 15-13,,8,50,11,88,19,138
3140,OAK,2001,2001-10-07,1:15,1:15,,DAL,4,4,Sun,W 28-21,,8,70,4,29,12,99
3141,OAK,2001,2001-12-02,4:15,1:15,,ARI,12,11,Sun,L 31-34,OT,8,76,4,30,12,106
3142,OAK,2001,2001-12-30,4:15,2:15,@,DEN,16,15,Sun,L 17-23,,8,62,2,11,10,73
3143,OAK,2002,2002-12-08,4:15,1:15,@,SDG,14,13,Sun,W 27-7,,8,57,8,46,16,103
3144,OAK,2003,2003-11-02,1:03,1:03,@,DET,9,8,Sun,L 13-23,,8,51,3,30,11,81
3145,OAK,2004,2004-11-07,1:02,1:02,@,CAR,9,9,Sun,W 27-24,,8,53,8,83,16,136
3146,OAK,2004,2004-11-21,4:05,1:05,,SDG,11,10,Sun,L 17-23,,8,76,9,80,17,156
3147,OAK,2004,2005-01-02,4:15,1:15,,JAX,17,16,Sun,L 6-13,,8,72,7,87,15,159
3148,OAK,2005,2005-10-16,4:15,1:15,,SDG,6,5,Sun,L 14-27,,8,51,5,35,13,86
3149,OAK,2005,2005-10-23,4:15,1:15,,BUF,7,6,Sun,W 38-17,,8,53,7,51,15,104
3150,OAK,2005,2005-12-31,8:05,5:05,,NYG,17,16,Sat,L 21-30,,8,54,9,70,17,124
3151,OAK,2006,2006-10-22,4:15,1:15,,ARI,7,6,Sun,W 22-9,,8,70,4,25,12,95
3152,OAK,2006,2006-11-06,8:40,5:40,@,SEA,9,8,Mon,L 0-16,,8,60,10,80,18,140
3153,OAK,2006,2006-11-19,1:00,12:00,@,KAN,11,10,Sun,L 13-17,,8,65,4,20,12,85
3154,OAK,2006,2006-11-26,4:05,1:05,@,SDG,12,11,Sun,L 14-21,,8,56,5,49,13,105
3155,OAK,2007,2007-09-09,4:15,1:15,,DET,1,1,Sun,L 21-36,,8,50,6,35,14,85
3156,OAK,2007,2007-10-14,4:15,1:15,@,SDG,6,5,Sun,L 14-28,,8,68,6,40,14,108
3157,OAK,2007,2007-12-30,4:15,1:15,,SDG,17,16,Sun,L 17-30,,8,60,6,75,14,135
3158,OAK,2008,2008-09-28,4:05,1:05,,SDG,4,4,Sun,L 18-28,,8,64,3,15,11,79
3159,OAK,2010,2010-10-17,4:05,1:05,@,SFO,6,6,Sun,L 9-17,,8,60,11,143,19,203
3160,OAK,2011,2011-09-18,1:03,1:03,@,BUF,2,2,Sun,L 35-38,,8,85,3,26,11,111
3161,OAK,2011,2012-01-01,4:15,1:15,,SDG,17,16,Sun,L 26-38,,8,64,8,68,16,132
3162,OAK,2013,2013-09-08,1:02,1:02,@,IND,1,1,Sun,L 17-21,,8,51,3,31,11,82
3163,OAK,2013,2013-09-23,8:40,6:40,@,DEN,3,3,Mon,L 21-37,,8,77,5,40,13,117
3164,OAK,2013,2013-10-06,11:35,8:35,,SDG,5,5,Sun,W 27-17,,8,85,5,30,13,115
3165,OAK,2013,2013-11-03,4:05,1:05,,PHI,9,8,Sun,L 20-49,,8,70,7,52,15,122
3166,OAK,2013,2013-11-10,1:03,1:03,@,NYG,10,9,Sun,L 20-24,,8,65,1,5,9,70
3167,OAK,2013,2013-11-17,1:03,12:03,@,HOU,11,10,Sun,W 28-23,,8,77,9,50,17,127
3168,OAK,2014,2014-10-19,4:25,1:25,,ARI,7,6,Sun,L 13-24,,8,74,6,43,14,117
3169,OAK,2014,2014-10-26,4:25,4:25,@,CLE,8,7,Sun,L 13-23,,8,54,6,30,14,84
3170,OAK,2014,2014-11-16,4:05,1:05,@,SDG,11,10,Sun,L 6-13,,8,41,6,40,14,81
3171,OAK,2014,2014-11-30,1:00,12:00,@,STL,13,12,Sun,L 0-52,,8,73,8,60,16,133
3172,OAK,2015,2015-11-15,4:05,1:05,,MIN,10,9,Sun,L 14-30,,8,82,3,15,11,97
3173,OAK,2016,2016-09-25,1:02,12:02,@,TEN,3,3,Sun,W 17-10,,8,58,8,70,16,128
3174,OAK,2016,2016-11-06,8:30,5:30,,DEN,9,9,Sun,W 30-20,,8,72,12,104,20,176
3175,OAK,2017,2017-11-19,4:25,3:25,,NWE,11,10,Sun,L 8-33,,8,66,2,10,10,76
3176,OAK,2018,2018-09-23,1:00,1:00,@,MIA,3,3,Sun,L 20-28,,8,38,9,74,17,112
3177,OAK,2018,2018-12-02,4:05,1:05,,KAN,13,12,Sun,L 33-40,,8,74,11,94,19,168
3178,OAK,2018,2018-12-16,1:00,1:00,@,CIN,15,14,Sun,L 16-30,,8,90,9,85,17,175
3179,OAK,2019,2019-10-20,1:00,12:00,@,GNB,7,6,Sun,L 24-42,,8,97,3,20,11,117
3180,LVR,2020,2020-10-11,1:00,12:00,@,KAN,5,5,Sun,W 40-32,,8,59,10,94,18,153
3181,LVR,2020,2020-11-15,4:05,1:05,,DEN,10,9,Sun,W 37-12,,8,82,7,37,15,119
3182,LVR,2020,2020-11-22,8:20,5:20,,KAN,11,10,Sun,L 31-35,,8,72,10,89,18,161
3183,LVR,2021,2021-09-26,4:05,1:05,,MIA,3,3,Sun,W 31-28,OT,8,104,8,68,16,172
3184,LVR,2021,2021-10-04,8:15,5:15,@,LAC,4,4,Mon,L 14-28,,8,73,6,90,14,163
3185,STL,2000,2000-10-22,1:00,12:00,@,KAN,8,7,Sun,L 34-54,,8,87,6,50,14,137
3186,STL,2000,2000-11-20,9:08,8:08,,WAS,12,11,Mon,L 20-33,,8,52,9,67,17,119
3187,STL,2001,2001-09-23,4:29,1:29,@,SFO,2,2,Sun,W 30-26,,8,92,3,25,11,117
3188,STL,2001,2001-10-28,1:02,12:02,,NOR,7,7,Sun,L 31-34,,8,58,7,81,15,139
3189,STL,2002,2002-09-15,3:05,3:05,,NYG,2,2,Sun,L 21-26,,8,40,4,30,12,70
3190,STL,2002,2002-09-29,1:02,12:02,,DAL,4,4,Sun,L 10-13,,8,65,8,60,16,125
3191,STL,2002,2002-11-24,1:01,1:01,@,WAS,12,11,Sun,L 17-20,,8,65,4,40,12,105
3192,STL,2003,2003-10-19,1:02,12:02,,GNB,7,6,Sun,W 34-24,,8,64,6,40,14,104
3193,STL,2003,2003-10-26,1:02,1:02,@,PIT,8,7,Sun,W 33-21,,8,45,5,37,13,82
3194,STL,2004,2004-12-05,1:02,12:02,,SFO,13,12,Sun,W 16-6,,8,59,6,35,14,94
3195,STL,2005,2005-10-23,1:02,12:02,,NOR,7,7,Sun,W 28-17,,8,65,9,102,17,167
3196,STL,2005,2005-11-13,4:16,1:16,@,SEA,10,9,Sun,L 16-31,,8,49,3,69,11,118
3197,STL,2006,2006-10-01,4:05,3:05,,DET,4,4,Sun,W 41-34,,8,66,4,70,12,136
3198,STL,2006,2006-11-05,1:02,12:02,,KAN,9,8,Sun,L 17-31,,8,67,5,23,13,90
3199,STL,2007,2007-09-09,12:59,11:59,,CAR,1,1,Sun,L 13-27,,8,82,7,75,15,157
3200,STL,2007,2007-10-21,4:16,1:16,@,SEA,7,7,Sun,L 6-33,,8,45,4,25,12,70
3201,STL,2010,2010-09-19,4:05,1:05,@,OAK,2,2,Sun,L 14-16,,8,92,12,90,20,182
3202,STL,2011,2011-09-25,4:05,3:05,,BAL,3,3,Sun,L 7-37,,8,117,5,32,13,149
3203,STL,2011,2011-11-27,1:00,12:00,,ARI,12,11,Sun,L 20-23,,8,49,4,30,12,79
3204,STL,2012,2012-12-02,1:00,12:00,,SFO,13,12,Sun,W 16-13,OT,8,65,11,97,19,162
3205,STL,2012,2012-12-16,1:00,12:00,,MIN,15,14,Sun,L 22-36,,8,47,3,49,11,96
3206,STL,2013,2013-09-26,8:25,7:25,,SFO,4,4,Thu,L 11-35,,8,82,10,85,18,167
3207,STL,2013,2013-10-20,1:03,1:03,@,CAR,7,7,Sun,L 15-30,,8,68,7,59,15,127
3208,STL,2013,2013-10-28,8:30,7:30,,SEA,8,8,Mon,L 9-14,,8,53,10,83,18,136
3209,STL,2013,2013-11-10,1:03,1:03,@,IND,10,10,Sun,W 38-8,,8,46,2,20,10,66
3210,STL,2014,2014-09-21,1:00,12:00,,DAL,3,3,Sun,L 31-34,,8,119,3,15,11,134
3211,STL,2014,2014-10-13,8:30,7:30,,SFO,6,5,Mon,L 17-31,,8,38,5,23,13,61
3212,STL,2014,2014-10-26,1:04,12:04,@,KAN,8,7,Sun,L 7-34,,8,68,7,51,15,119
3213,STL,2014,2014-11-09,4:25,2:25,@,ARI,10,9,Sun,L 14-31,,8,80,5,35,13,115
3214,STL,2014,2014-11-30,1:00,12:00,,OAK,13,12,Sun,W 52-0,,8,60,8,73,16,133
3215,STL,2015,2015-10-11,1:02,12:02,@,GNB,5,5,Sun,L 10-24,,8,40,7,67,15,107
3216,STL,2015,2015-11-15,1:00,12:00,,CHI,10,9,Sun,L 13-37,,8,57,4,44,12,101
3217,LAR,2016,2016-09-25,4:05,4:05,@,TAM,3,3,Sun,W 37-32,,8,69,9,80,17,149
3218,LAR,2016,2016-10-16,1:02,1:02,@,DET,6,6,Sun,L 28-31,,8,62,7,62,15,124
3219,LAR,2016,2016-10-23,9:31,2:31,,NYG,7,7,Sun,L 10-17,,8,43,3,33,11,76
3220,LAR,2016,2016-11-20,4:05,1:05,,MIA,11,10,Sun,L 10-14,,8,70,8,82,16,152
3221,LAR,2016,2016-12-15,8:25,5:25,@,SEA,15,14,Thu,L 3-24,,8,76,13,86,21,162
3222,LAR,2017,2017-11-19,1:00,3:00,@,MIN,11,10,Sun,L 7-24,,8,60,7,65,15,125
3223,LAR,2018,2018-09-10,10:20,7:20,@,OAK,1,1,Mon,W 33-13,,8,70,11,155,19,225
3224,LAR,2018,2018-11-19,8:15,7:15,,KAN,11,11,Mon,W 54-51,,8,60,13,135,21,195
3225,LAR,2019,2019-09-15,4:25,1:25,,NOR,2,2,Sun,W 27-9,,8,65,11,87,19,152
3226,LAR,2019,2019-10-13,4:05,1:05,,SFO,6,6,Sun,L 7-20,,8,59,4,30,12,89
3227,LAR,2019,2019-11-25,8:15,5:15,,BAL,12,11,Mon,L 6-45,,8,56,8,66,16,122
3228,LAR,2019,2019-12-01,4:05,2:05,@,ARI,13,12,Sun,W 34-7,,8,81,2,7,10,88
3229,BAL,2000,2000-09-10,1:02,1:02,,JAX,2,2,Sun,W 39-36,,8,65,10,60,18,125
3230,BAL,2000,2000-10-22,1:02,1:02,,TEN,8,8,Sun,L 6-14,,8,52,4,20,12,72
3231,BAL,2000,2000-11-12,1:03,12:03,@,TEN,11,11,Sun,W 24-23,,8,72,8,64,16,136
3232,BAL,2001,2001-12-29,9:07,9:07,@,TAM,16,15,Sat,L 10-22,,8,65,3,25,11,90
3233,BAL,2002,2002-12-01,1:02,1:02,@,CIN,13,12,Sun,W 27-23,,8,79,3,30,11,109
3234,BAL,2002,2002-12-08,4:05,4:05,,NOR,14,13,Sun,L 25-37,,8,69,4,35,12,104
3235,BAL,2003,2003-12-14,4:05,1:05,@,OAK,15,14,Sun,L 12-20,,8,55,9,70,17,125
3236,BAL,2005,2005-09-11,8:38,8:38,,IND,1,1,Sun,L 7-24,,8,45,7,45,15,90
3237,BAL,2005,2005-12-04,1:02,1:02,,HOU,13,12,Sun,W 16-15,,8,71,11,93,19,164
3238,BAL,2005,2006-01-01,1:02,1:02,@,CLE,17,16,Sun,L 16-20,,8,64,9,64,17,128
3239,BAL,2006,2006-11-05,1:02,1:02,,CIN,9,8,Sun,W 26-20,,8,81,4,40,12,121
3240,BAL,2006,2006-11-12,1:03,12:03,@,TEN,10,9,Sun,W 27-26,,8,91,3,20,11,111
3241,BAL,2008,2008-09-29,8:40,8:40,@,PIT,4,3,Mon,L 20-23,OT,8,72,5,29,13,101
3242,BAL,2008,2008-10-26,1:02,1:02,,OAK,8,7,Sun,W 29-10,,8,52,2,10,10,62
3243,BAL,2009,2009-09-13,1:02,1:02,,KAN,1,1,Sun,W 38-24,,8,65,3,15,11,80
3244,BAL,2009,2009-09-27,1:02,1:02,,CLE,3,3,Sun,W 34-3,,8,84,5,46,13,130
3245,BAL,2009,2009-11-01,1:02,1:02,,DEN,8,7,Sun,W 30-7,,8,94,6,35,14,129
3246,BAL,2010,2010-09-26,1:02,1:02,,CLE,3,3,Sun,W 24-17,,8,60,8,60,16,120
3247,BAL,2010,2010-10-17,1:02,1:02,@,NWE,6,6,Sun,L 20-23,OT,8,67,9,78,17,145
3248,BAL,2012,2012-12-02,4:25,4:25,,PIT,13,12,Sun,L 20-23,,8,70,4,50,12,120
3249,BAL,2012,2012-12-09,1:03,1:03,@,WAS,14,13,Sun,L 28-31,OT,8,56,8,70,16,126
3250,BAL,2013,2013-09-29,1:02,1:02,@,BUF,4,4,Sun,L 20-23,,8,59,11,99,19,158
3251,BAL,2013,2013-11-10,1:02,1:02,,CIN,10,9,Sun,W 20-17,OT,8,65,9,134,17,199
3252,BAL,2014,2014-10-12,1:02,1:02,@,TAM,6,6,Sun,W 48-17,,8,70,5,43,13,113
3253,BAL,2014,2014-12-28,1:02,1:02,,CLE,17,16,Sun,W 20-10,,8,55,7,58,15,113
3254,BAL,2016,2016-09-25,1:02,1:02,@,JAX,3,3,Sun,W 19-17,,8,58,7,75,15,133
3255,BAL,2016,2016-11-27,1:00,1:00,,CIN,12,11,Sun,W 19-14,,8,69,2,15,10,84
3256,BAL,2016,2016-12-12,8:30,8:30,@,NWE,14,13,Mon,L 23-30,,8,47,5,48,13,95
3257,BAL,2017,2017-10-15,1:00,1:00,,CHI,6,6,Sun,L 24-27,OT,8,69,5,44,13,113
3258,BAL,2018,2018-12-16,1:00,1:00,,TAM,15,14,Sun,W 20-12,,8,70,6,58,14,128
3259,BAL,2019,2019-10-20,4:25,1:25,@,SEA,7,7,Sun,W 30-16,,8,75,2,18,10,93
3260,BAL,2019,2019-11-17,1:00,1:00,,HOU,11,10,Sun,W 41-7,,8,65,5,60,13,125
3261,BAL,2019,2019-11-25,8:15,5:15,@,LAR,12,11,Mon,W 45-6,,8,66,8,56,16,122
3262,BAL,2020,2020-11-15,8:20,8:20,@,NWE,10,9,Sun,L 17-23,,8,64,3,18,11,82
3263,BAL,2020,2020-12-14,8:15,8:15,@,CLE,14,13,Mon,W 47-42,,8,69,8,75,16,144
3264,BAL,2021,2021-09-19,8:20,8:20,,KAN,2,2,Sun,W 36-35,,8,55,5,46,13,101
3265,BAL,2021,2021-10-11,8:15,8:15,,IND,5,5,Mon,W 31-25,OT,8,74,5,45,13,119
3266,BAL,2021,2021-11-07,1:00,1:00,,MIN,9,8,Sun,W 34-31,OT,8,61,8,107,16,168
3267,BAL,2021,2021-12-19,1:00,1:00,,GNB,15,14,Sun,L 30-31,,8,56,8,76,16,132
3268,SDG,2000,2000-09-17,4:05,3:05,@,KAN,3,3,Sun,L 10-42,,8,86,6,30,14,116
3269,SDG,2000,2000-11-12,4:05,1:05,,MIA,11,10,Sun,L 7-17,,8,88,8,60,16,148
3270,SDG,2000,2000-12-03,4:05,1:05,,SFO,14,13,Sun,L 17-45,,8,68,8,60,16,128
3271,SDG,2000,2000-12-24,4:05,1:05,,PIT,17,16,Sun,L 21-34,,8,82,1,10,9,92
3272,SDG,2002,2002-09-22,4:05,1:05,@,ARI,3,3,Sun,W 23-15,,8,80,2,25,10,105
3273,SDG,2002,2002-11-03,4:05,1:05,,NYJ,9,8,Sun,L 13-44,,8,55,6,65,14,120
3274,SDG,2002,2002-12-08,4:15,1:15,,OAK,14,13,Sun,L 7-27,,8,46,8,57,16,103
3275,SDG,2003,2003-09-07,1:00,12:00,@,KAN,1,1,Sun,L 14-27,,8,55,7,62,15,117
3276,SDG,2004,2004-09-12,1:05,12:05,@,HOU,1,1,Sun,W 27-20,,8,60,6,83,14,143
3277,SDG,2005,2005-09-11,4:15,1:15,,DAL,1,1,Sun,L 24-28,,8,62,8,46,16,108
3278,SDG,2005,2005-12-31,4:35,1:35,,DEN,17,16,Sat,L 7-23,,8,70,4,22,12,92
3279,SDG,2007,2007-09-23,1:02,12:02,@,GNB,3,3,Sun,L 24-31,,8,70,5,38,13,108
3280,SDG,2008,2008-09-14,4:15,2:15,@,DEN,2,2,Sun,L 38-39,,8,60,7,67,15,127
3281,SDG,2009,2009-11-29,4:05,1:05,,KAN,12,11,Sun,W 43-14,,8,55,5,25,13,80
3282,SDG,2010,2010-10-31,4:05,1:05,,TEN,8,8,Sun,W 33-25,,8,62,10,80,18,142
3283,SDG,2011,2011-10-02,4:15,1:15,,MIA,4,4,Sun,W 26-16,,8,80,2,41,10,121
3284,SDG,2011,2011-11-06,4:15,1:15,,GNB,9,8,Sun,L 38-45,,8,64,5,33,13,97
3285,SDG,2011,2012-01-01,4:15,1:15,@,OAK,17,16,Sun,W 38-26,,8,68,8,64,16,132
3286,SDG,2012,2012-11-01,8:27,5:27,,KAN,9,8,Thu,W 31-13,,8,54,5,37,13,91
3287,SDG,2012,2012-12-02,4:25,1:25,,CIN,13,12,Sun,L 13-20,,8,55,8,55,16,110
3288,SDG,2012,2012-12-30,4:21,1:21,,OAK,17,16,Sun,W 24-21,,8,60,9,67,17,127
3289,SDG,2013,2013-10-20,1:02,1:02,@,JAX,7,7,Sun,W 24-6,,8,61,6,45,14,106
3290,SDG,2014,2014-11-23,4:05,1:05,,STL,12,11,Sun,W 27-24,,8,85,9,90,17,175
3291,SDG,2014,2014-11-30,1:02,1:02,@,BAL,13,12,Sun,W 34-33,,8,91,14,98,22,189
3292,SDG,2014,2014-12-07,8:30,5:30,,NWE,14,13,Sun,L 14-23,,8,61,6,70,14,131
3293,SDG,2014,2014-12-14,4:05,1:05,,DEN,15,14,Sun,L 10-22,,8,65,7,71,15,136
3294,SDG,2014,2014-12-20,8:26,5:26,@,SFO,16,15,Sat,W 38-35,OT,8,38,9,92,17,130
3295,SDG,2015,2015-09-20,1:03,1:03,@,CIN,2,2,Sun,L 19-24,,8,64,9,75,17,139
3296,SDG,2015,2015-11-09,8:30,5:30,,CHI,9,9,Mon,L 19-22,,8,54,6,55,14,109
3297,SDG,2015,2015-11-29,1:03,1:03,@,JAX,12,11,Sun,W 31-25,,8,70,6,35,14,105
3298,SDG,2015,2015-12-06,4:05,1:05,,DEN,13,12,Sun,L 3-17,,8,72,3,18,11,90
3299,SDG,2016,2016-10-30,4:05,2:05,@,DEN,8,8,Sun,L 19-27,,8,52,6,45,14,97
3300,LAC,2017,2017-09-24,4:25,1:25,,KAN,3,3,Sun,L 10-24,,8,61,13,122,21,183
3301,LAC,2017,2017-12-24,1:00,1:00,@,NYJ,16,15,Sun,W 14-7,,8,80,5,34,13,114
3302,LAC,2018,2018-12-22,8:20,5:20,,BAL,16,15,Sat,L 10-22,,8,69,4,40,12,109
3303,LAC,2019,2019-10-13,8:20,5:20,,PIT,6,6,Sun,L 17-24,,8,74,6,45,14,119
3304,LAC,2019,2019-10-27,1:00,12:00,@,CHI,8,8,Sun,W 17-16,,8,53,5,42,13,95
3305,LAC,2019,2019-11-07,8:20,5:20,@,OAK,10,10,Thu,L 24-26,,8,70,12,97,20,167
3306,LAC,2019,2019-12-29,1:00,12:00,@,KAN,17,16,Sun,L 21-31,,8,40,5,39,13,79
3307,LAC,2020,2020-09-27,4:05,1:05,,CAR,3,3,Sun,L 16-21,,8,60,3,30,11,90
3308,LAC,2021,2021-09-26,1:00,12:00,@,KAN,3,3,Sun,W 30-24,,8,50,6,56,14,106
3309,SEA,2001,2001-10-14,4:16,1:16,,DEN,5,5,Sun,W 34-21,,8,84,12,148,20,232
3310,SEA,2002,2002-12-08,4:05,1:05,,PHI,14,13,Sun,L 20-27,,8,56,3,15,11,71
3311,SEA,2003,2003-09-14,4:06,1:06,@,ARI,2,2,Sun,W 38-0,,8,64,4,40,12,104
3312,SEA,2003,2003-10-12,8:37,5:37,,SFO,6,5,Sun,W 20-19,,8,105,6,33,14,138
3313,SEA,2005,2005-10-02,1:03,1:03,@,WAS,4,4,Sun,L 17-20,OT,8,84,2,10,10,94
3314,SEA,2005,2005-11-27,4:16,1:16,,NYG,12,11,Sun,W 24-21,OT,8,65,16,114,24,179
3315,SEA,2005,2005-12-11,4:06,1:06,,SFO,14,13,Sun,W 41-3,,8,54,7,82,15,136
3316,SEA,2006,2006-09-10,1:04,1:04,@,DET,1,1,Sun,W 9-6,,8,55,7,61,15,116
3317,SEA,2009,2009-12-27,1:02,12:02,@,GNB,16,15,Sun,L 10-48,,8,86,5,50,13,136
3318,SEA,2010,2010-11-21,4:05,3:05,@,NOR,11,10,Sun,L 19-34,,8,79,3,24,11,103
3319,SEA,2010,2010-12-12,4:05,1:05,@,SFO,14,13,Sun,L 21-40,,8,75,2,15,10,90
3320,SEA,2011,2011-09-25,4:15,1:15,,ARI,3,3,Sun,W 13-10,,8,39,2,20,10,59
3321,SEA,2011,2011-10-23,1:05,1:05,@,CLE,7,6,Sun,L 3-6,,8,68,7,48,15,116
3322,SEA,2012,2012-12-02,1:03,12:03,@,CHI,13,12,Sun,W 23-17,OT,8,55,5,45,13,100
3323,SEA,2013,2013-12-02,8:41,5:41,,NOR,13,12,Mon,W 34-7,,8,66,7,52,15,118
3324,SEA,2013,2013-12-15,1:03,1:03,@,NYG,15,14,Sun,W 23-0,,8,50,5,38,13,88
3325,SEA,2014,2014-09-14,4:05,1:05,@,SDG,2,2,Sun,L 21-30,,8,53,6,53,14,106
3326,SEA,2014,2014-11-16,1:04,12:04,@,KAN,11,10,Sun,L 20-24,,8,50,3,6,11,56
3327,SEA,2014,2014-12-07,4:25,4:25,@,PHI,14,13,Sun,W 24-14,,8,67,4,69,12,136
3328,SEA,2015,2015-11-22,4:27,1:27,,SFO,11,10,Sun,W 29-13,,8,51,5,42,13,93
3329,SEA,2015,2015-11-29,4:26,1:26,,PIT,12,11,Sun,W 39-30,,8,76,6,65,14,141
3330,SEA,2016,2016-09-11,4:08,1:08,,MIA,1,1,Sun,W 12-10,,8,69,4,40,12,109
3331,SEA,2016,2016-11-13,8:30,8:30,@,NWE,10,9,Sun,W 31-24,,8,60,7,61,15,121
3332,SEA,2017,2017-09-10,4:25,3:25,@,GNB,1,1,Sun,L 9-17,,8,50,8,70,16,120
3333,SEA,2017,2017-12-31,4:25,1:25,,ARI,17,16,Sun,L 24-26,,8,100,4,25,12,125
3334,SEA,2018,2018-09-30,4:05,2:05,@,ARI,4,4,Sun,W 20-17,,8,57,5,38,13,95
3335,SEA,2018,2018-10-14,1:00,6:00,@,OAK,6,6,Sun,W 27-3,,8,64,5,38,13,102
3336,SEA,2019,2019-09-08,4:05,1:05,,CIN,1,1,Sun,W 21-20,,8,55,7,57,15,112
3337,SEA,2019,2019-12-08,8:20,5:20,@,LAR,14,13,Sun,L 12-28,,8,64,3,20,11,84
3338,SEA,2020,2020-10-25,8:20,6:20,@,ARI,7,6,Sun,L 34-37,OT,8,78,6,40,14,118
3339,SEA,2020,2020-11-19,8:20,5:20,,ARI,11,10,Thu,W 28-21,,8,79,10,115,18,194
3340,SEA,2020,2020-11-30,8:15,8:15,@,PHI,12,11,Mon,W 23-17,,8,83,9,79,17,162
3341,SEA,2021,2021-12-12,1:00,12:00,@,HOU,14,13,Sun,W 33-13,,8,69,6,52,14,121
3342,SEA,2021,2021-12-21,7:00,4:00,@,LAR,15,14,Tue,L 10-20,,8,65,4,34,12,99
3343,SFO,2000,2000-09-24,1:05,12:05,@,DAL,4,4,Sun,W 41-24,,8,94,5,62,13,156
3344,SFO,2000,2000-10-29,4:05,1:05,,STL,9,9,Sun,L 24-34,,8,80,11,90,19,170
3345,SFO,2000,2000-12-03,4:05,1:05,@,SDG,14,13,Sun,W 45-17,,8,60,8,68,16,128
3346,SFO,2001,2001-10-07,8:38,5:38,,CAR,4,4,Sun,W 24-14,,8,47,8,95,16,142
3347,SFO,2001,2001-10-14,1:04,1:04,@,ATL,5,5,Sun,W 37-31,OT,8,70,4,30,12,100
3348,SFO,2001,2001-10-28,1:03,12:03,@,CHI,7,6,Sun,L 31-37,OT,8,78,3,17,11,95
3349,SFO,2001,2001-11-25,1:00,1:00,@,IND,11,10,Sun,W 40-21,,8,58,7,80,15,138
3350,SFO,2002,2002-10-14,9:09,6:09,@,SEA,6,5,Mon,W 28-21,,8,51,10,80,18,131
3351,SFO,2002,2002-11-17,4:05,1:05,@,SDG,11,10,Sun,L 17-20,OT,8,71,5,36,13,107
3352,SFO,2003,2003-09-21,4:15,1:15,,CLE,3,3,Sun,L 12-13,,8,88,7,60,15,148
3353,SFO,2003,2003-12-21,4:15,4:15,@,PHI,16,15,Sun,W 31-28,OT,8,70,5,35,13,105
3354,SFO,2005,2005-09-25,4:05,1:05,,DAL,3,3,Sun,L 31-34,,8,67,6,45,14,112
3355,SFO,2005,2005-10-02,8:36,7:36,@,ARI,4,4,Sun,L 14-31,,8,52,4,37,12,89
3356,SFO,2005,2005-12-18,1:02,1:02,@,JAX,15,14,Sun,L 9-10,,8,56,10,84,18,140
3357,SFO,2006,2006-09-10,4:15,1:15,@,ARI,1,1,Sun,L 27-34,,8,62,11,85,19,147
3358,SFO,2006,2006-09-24,4:15,1:15,,PHI,3,3,Sun,L 24-38,,8,64,9,72,17,136
3359,SFO,2006,2006-12-31,4:16,2:16,@,DEN,17,16,Sun,W 26-23,OT,8,61,8,49,16,110
3360,SFO,2007,2007-12-23,4:05,1:05,,TAM,16,15,Sun,W 21-19,,8,72,8,56,16,128
3361,SFO,2009,2009-10-11,4:05,1:05,,ATL,5,5,Sun,L 10-45,,8,92,8,90,16,182
3362,SFO,2009,2009-12-06,4:16,1:16,@,SEA,13,12,Sun,L 17-20,,8,57,4,48,12,105
3363,SFO,2009,2009-12-20,4:16,4:16,@,PHI,15,14,Sun,L 13-27,,8,55,4,69,12,124
3364,SFO,2010,2010-09-12,4:16,1:16,@,SEA,1,1,Sun,L 6-31,,8,60,5,35,13,95
3365,SFO,2010,2010-12-26,1:00,12:00,@,STL,16,15,Sun,L 17-25,,8,87,5,41,13,128
3366,SFO,2011,2011-12-04,4:15,1:15,,STL,13,12,Sun,W 26-0,,8,72,5,35,13,107
3367,SFO,2012,2012-09-09,4:25,3:25,@,GNB,1,1,Sun,W 30-22,,8,66,10,77,18,143
3368,SFO,2012,2012-09-30,1:03,1:03,@,NYJ,4,4,Sun,W 34-0,,8,67,4,30,12,97
3369,SFO,2013,2013-12-15,1:02,1:02,@,TAM,15,14,Sun,W 33-14,,8,62,4,32,12,94
3370,SFO,2014,2014-12-14,4:26,1:26,@,SEA,15,14,Sun,L 7-17,,8,78,7,50,15,128
3371,SFO,2015,2015-09-14,10:20,7:20,,MIN,1,1,Mon,W 20-3,,8,57,5,25,13,82
3372,SFO,2017,2017-11-05,4:05,1:05,,ARI,9,9,Sun,L 10-20,,8,53,2,25,10,78
3373,SFO,2017,2017-12-03,1:00,12:00,@,CHI,13,12,Sun,W 15-14,,8,53,4,29,12,82
3374,SFO,2017,2017-12-24,4:05,1:05,,JAX,16,15,Sun,W 44-33,,8,68,12,99,20,167
3375,SFO,2018,2018-11-25,1:00,1:00,@,TAM,12,11,Sun,L 9-27,,8,68,9,70,17,138
3376,SFO,2018,2018-12-16,4:05,1:05,,SEA,15,14,Sun,W 26-23,OT,8,66,14,148,22,214
3377,SFO,2019,2019-10-31,8:20,6:20,@,ARI,9,8,Thu,W 28-25,,8,75,9,65,17,140
3378,SFO,2019,2019-12-29,8:20,5:20,@,SEA,17,16,Sun,W 26-21,,8,57,5,29,13,86
3379,SFO,2021,2021-10-03,4:05,1:05,,SEA,4,4,Sun,L 21-28,,8,78,5,27,13,105
3380,TAM,2000,2000-09-24,4:15,4:15,,NYJ,4,4,Sun,L 17-21,,8,75,4,25,12,100
3381,TAM,2001,2001-10-14,1:04,12:04,@,TEN,5,4,Sun,L 28-31,OT,8,53,12,117,20,170
3382,TAM,2002,2002-09-08,4:15,4:15,,NOR,1,1,Sun,L 20-26,OT,8,85,5,45,13,130
3383,TAM,2002,2002-09-23,9:07,9:07,,STL,3,3,Mon,W 26-14,,8,50,5,33,13,83
3384,TAM,2003,2003-11-16,4:15,4:15,,GNB,11,10,Sun,L 13-20,,8,48,7,29,15,77
3385,TAM,2004,2004-09-26,8:35,5:35,@,OAK,3,3,Sun,L 20-30,,8,56,11,74,19,130
3386,TAM,2004,2005-01-02,4:06,2:06,@,ARI,17,16,Sun,L 7-12,,8,63,10,70,18,133
3387,TAM,2005,2005-09-25,1:02,12:02,@,GNB,3,3,Sun,W 17-16,,8,103,8,65,16,168
3388,TAM,2005,2005-10-30,4:15,1:15,@,SFO,8,7,Sun,L 10-15,,8,65,7,65,15,130
3389,TAM,2005,2005-11-06,1:02,1:02,,CAR,9,8,Sun,L 14-34,,8,42,5,24,13,66
3390,TAM,2005,2005-11-20,1:05,1:05,@,ATL,11,10,Sun,W 30-27,,8,55,11,87,19,142
3391,TAM,2005,2005-12-17,1:33,1:33,@,NWE,15,14,Sat,L 0-28,,8,58,8,54,16,112
3392,TAM,2005,2005-12-24,1:02,1:02,,ATL,16,15,Sat,W 27-24,OT,8,107,7,85,15,192
3393,TAM,2006,2006-09-17,1:05,1:05,@,ATL,2,2,Sun,L 3-14,,8,99,8,83,16,182
3394,TAM,2006,2006-10-08,1:03,12:03,@,NOR,5,4,Sun,L 21-24,,8,66,9,49,17,115
3395,TAM,2006,2006-12-31,1:03,1:03,,SEA,17,16,Sun,L 7-23,,8,51,3,20,11,71
3396,TAM,2007,2007-12-23,4:05,1:05,@,SFO,16,15,Sun,L 19-21,,8,56,8,72,16,128
3397,TAM,2008,2008-09-28,1:02,1:02,,GNB,4,4,Sun,W 30-21,,8,70,7,74,15,144
3398,TAM,2009,2009-11-29,1:03,1:03,@,ATL,12,11,Sun,L 17-20,,8,52,3,29,11,81
3399,TAM,2011,2011-10-23,1:05,6:05,,CHI,7,7,Sun,L 18-24,,8,69,7,54,15,123
3400,TAM,2012,2012-12-09,1:03,1:03,,PHI,14,13,Sun,L 21-23,,8,64,2,13,10,77
3401,TAM,2013,2013-09-29,1:03,1:03,,ARI,4,4,Sun,L 10-13,,8,73,10,90,18,163
3402,TAM,2013,2013-10-13,1:03,1:03,,PHI,6,5,Sun,L 20-31,,8,72,3,31,11,103
3403,TAM,2013,2013-11-03,4:05,1:05,@,SEA,9,8,Sun,L 24-27,OT,8,99,6,67,14,166
3404,TAM,2013,2013-12-08,1:02,1:02,,BUF,14,13,Sun,W 27-6,,8,76,11,114,19,190
3405,TAM,2013,2013-12-29,4:25,3:25,@,NOR,17,16,Sun,L 17-42,,8,78,9,94,17,172
3406,TAM,2014,2014-10-26,1:03,1:03,,MIN,8,7,Sun,L 13-19,OT,8,52,6,59,14,111
3407,TAM,2015,2015-11-01,1:02,1:02,@,ATL,8,7,Sun,W 23-20,OT,8,43,11,124,19,167
3408,TAM,2015,2015-12-06,1:03,1:03,,ATL,13,12,Sun,W 23-19,,8,53,7,58,15,111
3409,TAM,2015,2015-12-13,1:02,1:02,,NOR,14,13,Sun,L 17-24,,8,80,12,95,20,175
3410,TAM,2017,2017-12-03,1:00,12:00,@,GNB,13,12,Sun,L 20-26,OT,8,74,7,47,15,121
3411,TAM,2018,2018-10-21,1:00,1:00,,CLE,7,6,Sun,W 26-23,OT,8,65,14,114,22,179
3412,TAM,2018,2018-11-04,1:00,1:00,@,CAR,9,8,Sun,L 28-42,,8,49,9,84,17,133
3413,TAM,2019,2019-09-08,4:25,4:25,,SFO,1,1,Sun,L 17-31,,8,87,11,87,19,174
3414,TAM,2019,2019-11-24,1:00,1:00,@,ATL,12,11,Sun,W 35-22,,8,51,7,60,15,111
3415,TAM,2019,2019-12-01,1:00,1:00,@,JAX,13,12,Sun,W 28-11,,8,44,16,121,24,165
3416,TAM,2020,2020-10-04,1:00,1:00,,LAC,4,4,Sun,W 38-31,,8,90,7,60,15,150
3417,TAM,2020,2020-11-29,4:25,4:25,,KAN,12,12,Sun,L 24-27,,8,57,10,82,18,139
3418,TAM,2020,2020-12-26,1:00,1:00,@,DET,16,15,Sat,W 47-7,,8,65,11,117,19,182
3419,WAS,2000,2000-10-01,4:15,4:15,,TAM,5,5,Sun,W 20-17,OT,8,48,4,40,12,88
3420,WAS,2000,2000-11-05,4:05,2:05,@,ARI,10,10,Sun,L 15-16,,8,59,8,74,16,133
3421,WAS,2000,2000-12-24,1:01,1:01,,ARI,17,16,Sun,W 20-3,,8,85,7,50,15,135
3422,WAS,2001,2001-09-24,9:08,8:08,@,GNB,2,2,Mon,L 0-37,,8,70,3,15,11,85
3423,WAS,2002,2002-12-29,1:02,1:02,,DAL,17,16,Sun,W 20-14,,8,55,9,86,17,141
3424,WAS,2003,2003-11-02,4:15,3:15,@,DAL,9,8,Sun,L 14-21,,8,57,5,30,13,87
3425,WAS,2003,2003-11-30,4:05,4:05,,NOR,13,12,Sun,L 20-24,,8,120,3,30,11,150
3426,WAS,2004,2004-12-05,4:16,4:16,,NYG,13,12,Sun,W 31-7,,8,66,7,40,15,106
3427,WAS,2004,2004-12-26,4:15,3:15,@,DAL,16,15,Sun,L 10-13,,8,69,1,13,9,82
3428,WAS,2005,2005-10-23,1:03,1:03,,SFO,7,6,Sun,W 52-17,,8,60,5,29,13,89
3429,WAS,2005,2005-12-04,4:05,3:05,@,STL,13,12,Sun,W 24-9,,8,76,4,30,12,106
3430,WAS,2006,2006-11-12,1:02,1:02,@,PHI,10,9,Sun,L 3-27,,8,58,7,65,15,123
3431,WAS,2008,2008-10-26,1:03,1:03,@,DET,8,8,Sun,W 25-17,,8,67,7,51,15,118
3432,WAS,2011,2011-12-11,1:03,1:03,,NWE,14,13,Sun,L 27-34,,8,73,4,47,12,120
3433,WAS,2011,2011-12-24,1:05,1:05,,MIN,16,15,Sat,L 26-33,,8,64,4,40,12,104
3434,WAS,2012,2012-09-30,4:25,4:25,@,TAM,4,4,Sun,W 24-22,,8,73,10,107,18,180
3435,WAS,2012,2012-12-09,1:03,1:03,,BAL,14,13,Sun,W 31-28,OT,8,70,8,56,16,126
3436,WAS,2013,2013-11-07,8:35,7:35,@,MIN,10,9,Thu,L 27-34,,8,63,1,7,9,70
3437,WAS,2013,2013-12-01,8:31,8:31,,NYG,13,12,Sun,L 17-24,,8,55,1,1,9,56
3438,WAS,2013,2013-12-22,1:03,1:03,,DAL,16,15,Sun,L 23-24,,8,44,6,42,14,86
3439,WAS,2015,2015-12-13,1:02,12:02,@,CHI,14,13,Sun,W 24-21,,8,63,7,79,15,142
3440,WAS,2015,2015-12-26,8:26,8:26,@,PHI,16,15,Sat,W 38-24,,8,70,8,45,16,115
3441,WAS,2016,2016-09-18,1:03,1:03,,DAL,2,2,Sun,L 23-27,,8,51,6,39,14,90
3442,WAS,2016,2016-09-25,1:02,1:02,@,NYG,3,3,Sun,W 29-27,,8,70,11,128,19,198
3443,WAS,2017,2017-11-23,8:30,8:30,,NYG,12,11,Thu,W 20-10,,8,55,6,79,14,134
3444,WAS,2018,2018-10-28,1:00,1:00,@,NYG,8,7,Sun,W 20-13,,8,90,11,102,19,192
3445,WAS,2018,2018-11-11,1:00,1:00,@,TAM,10,9,Sun,W 16-3,,8,52,5,50,13,102
3446,WAS,2018,2018-12-22,4:30,4:30,@,TEN,16,15,Sat,L 16-25,,8,49,2,10,10,59
3447,WAS,2019,2019-11-24,1:00,1:00,,DET,12,11,Sun,W 19-16,,8,63,6,65,14,128
3448,WAS,2020,2020-10-18,1:00,1:00,@,NYG,6,6,Sun,L 19-20,,8,50,4,30,12,80
3449,WAS,2021,2021-09-12,1:00,1:00,,LAC,1,1,Sun,L 16-20,,8,57,6,94,14,151
3450,WAS,2021,2021-11-21,1:00,1:00,@,CAR,11,10,Sun,W 27-21,,8,69,7,65,15,134
3451,ATL,2000,2000-09-17,1:02,1:02,@,CAR,3,3,Sun,W 15-10,,7,57,4,28,11,85
3452,ATL,2000,2000-10-22,1:05,1:05,,NOR,8,8,Sun,L 19-21,,7,48,6,45,13,93
3453,ATL,2001,2001-11-04,1:01,1:01,,NWE,8,7,Sun,L 10-24,,7,55,7,60,14,115
3454,ATL,2001,2001-12-02,4:15,4:15,,STL,12,11,Sun,L 6-35,,7,61,12,107,19,168
3455,ATL,2001,2001-12-16,1:00,1:00,@,IND,14,13,Sun,L 27-41,,7,83,5,63,12,146
3456,ATL,2002,2002-09-22,8:35,8:35,,CIN,3,3,Sun,W 30-3,,7,70,8,72,15,142
3457,ATL,2002,2002-12-22,1:03,1:03,,DET,16,15,Sun,W 36-15,,7,55,9,86,16,141
3458,ATL,2003,2003-10-05,1:05,1:05,,MIN,5,5,Sun,L 26-39,,7,56,8,58,15,114
3459,ATL,2003,2003-11-09,1:04,1:04,@,NYG,10,9,Sun,W 27-7,,7,60,9,70,16,130
3460,ATL,2003,2003-12-07,8:37,8:37,,CAR,14,13,Sun,W 20-14,OT,7,42,10,75,17,117
3461,ATL,2004,2004-09-12,4:19,1:19,@,SFO,1,1,Sun,W 21-19,,7,72,10,57,17,129
3462,ATL,2004,2004-10-31,4:05,2:05,@,DEN,8,8,Sun,W 41-28,,7,56,9,70,16,126
3463,ATL,2004,2004-12-05,1:02,1:02,@,TAM,13,12,Sun,L 0-27,,7,50,3,32,10,82
3464,ATL,2005,2005-09-12,9:05,9:05,,PHI,1,1,Mon,W 14-10,,7,88,8,55,15,143
3465,ATL,2005,2005-09-25,1:02,1:02,@,BUF,3,3,Sun,W 24-16,,7,75,3,35,10,110
3466,ATL,2005,2005-12-24,1:02,1:02,@,TAM,16,15,Sat,L 24-27,OT,7,85,8,107,15,192
3467,ATL,2005,2006-01-01,1:05,1:05,,CAR,17,16,Sun,L 11-44,,7,70,6,55,13,125
3468,ATL,2006,2006-11-26,1:05,1:05,,NOR,12,11,Sun,L 13-31,,7,65,5,35,12,100
3469,ATL,2008,2008-09-07,1:04,1:04,,DET,1,1,Sun,W 34-21,,7,68,5,30,12,98
3470,ATL,2009,2009-09-27,1:02,1:02,@,NWE,3,3,Sun,L 10-26,,7,54,2,10,9,64
3471,ATL,2009,2009-11-08,1:03,1:03,,WAS,9,8,Sun,W 31-17,,7,54,10,88,17,142
3472,ATL,2011,2011-09-18,8:30,8:30,,PHI,2,2,Sun,W 35-31,,7,57,4,20,11,77
3473,ATL,2011,2011-09-25,4:16,4:16,@,TAM,3,3,Sun,L 13-16,,7,50,9,66,16,116
3474,ATL,2011,2011-12-04,1:03,12:03,@,HOU,13,12,Sun,L 10-17,,7,43,5,35,12,78
3475,ATL,2011,2011-12-26,8:40,7:40,@,NOR,16,15,Mon,L 16-45,,7,57,4,46,11,103
3476,ATL,2013,2013-09-15,1:03,1:03,,STL,2,2,Sun,W 31-24,,7,53,7,53,14,106
3477,ATL,2013,2013-09-22,4:05,4:05,@,MIA,3,3,Sun,L 23-27,,7,59,2,13,9,72
3478,ATL,2013,2013-11-03,1:03,1:03,@,CAR,9,8,Sun,L 10-34,,7,59,2,15,9,74
3479,ATL,2013,2013-11-17,1:03,1:03,@,TAM,11,10,Sun,L 28-41,,7,45,11,121,18,166
3480,ATL,2013,2013-12-15,1:03,1:03,,WAS,15,14,Sun,W 27-26,,7,73,9,66,16,139
3481,ATL,2014,2014-09-14,1:05,1:05,@,CIN,2,2,Sun,L 10-24,,7,56,7,55,14,111
3482,ATL,2014,2014-10-19,1:02,1:02,@,BAL,7,7,Sun,L 7-29,,7,76,9,72,16,148
3483,ATL,2014,2014-11-23,1:02,1:02,,CLE,12,11,Sun,L 24-26,,7,40,5,30,12,70
3484,ATL,2015,2015-09-14,7:10,7:10,,PHI,1,1,Mon,W 26-24,,7,57,10,88,17,145
3485,ATL,2015,2015-10-15,8:26,7:26,@,NOR,6,6,Thu,L 21-31,,7,41,3,15,10,56
3486,ATL,2015,2015-12-06,1:03,1:03,@,TAM,13,12,Sun,L 19-23,,7,58,8,53,15,111
3487,ATL,2016,2016-09-11,1:05,1:05,,TAM,1,1,Sun,L 24-31,,7,74,6,48,13,122
3488,ATL,2016,2016-09-18,4:25,1:25,@,OAK,2,2,Sun,W 35-28,,7,73,9,58,16,131
3489,ATL,2016,2016-10-09,4:05,2:05,@,DEN,5,5,Sun,W 23-16,,7,78,8,57,15,135
3490,ATL,2016,2016-10-30,4:25,4:25,,GNB,8,8,Sun,W 33-32,,7,46,6,68,13,114
3491,ATL,2017,2017-11-20,8:30,5:30,@,SEA,11,10,Mon,W 34-31,,7,69,9,106,16,175
3492,ATL,2017,2017-12-03,1:00,1:00,,MIN,13,12,Sun,L 9-14,,7,55,6,51,13,106
3493,ATL,2017,2017-12-31,4:25,1:00,,CAR,17,16,Sun,W 22-10,,7,60,5,35,12,95
3494,ATL,2018,2018-10-07,1:00,1:00,@,PIT,5,5,Sun,L 17-41,,7,75,7,58,14,133
3495,ATL,2018,2018-11-04,1:00,1:00,@,WAS,9,8,Sun,W 38-14,,7,50,10,147,17,197
3496,ATL,2019,2019-09-29,1:00,1:00,,TEN,4,4,Sun,L 10-24,,7,50,5,77,12,127
3497,ATL,2019,2019-10-06,1:00,12:00,@,HOU,5,5,Sun,L 32-53,,7,63,9,89,16,152
3498,ATL,2019,2019-11-10,1:00,12:00,@,NOR,10,9,Sun,W 26-9,,7,48,12,90,19,138
3499,ATL,2019,2019-11-24,1:00,1:00,,TAM,12,11,Sun,L 22-35,,7,60,8,51,15,111
3500,ATL,2020,2020-09-27,1:00,1:00,,CHI,3,3,Sun,L 26-30,,7,75,10,80,17,155
3501,ATL,2020,2020-11-22,1:00,12:00,@,NOR,11,10,Sun,L 9-24,,7,53,5,35,12,88
3502,ATL,2020,2020-12-27,1:00,12:00,@,KAN,16,15,Sun,L 14-17,,7,45,6,41,13,86
3503,ATL,2021,2021-10-03,1:00,1:00,,WAS,4,4,Sun,L 30-34,,7,36,6,85,13,121
3504,BUF,2000,2000-09-17,1:03,1:03,@,NYJ,3,3,Sun,L 14-27,,7,66,3,10,10,76
3505,BUF,2000,2000-11-05,1:02,1:02,@,NWE,10,9,Sun,W 16-13,OT,7,73,8,103,15,176
3506,BUF,2001,2001-10-07,4:05,4:05,,NYJ,4,4,Sun,L 36-42,,7,55,6,56,13,111
3507,BUF,2001,2001-12-02,8:36,5:36,@,SFO,12,11,Sun,L 0-35,,7,47,1,10,8,57
3508,BUF,2002,2002-10-06,1:02,1:02,,OAK,5,5,Sun,L 31-49,,7,43,10,120,17,163
3509,BUF,2002,2002-12-01,1:02,1:02,,MIA,13,12,Sun,W 38-21,,7,56,5,38,12,94
3510,BUF,2002,2002-12-29,1:02,1:02,,CIN,17,16,Sun,W 27-9,,7,71,10,105,17,176
3511,BUF,2003,2003-12-21,1:02,1:02,,MIA,16,15,Sun,L 3-20,,7,59,12,106,19,165
3512,BUF,2004,2004-09-12,1:04,1:04,,JAX,1,1,Sun,L 10-13,,7,78,9,50,16,128
3513,BUF,2004,2004-09-19,4:15,1:15,@,OAK,2,2,Sun,L 10-13,,7,55,10,96,17,151
3514,BUF,2004,2004-10-10,4:06,4:06,@,NYJ,5,4,Sun,L 14-16,,7,83,8,45,15,128
3515,BUF,2004,2004-10-17,1:01,1:01,,MIA,6,5,Sun,W 20-13,,7,60,3,21,10,81
3516,BUF,2004,2004-10-31,1:02,1:02,,ARI,8,7,Sun,W 38-14,,7,55,14,101,21,156
3517,BUF,2004,2004-12-12,1:02,1:02,,CLE,14,13,Sun,W 37-7,,7,37,7,40,14,77
3518,BUF,2005,2005-10-09,1:02,1:02,,MIA,5,5,Sun,W 20-14,,7,63,18,102,25,165
3519,BUF,2005,2005-10-23,4:15,1:15,@,OAK,7,7,Sun,L 17-38,,7,51,8,53,15,104
3520,BUF,2005,2005-12-04,1:03,1:03,@,MIA,13,12,Sun,L 23-24,,7,55,13,81,20,136
3521,BUF,2005,2005-12-11,1:02,1:02,,NWE,14,13,Sun,L 7-35,,7,50,9,83,16,133
3522,BUF,2006,2006-09-10,1:02,1:02,@,NWE,1,1,Sun,L 17-19,,7,53,1,5,8,58
3523,BUF,2006,2006-10-08,1:03,12:03,@,CHI,5,5,Sun,L 7-40,,7,44,4,21,11,65
3524,BUF,2007,2007-10-28,4:05,4:05,@,NYJ,8,7,Sun,W 13-3,,7,50,2,25,9,75
3525,BUF,2008,2008-10-26,1:05,1:05,@,MIA,8,7,Sun,L 16-25,,7,64,7,51,14,115
3526,BUF,2008,2008-11-02,1:02,1:02,,NYJ,9,8,Sun,L 17-26,,7,45,5,34,12,79
3527,BUF,2009,2009-09-20,4:05,4:05,,TAM,2,2,Sun,W 33-20,,7,55,13,112,20,167
3528,BUF,2011,2011-10-16,1:02,1:02,@,NYG,6,6,Sun,L 24-27,,7,75,7,79,14,154
3529,BUF,2013,2013-09-15,1:02,1:02,,CAR,2,2,Sun,W 24-23,,7,55,3,30,10,85
3530,BUF,2013,2013-09-22,4:25,4:25,@,NYJ,3,3,Sun,L 20-27,,7,87,20,168,27,255
3531,BUF,2013,2013-10-03,8:29,8:29,@,CLE,5,5,Thu,L 24-37,,7,56,6,66,13,122
3532,BUF,2013,2013-12-15,1:02,1:02,@,JAX,15,14,Sun,W 27-20,,7,67,6,80,13,147
3533,BUF,2014,2014-10-26,1:02,1:02,@,NYJ,8,8,Sun,W 43-23,,7,49,10,90,17,139
3534,BUF,2014,2014-11-13,8:26,8:26,@,MIA,11,10,Thu,L 9-22,,7,70,4,30,11,100
3535,BUF,2014,2014-12-21,4:25,1:25,@,OAK,16,15,Sun,L 24-26,,7,55,4,35,11,90
3536,BUF,2015,2015-10-11,1:03,12:03,@,TEN,5,5,Sun,W 14-13,,7,62,9,74,16,136
3537,BUF,2015,2015-12-27,1:02,1:02,,DAL,16,15,Sun,W 16-6,,7,62,8,65,15,127
3538,BUF,2016,2016-10-09,4:25,1:25,@,LAR,5,5,Sun,W 30-19,,7,60,6,40,13,100
3539,BUF,2016,2016-10-16,1:02,1:02,,SFO,6,6,Sun,W 45-16,,7,71,6,52,13,123
3540,BUF,2016,2016-12-11,1:00,1:00,,PIT,14,13,Sun,L 20-27,,7,46,6,45,13,91
3541,BUF,2018,2018-10-21,1:00,1:00,@,IND,7,7,Sun,L 5-37,,7,59,4,35,11,94
3542,BUF,2018,2018-12-09,1:00,1:00,,NYJ,14,13,Sun,L 23-27,,7,47,7,93,14,140
3543,BUF,2019,2019-09-08,1:00,1:00,@,NYJ,1,1,Sun,W 17-16,,7,55,8,67,15,122
3544,BUF,2019,2019-09-22,1:00,1:00,,CIN,3,3,Sun,W 21-17,,7,55,8,54,15,109
3545,BUF,2019,2019-11-10,1:00,1:00,@,CLE,10,9,Sun,L 16-19,,7,40,4,70,11,110
3546,BUF,2019,2019-11-28,4:30,3:30,@,DAL,13,12,Thu,W 26-15,,7,53,5,66,12,119
3547,BUF,2019,2019-12-21,4:30,4:30,@,NWE,16,15,Sat,L 17-24,,7,46,3,30,10,76
3548,BUF,2020,2020-09-13,1:00,1:00,,NYJ,1,1,Sun,W 27-17,,7,79,9,95,16,174
3549,BUF,2020,2020-12-13,8:20,8:20,,PIT,14,13,Sun,W 26-15,,7,48,3,55,10,103
3550,BUF,2021,2021-11-14,1:00,1:00,@,NYJ,10,9,Sun,W 45-17,,7,50,9,69,16,119
3551,BUF,2021,2021-11-21,1:00,1:00,,IND,11,10,Sun,L 15-41,,7,56,3,30,10,86
3552,BUF,2021,2021-12-12,4:25,4:25,@,TAM,14,13,Sun,L 27-33,OT,7,65,4,24,11,89
3553,BUF,2021,2022-01-02,1:00,1:00,,ATL,17,16,Sun,W 29-15,,7,47,4,27,11,74
3554,CAR,2000,2000-10-15,1:04,12:04,@,NOR,7,6,Sun,L 6-24,,7,45,8,59,15,104
3555,CAR,2000,2000-12-17,1:04,1:04,,SDG,16,15,Sun,W 30-22,,7,45,10,95,17,140
3556,CAR,2001,2001-09-09,1:00,12:00,@,MIN,1,1,Sun,W 24-13,,7,57,7,40,14,97
3557,CAR,2001,2001-09-23,1:12,1:12,@,ATL,2,2,Sun,L 16-24,,7,54,1,5,8,59
3558,CAR,2001,2001-10-21,1:01,1:01,@,WAS,6,6,Sun,L 14-17,OT,7,51,5,50,12,101
3559,CAR,2001,2001-12-30,1:02,1:02,,ARI,16,15,Sun,L 7-30,,7,81,5,30,12,111
3560,CAR,2002,2002-09-29,1:02,12:02,@,GNB,4,4,Sun,L 14-17,,7,77,10,83,17,160
3561,CAR,2002,2002-10-27,1:02,1:02,,TAM,8,8,Sun,L 9-12,,7,70,4,26,11,96
3562,CAR,2002,2002-11-10,1:02,1:02,,NOR,10,9,Sun,L 24-34,,7,57,11,63,18,120
3563,CAR,2003,2003-11-09,1:02,1:02,,TAM,10,9,Sun,W 27-24,,7,64,9,95,16,159
3564,CAR,2004,2004-11-14,4:15,1:15,@,SFO,10,9,Sun,W 37-27,,7,49,7,60,14,109
3565,CAR,2004,2004-12-12,4:15,4:15,,STL,14,13,Sun,W 20-7,,7,55,5,44,12,99
3566,CAR,2004,2004-12-18,8:36,8:36,@,ATL,15,14,Sat,L 31-34,OT,7,50,6,66,13,116
3567,CAR,2005,2005-11-20,1:02,12:02,@,CHI,11,10,Sun,L 3-13,,7,62,9,75,16,137
3568,CAR,2006,2006-09-24,1:03,1:03,@,TAM,3,3,Sun,W 26-24,,7,40,6,56,13,96
3569,CAR,2006,2006-10-01,1:02,1:02,,NOR,4,4,Sun,W 21-18,,7,48,5,38,12,86
3570,CAR,2006,2006-12-04,8:40,8:40,@,PHI,13,12,Mon,L 24-27,,7,67,8,72,15,139
3571,CAR,2006,2006-12-10,1:02,1:02,,NYG,14,13,Sun,L 13-27,,7,37,2,10,9,47
3572,CAR,2007,2007-09-09,12:59,11:59,@,STL,1,1,Sun,W 27-13,,7,75,8,82,15,157
3573,CAR,2007,2007-09-30,4:06,4:06,,TAM,4,4,Sun,L 7-20,,7,65,1,5,8,70
3574,CAR,2007,2007-10-07,1:03,12:03,@,NOR,5,5,Sun,W 16-13,,7,59,5,35,12,94
3575,CAR,2007,2007-12-02,1:03,1:03,,SFO,13,12,Sun,W 31-14,,7,65,7,55,14,120
3576,CAR,2008,2008-11-16,1:03,1:03,,DET,11,10,Sun,W 31-22,,7,55,1,14,8,69
3577,CAR,2009,2009-11-01,4:15,2:15,@,ARI,8,7,Sun,W 34-21,,7,72,5,35,12,107
3578,CAR,2010,2010-09-12,1:04,1:04,@,NYG,1,1,Sun,L 18-31,,7,63,9,95,16,158
3579,CAR,2010,2010-10-10,1:03,1:03,,CHI,5,5,Sun,L 6-23,,7,53,5,45,12,98
3580,CAR,2010,2010-11-14,1:02,1:02,@,TAM,10,9,Sun,L 16-31,,7,71,10,80,17,151
3581,CAR,2010,2010-11-21,1:04,1:04,,BAL,11,10,Sun,L 13-37,,7,54,3,20,10,74
3582,CAR,2011,2011-10-09,1:04,1:04,,NOR,5,5,Sun,L 27-30,,7,65,9,82,16,147
3583,CAR,2011,2011-10-16,1:02,1:02,@,ATL,6,6,Sun,L 17-31,,7,85,4,57,11,142
3584,CAR,2011,2011-11-20,1:02,1:02,@,DET,11,10,Sun,L 35-49,,7,70,8,56,15,126
3585,CAR,2011,2011-12-18,1:03,12:03,@,HOU,15,14,Sun,W 28-13,,7,40,6,60,13,100
3586,CAR,2012,2012-11-04,1:05,1:05,@,WAS,9,8,Sun,W 21-13,,7,60,13,97,20,157
3587,CAR,2012,2012-11-11,1:02,1:02,,DEN,10,9,Sun,L 14-36,,7,45,7,60,14,105
3588,CAR,2012,2012-12-02,1:03,12:03,@,KAN,13,12,Sun,L 21-27,,7,45,1,5,8,50
3589,CAR,2013,2013-10-20,1:03,1:03,,STL,7,6,Sun,W 30-15,,7,59,8,68,15,127
3590,CAR,2013,2013-11-18,8:42,8:42,,NWE,11,10,Mon,W 24-20,,7,47,5,50,12,97
3591,CAR,2014,2014-09-21,8:31,8:31,,PIT,3,3,Sun,L 19-37,,7,105,11,91,18,196
3592,CAR,2014,2014-09-28,1:02,1:02,@,BAL,4,4,Sun,L 10-38,,7,59,4,40,11,99
3593,CAR,2015,2015-12-20,1:02,1:02,@,NYG,15,14,Sun,W 38-35,,7,88,7,47,14,135
3594,CAR,2015,2016-01-03,4:25,4:25,,TAM,17,16,Sun,W 38-10,,7,33,5,65,12,98
3595,CAR,2016,2016-10-10,8:04,8:04,,TAM,5,5,Mon,L 14-17,,7,60,5,40,12,100
3596,CAR,2016,2016-11-27,4:25,1:25,@,OAK,12,11,Sun,L 32-35,,7,67,7,46,14,113
3597,CAR,2018,2018-09-16,1:00,1:00,@,ATL,2,2,Sun,L 24-31,,7,49,2,26,9,75
3598,CAR,2018,2018-12-02,1:00,1:00,@,TAM,13,12,Sun,L 17-24,,7,104,9,69,16,173
3599,CAR,2019,2019-12-08,1:00,1:00,@,ATL,14,13,Sun,L 20-40,,7,44,6,58,13,102
3600,CAR,2020,2020-11-22,1:00,1:00,,DET,11,11,Sun,W 20-0,,7,45,4,20,11,65
3601,CAR,2020,2020-11-29,1:00,3:00,@,MIN,12,12,Sun,L 27-28,,7,58,8,52,15,110
3602,CAR,2020,2020-12-13,1:00,1:00,,DEN,14,13,Sun,L 27-32,,7,48,2,18,9,66
3603,CAR,2020,2020-12-19,8:15,7:15,@,GNB,15,14,Sat,L 16-24,,7,66,5,50,12,116
3604,CAR,2021,2021-10-24,1:00,1:00,@,NYG,7,7,Sun,L 3-25,,7,37,8,60,15,97
3605,CAR,2021,2021-11-21,1:00,1:00,,WAS,11,11,Sun,L 21-27,,7,65,8,69,15,134
3606,CAR,2021,2021-11-28,1:00,1:00,@,MIA,12,12,Sun,L 10-33,,7,61,5,35,12,96
3607,CHI,2000,2000-10-22,1:03,1:03,@,PHI,8,8,Sun,L 9-13,,7,50,4,35,11,85
3608,CHI,2001,2001-09-23,12:12,12:12,,MIN,2,2,Sun,W 17-10,,7,78,6,50,13,128
3609,CHI,2001,2001-11-18,4:15,4:15,@,TAM,10,9,Sun,W 27-24,,7,75,3,39,10,114
3610,CHI,2001,2001-12-30,1:03,1:03,@,DET,16,15,Sun,W 24-0,,7,68,5,50,12,118
3611,CHI,2002,2002-09-15,1:04,1:04,@,ATL,2,2,Sun,W 14-13,,7,79,5,40,12,119
3612,CHI,2002,2002-09-22,1:05,12:05,,NOR,3,3,Sun,L 23-29,,7,49,10,91,17,140
3613,CHI,2002,2002-10-07,9:08,8:08,,GNB,5,5,Mon,L 21-34,,7,65,5,49,12,114
3614,CHI,2003,2003-10-26,1:03,12:03,,DET,8,7,Sun,W 24-16,,7,60,9,64,16,124
3615,CHI,2004,2004-10-17,1:03,12:03,,WAS,6,5,Sun,L 10-13,,7,65,5,39,12,104
3616,CHI,2004,2004-11-25,4:36,3:36,@,DAL,12,11,Thu,L 7-21,,7,45,5,30,12,75
3617,CHI,2004,2004-12-05,1:03,12:03,,MIN,13,12,Sun,W 24-14,,7,55,6,30,13,85
3618,CHI,2005,2005-09-25,1:02,12:02,,CIN,3,3,Sun,L 7-24,,7,88,9,77,16,165
3619,CHI,2005,2005-10-09,1:03,1:03,@,CLE,5,4,Sun,L 10-20,,7,57,5,55,12,112
3620,CHI,2006,2006-11-05,1:02,12:02,,MIA,9,8,Sun,L 13-31,,7,45,11,69,18,114
3621,CHI,2006,2006-12-24,1:03,1:03,@,DET,16,15,Sun,W 26-21,,7,48,11,92,18,140
3622,CHI,2007,2007-10-21,4:14,4:14,@,PHI,7,7,Sun,W 19-16,,7,51,5,32,12,83
3623,CHI,2007,2007-10-28,1:05,12:05,,DET,8,8,Sun,L 7-16,,7,78,5,32,12,110
3624,CHI,2007,2007-11-11,4:15,1:15,@,OAK,10,9,Sun,W 17-6,,7,50,6,46,13,96
3625,CHI,2008,2008-09-07,8:23,8:23,@,IND,1,1,Sun,W 29-13,,7,60,6,40,13,100
3626,CHI,2009,2009-11-22,8:30,7:30,,PHI,11,10,Sun,L 20-24,,7,64,8,46,15,110
3627,CHI,2010,2010-11-07,1:02,1:02,@,BUF,9,8,Sun,W 22-19,,7,45,4,33,11,78
3628,CHI,2011,2011-10-23,1:05,6:05,@,TAM,7,7,Sun,W 24-18,,7,54,8,69,15,123
3629,CHI,2011,2011-11-27,4:05,1:05,@,OAK,12,11,Sun,L 20-25,,7,61,6,44,13,105
3630,CHI,2012,2012-09-09,1:02,12:02,,IND,1,1,Sun,W 41-21,,7,48,3,19,10,67
3631,CHI,2013,2013-12-15,1:03,1:03,@,CLE,15,14,Sun,W 38-31,,7,40,9,90,16,130
3632,CHI,2014,2014-10-12,4:25,4:25,@,ATL,6,6,Sun,W 27-13,,7,47,6,52,13,99
3633,CHI,2014,2014-11-16,1:02,12:02,,MIN,11,10,Sun,W 21-13,,7,60,2,18,9,78
3634,CHI,2015,2015-10-04,1:02,12:02,,OAK,4,4,Sun,W 22-20,,7,48,5,47,12,95
3635,CHI,2015,2015-12-13,1:02,12:02,,WAS,14,13,Sun,L 21-24,,7,79,8,63,15,142
3636,CHI,2016,2016-09-19,8:30,7:30,,PHI,2,2,Mon,L 14-29,,7,60,5,34,12,94
3637,CHI,2016,2016-11-27,1:00,12:00,,TEN,12,11,Sun,L 21-27,,7,48,6,118,13,166
3638,CHI,2018,2018-09-17,8:15,7:15,,SEA,2,2,Mon,W 24-17,,7,55,5,37,12,92
3639,CHI,2018,2018-09-23,4:25,2:25,@,ARI,3,3,Sun,W 16-14,,7,45,6,43,13,88
3640,CHI,2019,2019-09-15,4:25,2:25,@,DEN,2,2,Sun,W 16-14,,7,65,10,81,17,146
3641,CHI,2019,2019-09-29,4:25,3:25,,MIN,4,4,Sun,W 16-6,,7,50,7,55,14,105
3642,CHI,2019,2019-11-10,1:00,12:00,,DET,10,9,Sun,W 20-13,,7,57,8,76,15,133
3643,CHI,2019,2019-12-22,8:20,7:20,,KAN,16,15,Sun,L 3-26,,7,50,9,71,16,121
3644,CHI,2020,2020-11-01,4:25,3:25,,NOR,8,8,Sun,L 23-26,OT,7,53,5,45,12,98
3645,CHI,2020,2020-12-13,1:00,12:00,,HOU,14,13,Sun,W 36-7,,7,44,6,50,13,94
3646,CHI,2021,2021-10-03,1:00,12:00,,DET,4,4,Sun,W 24-14,,7,61,4,26,11,87
3647,CHI,2021,2021-10-17,1:00,12:00,,GNB,6,6,Sun,L 14-24,,7,54,3,51,10,105
3648,CHI,2021,2021-12-12,8:20,7:20,@,GNB,14,13,Sun,L 30-45,,7,41,3,30,10,71
3649,CIN,2000,2000-09-10,1:00,1:00,,CLE,2,1,Sun,L 7-24,,7,65,6,60,13,125
3650,CIN,2000,2000-11-12,1:00,12:00,@,DAL,11,10,Sun,L 6-23,,7,94,13,100,20,194
3651,CIN,2001,2001-09-30,4:15,1:15,@,SDG,3,3,Sun,L 14-28,,7,61,6,65,13,126
3652,CIN,2001,2001-12-09,1:02,1:02,,JAX,13,12,Sun,L 10-14,,7,54,7,40,14,94
3653,CIN,2001,2001-12-30,1:02,1:02,,PIT,16,15,Sun,W 26-23,OT,7,65,7,38,14,103
3654,CIN,2003,2003-09-14,4:15,1:15,@,OAK,2,2,Sun,L 20-23,,7,65,6,59,13,124
3655,CIN,2003,2003-09-21,1:02,1:02,,PIT,3,3,Sun,L 10-17,,7,49,6,53,13,102
3656,CIN,2003,2003-10-05,1:02,1:02,@,BUF,5,5,Sun,L 16-22,OT,7,49,6,49,13,98
3657,CIN,2003,2003-10-26,1:02,1:02,,SEA,8,7,Sun,W 27-24,,7,60,5,30,12,90
3658,CIN,2003,2003-11-09,1:03,1:03,,HOU,10,9,Sun,W 34-27,,7,55,6,58,13,113
3659,CIN,2004,2004-12-19,1:03,1:03,,BUF,15,14,Sun,L 17-33,,7,62,4,37,11,99
3660,CIN,2007,2007-11-11,4:05,4:05,@,BAL,10,9,Sun,W 21-7,,7,45,6,30,13,75
3661,CIN,2008,2008-10-05,4:15,3:15,@,DAL,5,5,Sun,L 22-31,,7,44,6,52,13,96
3662,CIN,2008,2008-10-26,3:47,2:47,@,HOU,8,8,Sun,L 6-35,,7,51,7,55,14,106
3663,CIN,2009,2009-10-11,1:02,1:02,@,BAL,5,5,Sun,W 17-14,,7,39,10,76,17,115
3664,CIN,2009,2009-11-15,1:02,1:02,@,PIT,10,9,Sun,W 18-12,,7,87,5,50,12,137
3665,CIN,2009,2010-01-03,8:31,8:31,@,NYJ,17,16,Sun,L 0-37,,7,44,4,20,11,64
3666,CIN,2010,2010-10-24,1:05,1:05,@,ATL,7,6,Sun,L 32-39,,7,36,3,41,10,77
3667,CIN,2010,2010-11-21,1:02,1:02,,BUF,11,10,Sun,L 31-49,,7,57,10,58,17,115
3668,CIN,2010,2010-12-05,1:03,1:03,,NOR,13,12,Sun,L 30-34,,7,43,11,100,18,143
3669,CIN,2011,2011-09-18,4:15,2:15,@,DEN,2,2,Sun,L 22-24,,7,69,7,55,14,124
3670,CIN,2011,2011-10-30,4:16,1:16,@,SEA,8,7,Sun,W 34-12,,7,65,11,80,18,145
3671,CIN,2012,2012-10-14,1:02,1:02,@,CLE,6,6,Sun,L 24-34,,7,50,5,35,12,85
3672,CIN,2012,2012-12-23,1:02,1:02,@,PIT,16,15,Sun,W 13-10,,7,55,5,63,12,118
3673,CIN,2013,2013-10-06,1:02,1:02,,NWE,5,5,Sun,W 13-6,,7,59,0,0,7,59
3674,CIN,2013,2013-12-08,1:02,1:02,,IND,14,13,Sun,W 42-28,,7,60,6,47,13,107
3675,CIN,2014,2014-09-14,1:05,1:05,,ATL,2,2,Sun,W 24-10,,7,55,7,56,14,111
3676,CIN,2014,2014-09-21,1:02,1:02,,TEN,3,3,Sun,W 33-7,,7,50,11,99,18,149
3677,CIN,2014,2014-11-06,8:29,8:29,,CLE,10,9,Thu,L 3-24,,7,55,6,62,13,117
3678,CIN,2014,2014-12-07,1:02,1:02,,PIT,14,13,Sun,L 21-42,,7,54,3,20,10,74
3679,CIN,2014,2014-12-22,8:30,8:30,,DEN,16,15,Mon,W 37-28,,7,45,6,72,13,117
3680,CIN,2015,2015-10-11,1:03,1:03,,SEA,5,5,Sun,W 27-24,OT,7,50,10,112,17,162
3681,CIN,2016,2016-10-16,1:02,1:02,@,NWE,6,6,Sun,L 17-35,,7,46,6,55,13,101
3682,CIN,2016,2016-10-30,8:36,1:36,,WAS,8,8,Sun,T 27-27,OT,7,85,15,106,22,191
3683,CIN,2017,2017-09-14,8:25,8:25,,HOU,2,2,Thu,L 9-13,,7,45,9,61,16,106
3684,CIN,2017,2017-09-24,4:25,3:25,@,GNB,3,3,Sun,L 24-27,OT,7,68,4,33,11,101
3685,CIN,2017,2017-12-10,1:00,1:00,,CHI,14,13,Sun,L 7-33,,7,56,10,74,17,130
3686,CIN,2018,2018-11-18,1:00,1:00,@,BAL,11,10,Sun,L 21-24,,7,58,5,31,12,89
3687,CIN,2019,2019-09-08,4:05,1:05,@,SEA,1,1,Sun,L 20-21,,7,57,8,55,15,112
3688,CIN,2019,2019-09-15,1:00,1:00,,SFO,2,2,Sun,L 17-41,,7,60,9,75,16,135
3689,CIN,2019,2019-10-06,1:00,1:00,,ARI,5,5,Sun,L 23-26,,7,60,12,96,19,156
3690,CIN,2019,2019-11-24,1:00,1:00,,PIT,12,11,Sun,L 10-16,,7,79,10,77,17,156
3691,CIN,2020,2020-09-13,4:05,4:05,,LAC,1,1,Sun,L 13-16,,7,44,6,35,13,79
3692,CIN,2020,2020-10-04,1:00,1:00,,JAX,4,4,Sun,W 33-25,,7,73,6,49,13,122
3693,CIN,2020,2020-10-25,1:00,1:00,,CLE,7,7,Sun,L 34-37,,7,45,5,40,12,85
3694,CIN,2020,2020-11-01,1:00,1:00,,TEN,8,8,Sun,W 31-20,,7,45,7,68,14,113
3695,CIN,2021,2021-12-05,1:00,1:00,,LAC,13,12,Sun,L 22-41,,7,63,7,51,14,114
3696,CLE,2000,2000-11-19,1:03,12:03,@,TEN,12,12,Sun,L 10-24,,7,61,5,45,12,106
3697,CLE,2000,2000-12-17,1:03,1:03,,TEN,16,16,Sun,L 0-24,,7,66,3,25,10,91
3698,CLE,2001,2001-11-18,1:01,1:01,@,BAL,10,9,Sun,W 27-17,,7,50,7,47,14,97
3699,CLE,2001,2001-12-02,1:02,1:02,,TEN,12,11,Sun,L 15-31,,7,52,9,72,16,124
3700,CLE,2002,2002-09-22,1:03,12:03,@,TEN,3,3,Sun,W 31-28,OT,7,57,13,96,20,153
3701,CLE,2002,2002-09-29,1:01,1:01,@,PIT,4,4,Sun,L 13-16,OT,7,50,7,45,14,95
3702,CLE,2002,2002-10-27,1:02,1:02,@,NYJ,8,8,Sun,W 24-21,,7,45,6,40,13,85
3703,CLE,2002,2002-12-15,1:02,1:02,,IND,15,14,Sun,L 23-28,,7,39,5,44,12,83
3704,CLE,2002,2002-12-22,4:15,4:15,@,BAL,16,15,Sun,W 14-13,,7,70,6,40,13,110
3705,CLE,2003,2003-09-21,4:15,1:15,@,SFO,3,3,Sun,W 13-12,,7,60,8,88,15,148
3706,CLE,2003,2003-10-19,1:02,1:02,,SDG,7,7,Sun,L 20-26,,7,76,12,93,19,169
3707,CLE,2003,2003-11-16,1:03,1:03,,ARI,11,10,Sun,W 44-6,,7,64,9,55,16,119
3708,CLE,2003,2003-12-14,4:05,2:05,@,DEN,15,14,Sun,L 20-23,OT,7,32,11,124,18,156
3709,CLE,2004,2004-11-21,1:02,1:02,,NYJ,11,10,Sun,L 7-10,,7,40,5,50,12,90
3710,CLE,2004,2004-12-05,1:02,1:02,,NWE,13,12,Sun,L 15-42,,7,84,7,60,14,144
3711,CLE,2004,2004-12-12,1:02,1:02,@,BUF,14,13,Sun,L 7-37,,7,40,7,37,14,77
3712,CLE,2004,2004-12-19,1:03,1:03,,SDG,15,14,Sun,L 0-21,,7,55,1,8,8,63
3713,CLE,2005,2005-09-11,1:07,1:07,,CIN,1,1,Sun,L 13-27,,7,56,5,40,12,96
3714,CLE,2005,2005-09-25,12:03,12:03,@,IND,3,3,Sun,L 6-13,,7,62,3,15,10,77
3715,CLE,2005,2005-12-04,1:03,1:03,,JAX,13,12,Sun,L 14-20,,7,97,5,50,12,147
3716,CLE,2005,2005-12-11,1:03,1:03,@,CIN,14,13,Sun,L 20-23,,7,45,6,33,13,78
3717,CLE,2006,2006-10-08,1:02,1:02,@,CAR,5,5,Sun,L 12-20,,7,70,4,34,11,104
3718,CLE,2006,2006-11-12,1:05,1:05,@,ATL,10,9,Sun,W 17-13,,7,52,8,76,15,128
3719,CLE,2006,2006-11-19,1:03,1:03,,PIT,11,10,Sun,L 20-24,,7,57,5,50,12,107
3720,CLE,2006,2006-12-17,1:02,1:02,@,BAL,15,14,Sun,L 17-27,,7,50,4,30,11,80
3721,CLE,2007,2007-10-07,1:02,1:02,@,NWE,5,5,Sun,L 17-34,,7,40,6,52,13,92
3722,CLE,2007,2007-11-11,1:02,1:02,@,PIT,10,9,Sun,L 28-31,,7,40,5,30,12,70
3723,CLE,2007,2007-11-25,1:03,1:03,,HOU,12,11,Sun,W 27-17,,7,71,5,26,12,97
3724,CLE,2010,2010-10-03,1:02,1:02,,CIN,4,4,Sun,W 23-20,,7,44,8,79,15,123
3725,CLE,2010,2010-10-10,1:03,1:03,,ATL,5,5,Sun,L 10-20,,7,58,6,60,13,118
3726,CLE,2011,2011-10-23,1:05,1:05,,SEA,7,6,Sun,W 6-3,,7,48,8,68,15,116
3727,CLE,2012,2012-09-27,8:30,8:30,@,BAL,4,4,Thu,L 16-23,,7,66,11,100,18,166
3728,CLE,2012,2012-12-09,1:02,1:02,,KAN,14,13,Sun,W 30-7,,7,55,5,35,12,90
3729,CLE,2013,2013-12-08,1:02,1:02,@,NWE,14,13,Sun,L 26-27,,7,75,6,41,13,116
3730,CLE,2014,2014-10-05,1:02,12:02,@,TEN,5,4,Sun,W 29-28,,7,74,7,68,14,142
3731,CLE,2014,2014-11-02,1:02,1:02,,TAM,9,8,Sun,W 22-17,,7,44,4,33,11,77
3732,CLE,2014,2014-12-07,1:03,1:03,,IND,14,13,Sun,L 24-25,,7,85,6,40,13,125
3733,CLE,2014,2014-12-28,1:02,1:02,@,BAL,17,16,Sun,L 10-20,,7,58,8,55,15,113
3734,CLE,2015,2015-11-01,1:02,1:02,,ARI,8,8,Sun,L 20-34,,7,35,5,25,12,60
3735,CLE,2015,2015-12-06,1:03,1:03,,CIN,13,12,Sun,L 3-37,,7,84,5,55,12,139
3736,CLE,2016,2016-10-02,1:05,1:05,@,WAS,4,4,Sun,L 20-31,,7,101,9,75,16,176
3737,CLE,2017,2017-11-12,1:00,1:00,@,DET,10,9,Sun,L 24-38,,7,60,7,81,14,141
3738,CLE,2017,2017-11-26,1:00,1:00,@,CIN,12,11,Sun,L 16-30,,7,69,4,35,11,104
3739,CLE,2018,2018-10-28,1:00,1:00,@,PIT,8,8,Sun,L 18-33,,7,52,8,60,15,112
3740,CLE,2018,2018-11-11,1:00,1:00,,ATL,10,10,Sun,W 28-16,,7,38,1,5,8,43
3741,CLE,2018,2018-11-25,1:00,1:00,@,CIN,12,11,Sun,W 35-20,,7,61,13,96,20,157
3742,CLE,2018,2018-12-09,1:00,1:00,,CAR,14,13,Sun,W 26-20,,7,52,10,68,17,120
3743,CLE,2019,2019-10-07,8:15,5:15,@,SFO,5,5,Mon,L 3-31,,7,55,4,34,11,89
3744,CLE,2019,2019-11-24,1:00,1:00,,MIA,12,11,Sun,W 41-24,,7,70,8,94,15,164
3745,CLE,2019,2019-12-22,1:00,1:00,,BAL,16,15,Sun,L 15-31,,7,62,7,50,14,112
3746,CLE,2020,2020-10-18,1:00,1:00,@,PIT,6,6,Sun,L 7-38,,7,55,6,45,13,100
3747,CLE,2020,2020-11-01,1:00,1:00,,LVR,8,8,Sun,L 6-16,,7,59,5,25,12,84
3748,CLE,2021,2021-09-26,1:00,1:00,,CHI,3,3,Sun,W 26-6,,7,98,5,49,12,147
3749,CLE,2021,2021-10-03,1:00,11:00,@,MIN,4,4,Sun,W 14-7,,7,73,7,42,14,115
3750,CLE,2021,2021-10-10,4:05,1:05,@,LAC,5,5,Sun,L 42-47,,7,77,6,49,13,126
3751,IND,2000,2000-09-03,1:00,12:00,@,KAN,1,1,Sun,W 27-14,,7,78,6,50,13,128
3752,IND,2000,2000-09-10,1:00,12:00,,OAK,2,2,Sun,L 31-38,,7,41,5,35,12,76
3753,IND,2000,2000-11-05,1:02,12:02,@,CHI,10,9,Sun,L 24-27,,7,81,8,58,15,139
3754,IND,2000,2000-12-11,9:00,9:00,,BUF,15,14,Mon,W 44-20,,7,67,10,106,17,173
3755,IND,2001,2001-10-14,8:30,7:30,,OAK,5,4,Sun,L 18-23,,7,38,10,61,17,99
3756,IND,2001,2001-10-25,7:30,7:30,@,KAN,7,6,Thu,W 35-28,,7,54,2,10,9,64
3757,IND,2001,2001-11-25,1:00,1:00,,SFO,11,10,Sun,L 21-40,,7,80,8,58,15,138
3758,IND,2002,2002-10-21,9:08,9:08,@,PIT,7,6,Mon,L 10-28,,7,55,4,38,11,93
3759,IND,2002,2002-11-17,1:00,1:00,,DAL,11,10,Sun,W 20-3,,7,35,4,30,11,65
3760,IND,2002,2002-12-22,1:00,1:00,,NYG,16,15,Sun,L 27-44,,7,59,5,33,12,92
3761,IND,2003,2003-11-09,1:02,1:02,@,JAX,10,9,Sun,L 23-28,,7,38,7,47,14,85
3762,IND,2004,2004-10-31,1:00,12:00,@,KAN,8,7,Sun,L 35-45,,7,40,5,46,12,86
3763,IND,2004,2004-12-05,1:02,1:02,,TEN,13,12,Sun,W 51-24,,7,88,9,105,16,193
3764,IND,2005,2005-09-11,8:38,8:38,@,BAL,1,1,Sun,W 24-7,,7,45,8,45,15,90
3765,IND,2005,2005-11-07,9:08,9:08,@,NWE,9,8,Mon,W 40-21,,7,32,4,24,11,56
3766,IND,2005,2006-01-01,1:02,1:02,,ARI,17,16,Sun,W 17-13,,7,50,12,98,19,148
3767,IND,2006,2006-09-17,1:03,1:03,,HOU,2,2,Sun,W 43-24,,7,60,8,58,15,118
3768,IND,2006,2006-11-05,8:20,8:20,@,NWE,9,8,Sun,W 27-20,,7,68,8,81,15,149
3769,IND,2006,2006-12-10,1:03,1:03,@,JAX,14,13,Sun,L 17-44,,7,71,3,31,10,102
3770,IND,2007,2007-12-09,8:23,8:23,@,BAL,14,13,Sun,W 44-20,,7,82,2,15,9,97
3771,IND,2009,2009-09-27,8:31,5:31,@,ARI,3,3,Sun,W 31-10,,7,69,5,35,12,104
3772,IND,2009,2009-10-04,1:03,1:03,,SEA,4,4,Sun,W 34-17,,7,48,6,45,13,93
3773,IND,2009,2009-10-11,8:30,7:30,@,TEN,5,5,Sun,W 31-9,,7,48,9,89,16,137
3774,IND,2010,2010-11-07,4:16,4:16,@,PHI,9,8,Sun,L 24-26,,7,59,14,125,21,184
3775,IND,2010,2010-12-09,8:29,7:29,@,TEN,14,13,Thu,W 30-28,,7,60,5,29,12,89
3776,IND,2011,2011-10-23,8:30,7:30,@,NOR,7,7,Sun,L 7-62,,7,49,1,10,8,59
3777,IND,2012,2012-09-16,1:03,1:03,,MIN,2,2,Sun,W 23-20,,7,51,11,105,18,156
3778,IND,2012,2012-10-21,1:02,1:02,,CLE,7,6,Sun,W 17-13,,7,50,9,75,16,125
3779,IND,2013,2013-09-29,1:06,1:06,@,JAX,4,4,Sun,W 37-3,,7,58,9,65,16,123
3780,IND,2013,2013-12-01,1:02,1:02,,TEN,13,12,Sun,W 22-14,,7,50,6,74,13,124
3781,IND,2014,2014-12-14,1:02,1:02,,HOU,15,14,Sun,W 17-10,,7,45,8,66,15,111
3782,IND,2015,2015-10-08,8:26,7:26,@,HOU,5,5,Thu,W 27-20,,7,65,13,125,20,190
3783,IND,2015,2015-10-25,1:03,1:03,,NOR,7,7,Sun,L 21-27,,7,42,12,100,19,142
3784,IND,2015,2015-11-22,1:02,1:02,@,ATL,11,10,Sun,W 24-21,,7,42,6,69,13,111
3785,IND,2016,2016-10-02,9:35,2:35,@,JAX,4,4,Sun,L 27-30,,7,78,11,145,18,223
3786,IND,2016,2016-10-16,8:32,7:32,@,HOU,6,6,Sun,L 23-26,OT,7,42,7,59,14,101
3787,IND,2017,2017-10-08,1:00,1:00,,SFO,5,5,Sun,W 26-23,OT,7,62,10,77,17,139
3788,IND,2017,2017-10-29,1:00,1:00,@,CIN,8,8,Sun,L 23-24,,7,45,5,54,12,99
3789,IND,2018,2018-09-09,1:00,1:00,,CIN,1,1,Sun,L 23-34,,7,91,8,94,15,185
3790,IND,2018,2018-11-11,1:00,1:00,,JAX,10,9,Sun,W 29-26,,7,45,8,61,15,106
3791,IND,2018,2018-11-18,1:00,1:00,,TEN,11,10,Sun,W 38-10,,7,60,8,112,15,172
3792,IND,2018,2018-11-25,4:25,1:00,,MIA,12,11,Sun,W 27-24,,7,52,10,75,17,127
3793,IND,2019,2019-10-06,8:20,7:20,@,KAN,5,5,Sun,W 19-13,,7,50,11,125,18,175
3794,IND,2019,2019-11-03,1:00,1:00,@,PIT,9,8,Sun,L 24-26,,7,89,5,70,12,159
3795,IND,2019,2019-12-16,8:15,7:15,@,NOR,15,14,Mon,L 7-34,,7,49,6,52,13,101
3796,IND,2020,2020-12-06,1:00,12:00,@,HOU,13,12,Sun,W 26-20,,7,50,3,30,10,80
3797,IND,2021,2021-11-14,1:00,1:00,,JAX,10,10,Sun,W 23-17,,7,47,8,79,15,126
3798,ARI,2000,2000-12-24,1:01,1:01,@,WAS,17,16,Sun,L 3-20,,7,50,8,85,15,135
3799,ARI,2002,2002-09-15,4:05,1:05,@,SEA,2,2,Sun,W 24-13,,7,42,7,35,14,77
3800,ARI,2002,2002-10-27,4:05,1:05,@,SFO,8,7,Sun,L 28-38,,7,65,3,25,10,90
3801,ARI,2003,2003-09-21,4:06,1:06,,GNB,3,3,Sun,W 20-13,,7,57,4,48,11,105
3802,ARI,2004,2004-10-03,4:05,1:05,,NOR,4,4,Sun,W 34-10,,7,65,12,104,19,169
3803,ARI,2004,2004-12-05,1:03,1:03,@,DET,13,12,Sun,L 12-26,,7,70,10,69,17,139
3804,ARI,2004,2004-12-19,4:05,2:05,,STL,15,14,Sun,W 31-7,,7,67,9,74,16,141
3805,ARI,2005,2005-12-18,1:02,12:02,@,HOU,15,14,Sun,L 19-30,,7,69,5,43,12,112
3806,ARI,2006,2006-10-08,4:05,1:05,,KAN,5,5,Sun,L 20-23,,7,50,5,49,12,99
3807,ARI,2007,2007-09-16,4:05,1:05,,SEA,2,2,Sun,W 23-20,,7,55,4,25,11,80
3808,ARI,2007,2007-12-09,4:06,1:06,@,SEA,14,13,Sun,L 21-42,,7,55,5,23,12,78
3809,ARI,2008,2008-10-26,1:04,1:04,@,CAR,8,7,Sun,L 23-27,,7,60,3,25,10,85
3810,ARI,2009,2009-09-20,1:03,1:03,@,JAX,2,2,Sun,W 31-17,,7,58,8,50,15,108
3811,ARI,2009,2009-10-11,4:15,1:15,,HOU,5,4,Sun,W 28-21,,7,40,6,53,13,93
3812,ARI,2009,2009-10-18,4:05,1:05,@,SEA,6,5,Sun,W 27-3,,7,76,6,56,13,132
3813,ARI,2009,2009-10-25,8:30,8:30,@,NYG,7,6,Sun,W 24-17,,7,60,7,30,14,90
3814,ARI,2009,2010-01-03,4:15,2:15,,GNB,17,16,Sun,L 7-33,,7,76,4,19,11,95
3815,ARI,2010,2010-09-26,4:15,1:15,,OAK,3,3,Sun,W 24-23,,7,104,11,123,18,227
3816,ARI,2010,2010-11-07,1:05,12:05,@,MIN,9,8,Sun,L 24-27,OT,7,39,11,65,18,104
3817,ARI,2010,2010-12-12,4:15,2:15,,DEN,14,13,Sun,W 43-13,,7,62,8,66,15,128
3818,ARI,2011,2011-11-13,1:02,1:02,@,PHI,10,9,Sun,W 21-17,,7,66,11,97,18,163
3819,ARI,2012,2012-10-14,4:05,1:05,,BUF,6,6,Sun,L 16-19,OT,7,67,5,39,12,106
3820,ARI,2012,2012-10-29,8:40,5:40,,SFO,8,8,Mon,L 3-24,,7,51,10,80,17,131
3821,ARI,2012,2012-11-25,4:25,2:25,,STL,12,11,Sun,L 17-31,,7,56,10,84,17,140
3822,ARI,2013,2013-09-15,4:05,1:05,,DET,2,2,Sun,W 25-21,,7,40,8,101,15,141
3823,ARI,2013,2013-12-22,4:06,1:06,@,SEA,16,15,Sun,W 17-10,,7,46,9,102,16,148
3824,ARI,2014,2014-09-14,1:04,1:04,@,NYG,2,2,Sun,W 25-14,,7,71,9,70,16,141
3825,ARI,2015,2015-11-22,8:30,6:30,,CIN,11,10,Sun,W 34-31,,7,40,10,108,17,148
3826,ARI,2015,2015-11-29,4:05,1:05,@,SFO,12,11,Sun,W 19-13,,7,47,13,81,20,128
3827,ARI,2016,2016-10-06,8:27,5:27,@,SFO,5,5,Thu,W 33-21,,7,50,4,34,11,84
3828,ARI,2016,2016-12-11,1:00,1:00,@,MIA,14,13,Sun,L 23-26,,7,54,14,118,21,172
3829,ARI,2016,2016-12-18,4:05,2:05,,NOR,15,14,Sun,L 41-48,,7,52,5,46,12,98
3830,ARI,2016,2016-12-24,4:25,1:25,@,SEA,16,15,Sat,W 34-31,,7,85,5,40,12,125
3831,ARI,2017,2017-10-08,1:00,1:00,@,PHI,5,5,Sun,L 7-34,,7,61,5,60,12,121
3832,ARI,2017,2017-10-15,4:05,2:05,,TAM,6,6,Sun,W 38-33,,7,61,9,49,16,110
3833,ARI,2018,2018-10-18,8:20,6:20,,DEN,7,7,Thu,L 10-45,,7,45,5,50,12,95
3834,ARI,2018,2018-11-18,4:05,2:05,,OAK,11,10,Sun,L 21-23,,7,62,4,20,11,82
3835,ARI,2018,2018-12-02,1:00,12:00,@,GNB,13,12,Sun,W 20-17,,7,49,7,43,14,92
3836,ARI,2018,2018-12-23,4:05,2:05,,LAR,16,15,Sun,L 9-31,,7,54,6,66,13,120
3837,ARI,2019,2019-09-08,4:25,2:25,,DET,1,1,Sun,T 27-27,OT,7,35,9,59,16,94
3838,ARI,2019,2019-09-22,4:05,2:05,,CAR,3,3,Sun,L 20-38,,7,52,3,35,10,87
3839,ARI,2019,2019-09-29,4:05,2:05,,SEA,4,4,Sun,L 10-27,,7,44,7,65,14,109
3840,ARI,2019,2019-12-08,4:25,2:25,,PIT,14,13,Sun,L 17-23,,7,75,4,20,11,95
3841,ARI,2020,2020-09-27,4:25,2:25,,DET,3,3,Sun,L 23-26,,7,38,7,46,14,84
3842,ARI,2020,2020-10-19,8:15,7:15,@,DAL,6,6,Mon,W 38-10,,7,43,6,36,13,79
3843,ARI,2020,2020-11-08,4:25,2:25,,MIA,9,8,Sun,L 31-34,,7,71,7,75,14,146
3844,ARI,2020,2020-11-15,4:05,2:05,,BUF,10,9,Sun,W 32-30,,7,40,9,69,16,109
3845,ARI,2021,2021-09-26,1:00,1:00,@,JAX,3,3,Sun,W 31-19,,7,58,4,40,11,98
3846,ARI,2021,2021-10-03,4:05,1:05,@,LAR,4,4,Sun,W 37-20,,7,63,5,36,12,99
3847,ARI,2021,2021-10-24,4:25,2:25,,HOU,7,7,Sun,W 31-5,,7,54,8,80,15,134
3848,ARI,2021,2021-10-28,8:20,6:20,,GNB,8,8,Thu,L 21-24,,7,59,7,60,14,119
3849,ARI,2021,2021-12-13,8:15,6:15,,LAR,14,13,Mon,L 23-30,,7,54,5,40,12,94
3850,ARI,2021,2021-12-19,1:00,1:00,@,DET,15,14,Sun,L 12-30,,7,83,6,49,13,132
3851,ARI,2021,2022-01-02,1:00,12:00,@,DAL,17,16,Sun,W 25-22,,7,45,10,88,17,133
3852,DAL,2000,2000-10-29,4:15,3:15,,JAX,9,8,Sun,L 17-23,OT,7,54,8,50,15,104
3853,DAL,2000,2000-12-03,1:01,1:01,@,TAM,14,13,Sun,L 7-27,,7,58,6,35,13,93
3854,DAL,2000,2000-12-17,8:20,7:20,,NYG,16,15,Sun,L 13-17,,7,75,7,79,14,154
3855,DAL,2000,2000-12-25,9:10,8:10,@,TEN,17,16,Mon,L 0-31,,7,51,7,51,14,102
3856,DAL,2001,2001-12-02,4:15,4:15,@,WAS,12,11,Sun,W 20-14,,7,45,5,36,12,81
3857,DAL,2002,2002-09-22,1:02,1:02,@,PHI,3,3,Sun,L 13-44,,7,92,3,25,10,117
3858,DAL,2002,2002-11-03,1:04,1:04,@,DET,9,9,Sun,L 7-9,,7,70,6,50,13,120
3859,DAL,2002,2002-12-15,4:16,4:16,@,NYG,15,14,Sun,L 7-37,,7,55,6,57,13,112
3860,DAL,2002,2002-12-21,8:39,7:39,,PHI,16,15,Sat,L 3-27,,7,69,10,67,17,136
3861,DAL,2003,2003-09-07,4:19,3:19,,ATL,1,1,Sun,L 13-27,,7,49,4,31,11,80
3862,DAL,2003,2003-10-05,1:02,12:02,,ARI,5,4,Sun,W 24-7,,7,64,5,36,12,100
3863,DAL,2003,2003-12-28,1:03,12:03,@,NOR,17,16,Sun,L 7-13,,7,44,7,60,14,104
3864,DAL,2004,2004-11-07,1:02,1:02,@,CIN,9,8,Sun,L 3-26,,7,46,4,20,11,66
3865,DAL,2004,2004-11-15,9:09,8:09,,PHI,10,9,Mon,L 21-49,,7,50,9,59,16,109
3866,DAL,2005,2005-09-19,9:07,8:07,,WAS,2,2,Mon,L 13-14,,7,60,12,80,19,140
3867,DAL,2005,2005-11-24,4:17,3:17,,DEN,12,11,Thu,L 21-24,OT,7,40,10,67,17,107
3868,DAL,2005,2005-12-04,1:03,1:03,@,NYG,13,12,Sun,L 10-17,,7,46,6,44,13,90
3869,DAL,2006,2006-10-08,4:14,4:14,@,PHI,5,4,Sun,L 24-38,,7,49,3,67,10,116
3870,DAL,2006,2006-11-19,4:15,3:15,,IND,11,10,Sun,W 21-14,,7,53,5,35,12,88
3871,DAL,2006,2006-12-03,4:15,4:15,@,NYG,13,12,Sun,W 23-20,,7,58,9,94,16,152
3872,DAL,2007,2007-09-09,8:25,7:25,,NYG,1,1,Sun,W 45-35,,7,55,4,45,11,100
3873,DAL,2007,2007-11-18,4:15,3:15,,WAS,11,10,Sun,W 28-23,,7,58,3,71,10,129
3874,DAL,2008,2008-09-21,8:23,7:23,@,GNB,3,3,Sun,W 27-16,,7,54,8,68,15,122
3875,DAL,2009,2009-10-04,4:15,2:15,@,DEN,4,4,Sun,L 10-17,,7,70,10,81,17,151
3876,DAL,2010,2010-12-25,7:30,5:30,@,ARI,16,15,Sat,L 26-27,,7,49,6,43,13,92
3877,DAL,2011,2011-09-11,8:33,8:33,@,NYJ,1,1,Sun,L 24-27,,7,40,0,0,7,40
3878,DAL,2011,2011-10-02,1:02,12:02,,DET,4,4,Sun,L 30-34,,7,33,10,75,17,108
3879,DAL,2011,2011-11-06,1:02,12:02,,SEA,9,8,Sun,W 23-13,,7,82,10,88,17,170
3880,DAL,2011,2011-12-04,4:15,2:15,@,ARI,13,12,Sun,L 13-19,OT,7,49,6,41,13,90
3881,DAL,2011,2012-01-01,8:31,8:31,@,NYG,17,16,Sun,L 14-31,,7,43,3,28,10,71
3882,DAL,2012,2012-11-04,8:31,8:31,@,ATL,9,8,Sun,L 13-19,,7,50,2,15,9,65
3883,DAL,2012,2012-11-22,4:41,3:41,,WAS,12,11,Thu,L 31-38,,7,45,5,41,12,86
3884,DAL,2012,2012-12-02,8:20,7:20,,PHI,13,12,Sun,W 38-33,,7,60,1,5,8,65
3885,DAL,2013,2013-10-13,8:31,7:31,,WAS,6,6,Sun,W 31-16,,7,80,12,104,19,184
3886,DAL,2013,2013-12-15,4:25,3:25,,GNB,15,14,Sun,L 36-37,,7,79,7,59,14,138
3887,DAL,2014,2014-10-05,1:03,12:03,,HOU,5,5,Sun,W 20-17,OT,7,56,5,35,12,91
3888,DAL,2014,2014-11-23,8:30,8:30,@,NYG,12,11,Sun,W 31-28,,7,63,5,30,12,93
3889,DAL,2014,2014-12-21,4:26,3:26,,IND,16,15,Sun,W 42-7,,7,67,8,55,15,122
3890,DAL,2014,2014-12-28,1:05,1:05,@,WAS,17,16,Sun,W 44-17,,7,48,9,101,16,149
3891,DAL,2015,2015-10-11,4:25,3:25,,NWE,5,5,Sun,L 6-30,,7,50,9,65,16,115
3892,DAL,2015,2015-10-25,4:25,4:25,@,NYG,7,6,Sun,L 20-27,,7,46,3,13,10,59
3893,DAL,2016,2016-10-09,4:25,3:25,,CIN,5,5,Sun,W 28-14,,7,45,6,49,13,94
3894,DAL,2016,2016-10-16,4:25,3:25,@,GNB,6,6,Sun,W 30-16,,7,60,5,23,12,83
3895,DAL,2017,2017-10-08,4:25,3:25,,GNB,5,5,Sun,L 31-35,,7,70,6,38,13,108
3896,DAL,2017,2017-11-23,4:30,3:30,,LAC,12,11,Thu,L 6-28,,7,60,5,56,12,116
3897,DAL,2017,2017-12-17,8:30,5:30,@,OAK,15,14,Sun,W 20-17,,7,100,14,105,21,205
3898,DAL,2017,2017-12-24,4:25,3:25,,SEA,16,15,Sun,L 12-21,,7,75,11,142,18,217
3899,DAL,2017,2017-12-31,1:00,1:00,@,PHI,17,16,Sun,W 6-0,,7,64,7,49,14,113
3900,DAL,2018,2018-09-23,4:25,1:25,@,SEA,3,3,Sun,L 13-24,,7,55,10,67,17,122
3901,DAL,2018,2018-10-07,8:20,7:20,@,HOU,5,5,Sun,L 16-19,OT,7,72,5,25,12,97
3902,DAL,2019,2019-11-24,4:25,4:25,@,NWE,12,11,Sun,L 9-13,,7,50,6,56,13,106
3903,DAL,2020,2020-09-13,8:20,5:20,@,LAR,1,1,Sun,L 17-20,,7,50,5,34,12,84
3904,DAL,2020,2020-09-20,1:00,12:00,,ATL,2,2,Sun,W 40-39,,7,75,8,51,15,126
3905,DAL,2020,2020-11-01,8:20,8:20,@,PHI,8,8,Sun,L 9-23,,7,68,4,28,11,96
3906,DAL,2020,2020-11-08,4:25,3:25,,PIT,9,9,Sun,L 19-24,,7,70,3,16,10,86
3907,DAL,2020,2020-12-08,8:05,8:05,@,BAL,13,12,Tue,L 17-34,,7,58,4,23,11,81
3908,DAL,2021,2021-10-03,1:00,12:00,,CAR,4,4,Sun,W 36-28,,7,50,6,32,13,82
3909,DAL,2021,2021-12-12,1:00,1:00,@,WAS,14,13,Sun,W 27-20,,7,60,7,65,14,125
3910,DEN,2000,2000-09-10,4:16,2:16,,ATL,2,2,Sun,W 42-14,,7,54,10,71,17,125
3911,DEN,2000,2000-10-01,4:06,2:06,,NWE,5,5,Sun,L 19-28,,7,50,5,17,12,67
3912,DEN,2000,2000-11-19,4:05,2:05,,SDG,12,11,Sun,W 38-37,,7,63,9,62,16,125
3913,DEN,2000,2000-12-17,1:00,12:00,@,KAN,16,15,Sun,L 7-20,,7,51,6,51,13,102
3914,DEN,2001,2001-11-05,9:05,6:05,@,OAK,8,8,Mon,L 28-38,,7,71,11,93,18,164
3915,DEN,2001,2001-11-18,4:15,2:15,,WAS,10,10,Sun,L 10-17,,7,57,7,54,14,111
3916,DEN,2002,2002-12-22,4:15,1:15,@,OAK,16,15,Sun,L 16-28,,7,48,5,40,12,88
3917,DEN,2003,2003-10-05,1:00,12:00,@,KAN,5,5,Sun,L 23-24,,7,59,7,47,14,106
3918,DEN,2003,2003-10-26,1:02,1:02,@,BAL,8,8,Sun,L 6-26,,7,49,9,62,16,111
3919,DEN,2003,2003-11-16,4:05,2:05,,SDG,11,10,Sun,W 37-8,,7,60,9,83,16,143
3920,DEN,2004,2004-09-19,1:02,1:02,@,JAX,2,2,Sun,L 6-7,,7,57,10,85,17,142
3921,DEN,2004,2004-10-03,4:15,4:15,@,TAM,4,4,Sun,W 16-13,,7,50,9,97,16,147
3922,DEN,2005,2005-09-11,1:07,1:07,@,MIA,1,1,Sun,L 10-34,,7,73,11,69,18,142
3923,DEN,2006,2006-09-24,8:20,8:20,@,NWE,3,3,Sun,W 17-7,,7,52,6,78,13,130
3924,DEN,2006,2006-11-23,8:12,7:12,@,KAN,12,11,Thu,L 10-19,,7,44,4,25,11,69
3925,DEN,2008,2008-09-14,4:15,2:15,,SDG,2,2,Sun,W 39-38,,7,67,8,60,15,127
3926,DEN,2009,2009-12-13,1:02,1:02,@,IND,14,13,Sun,L 16-28,,7,65,4,20,11,85
3927,DEN,2009,2009-12-20,4:05,2:05,,OAK,15,14,Sun,L 19-20,,7,72,9,62,16,134
3928,DEN,2010,2010-09-12,1:03,1:03,@,JAX,1,1,Sun,L 17-24,,7,70,5,47,12,117
3929,DEN,2011,2011-09-18,4:15,2:15,,CIN,2,2,Sun,W 24-22,,7,55,7,69,14,124
3930,DEN,2011,2011-12-18,4:16,2:16,,NWE,15,14,Sun,L 23-41,,7,39,4,30,11,69
3931,DEN,2011,2011-12-24,1:02,1:02,@,BUF,16,15,Sat,L 14-40,,7,58,8,69,15,127
3932,DEN,2012,2012-09-23,4:25,2:25,,HOU,3,3,Sun,L 25-31,,7,75,9,69,16,144
3933,DEN,2012,2012-11-11,1:02,1:02,@,CAR,10,9,Sun,W 36-14,,7,60,7,45,14,105
3934,DEN,2012,2012-12-16,1:02,1:02,@,BAL,15,14,Sun,W 34-17,,7,51,6,61,13,112
3935,DEN,2013,2013-12-08,4:05,2:05,,TEN,14,13,Sun,W 51-28,,7,60,8,66,15,126
3936,DEN,2014,2014-09-07,8:30,6:30,,IND,1,1,Sun,W 31-24,,7,70,9,45,16,115
3937,DEN,2014,2014-10-05,4:05,2:05,,ARI,5,4,Sun,W 41-20,,7,67,3,15,10,82
3938,DEN,2014,2014-12-14,4:05,1:05,@,SDG,15,14,Sun,W 22-10,,7,71,8,65,15,136
3939,DEN,2016,2016-10-24,8:30,6:30,,HOU,7,7,Mon,W 27-9,,7,83,2,15,9,98
3940,DEN,2017,2017-10-30,8:30,7:30,@,KAN,8,7,Mon,L 19-29,,7,53,7,69,14,122
3941,DEN,2018,2018-09-09,4:25,2:25,,SEA,1,1,Sun,W 27-24,,7,60,7,45,14,105
3942,DEN,2018,2018-11-18,4:05,1:05,@,LAC,11,10,Sun,W 23-22,,7,43,14,120,21,163
3943,DEN,2018,2018-12-02,1:00,1:00,@,CIN,13,12,Sun,W 24-10,,7,60,12,100,19,160
3944,DEN,2019,2019-11-03,4:25,2:25,,CLE,9,9,Sun,W 24-19,,7,55,5,40,12,95
3945,DEN,2019,2019-11-24,1:00,1:00,@,BUF,12,11,Sun,L 3-20,,7,70,12,90,19,160
3946,DEN,2019,2019-12-08,1:00,12:00,@,HOU,14,13,Sun,W 38-24,,7,50,9,44,16,94
3947,DEN,2019,2019-12-15,1:00,12:00,@,KAN,15,14,Sun,L 3-23,,7,72,5,45,12,117
3948,DEN,2020,2020-11-15,4:05,1:05,@,LVR,10,9,Sun,L 12-37,,7,37,8,82,15,119
3949,DEN,2020,2020-12-19,4:30,2:30,,BUF,15,14,Sat,L 19-48,,7,33,8,75,15,108
3950,DEN,2021,2021-10-10,1:00,1:00,@,PIT,5,5,Sun,L 19-27,,7,67,8,59,15,126
3951,DET,2000,2000-09-10,4:16,4:16,,WAS,2,2,Sun,W 15-10,,7,50,6,55,13,105
3952,DET,2000,2000-10-19,8:35,8:35,@,TAM,8,7,Thu,W 28-14,,7,55,7,54,14,109
3953,DET,2002,2002-11-24,1:03,12:03,@,CHI,12,11,Sun,L 17-20,OT,7,50,6,64,13,114
3954,DET,2002,2002-12-08,4:06,2:06,@,ARI,14,13,Sun,L 20-23,OT,7,75,10,92,17,167
3955,DET,2003,2003-09-14,1:02,12:02,@,GNB,2,2,Sun,L 6-31,,7,60,7,35,14,95
3956,DET,2003,2003-11-09,1:03,1:03,,CHI,10,9,Sun,W 12-10,,7,41,5,35,12,76
3957,DET,2003,2003-12-21,1:03,1:03,@,CAR,16,15,Sun,L 14-20,,7,55,6,35,13,90
3958,DET,2004,2004-10-24,1:03,1:03,@,NYG,7,6,Sun,W 28-13,,7,65,4,25,11,90
3959,DET,2005,2005-10-09,1:02,1:02,,BAL,5,4,Sun,W 35-17,,7,46,21,147,28,193
3960,DET,2005,2005-11-13,1:03,1:03,,ARI,10,9,Sun,W 29-21,,7,50,9,80,16,130
3961,DET,2006,2006-09-10,1:04,1:04,,SEA,1,1,Sun,L 6-9,,7,61,8,55,15,116
3962,DET,2006,2006-10-08,1:05,12:05,@,MIN,5,5,Sun,L 17-26,,7,50,5,40,12,90
3963,DET,2006,2006-11-23,12:30,12:30,,MIA,12,11,Thu,L 10-27,,7,55,11,100,18,155
3964,DET,2006,2006-12-03,1:02,1:02,@,NWE,13,12,Sun,L 21-28,,7,70,10,72,17,142
3965,DET,2006,2006-12-31,1:02,12:02,@,DAL,17,16,Sun,W 39-31,,7,65,4,45,11,110
3966,DET,2007,2007-09-16,4:05,4:05,,MIN,2,2,Sun,W 20-17,OT,7,44,12,96,19,140
3967,DET,2007,2007-11-18,1:03,1:03,,NYG,11,10,Sun,L 10-16,,7,40,6,47,13,87
3968,DET,2007,2007-11-22,12:36,12:36,,GNB,12,11,Thu,L 26-37,,7,59,9,81,16,140
3969,DET,2007,2007-12-09,1:03,1:03,,DAL,14,13,Sun,L 27-28,,7,35,3,23,10,58
3970,DET,2007,2007-12-30,1:02,12:02,@,GNB,17,16,Sun,L 13-34,,7,55,2,25,9,80
3971,DET,2008,2008-10-26,1:03,1:03,,WAS,8,7,Sun,L 17-25,,7,51,8,67,15,118
3972,DET,2009,2009-10-04,1:02,12:02,@,CHI,4,4,Sun,L 24-48,,7,51,3,36,10,87
3973,DET,2009,2009-12-06,1:02,1:02,@,CIN,13,12,Sun,L 13-23,,7,45,9,75,16,120
3974,DET,2009,2009-12-20,1:02,1:02,,ARI,15,14,Sun,L 24-31,,7,45,8,65,15,110
3975,DET,2010,2010-09-12,1:02,12:02,@,CHI,1,1,Sun,L 14-19,,7,40,9,100,16,140
3976,DET,2010,2010-10-31,1:02,1:02,,WAS,8,7,Sun,W 37-25,,7,65,10,77,17,142
3977,DET,2010,2010-12-19,1:03,1:03,@,TAM,15,14,Sun,W 23-20,OT,7,57,9,65,16,122
3978,DET,2011,2011-09-25,1:05,12:05,@,MIN,3,3,Sun,W 26-23,OT,7,65,10,79,17,144
3979,DET,2012,2012-11-18,1:02,1:02,,GNB,11,10,Sun,L 20-24,,7,50,9,80,16,130
3980,DET,2012,2012-11-22,12:39,12:39,,HOU,12,11,Thu,L 31-34,OT,7,70,8,66,15,136
3981,DET,2012,2012-12-16,4:05,2:05,@,ARI,15,14,Sun,L 10-38,,7,63,6,50,13,113
3982,DET,2013,2013-10-06,1:02,12:02,@,GNB,5,5,Sun,L 9-22,,7,50,10,72,17,122
3983,DET,2013,2013-12-22,4:05,4:05,,NYG,16,15,Sun,L 20-23,OT,7,60,5,30,12,90
3984,DET,2014,2014-12-21,1:03,12:03,@,CHI,16,15,Sun,W 20-14,,7,60,5,86,12,146
3985,DET,2015,2015-11-22,1:02,1:02,,OAK,11,10,Sun,W 18-13,,7,55,6,31,13,86
3986,DET,2015,2015-12-27,1:03,1:03,,SFO,16,15,Sun,W 32-17,,7,71,11,65,18,136
3987,DET,2016,2016-10-16,1:02,1:02,,LAR,6,6,Sun,W 31-28,,7,62,8,62,15,124
3988,DET,2016,2016-12-11,1:00,1:00,,CHI,14,13,Sun,W 20-17,,7,55,11,139,18,194
3989,DET,2017,2017-10-15,1:00,12:00,@,NOR,6,6,Sun,L 38-52,,7,46,13,118,20,164
3990,DET,2017,2017-11-12,1:00,1:00,,CLE,10,9,Sun,W 38-24,,7,81,7,60,14,141
3991,DET,2018,2018-12-09,4:25,2:25,@,ARI,14,13,Sun,W 17-3,,7,68,8,83,15,151
3992,DET,2018,2018-12-23,1:00,1:00,,MIN,16,15,Sun,L 9-27,,7,55,11,78,18,133
3993,DET,2019,2019-10-27,1:00,1:00,,NYG,8,7,Sun,W 31-26,,7,75,5,44,12,119
3994,DET,2019,2019-12-22,4:05,2:05,@,DEN,16,15,Sun,L 17-27,,7,68,6,50,13,118
3995,DET,2020,2020-09-20,1:00,12:00,@,GNB,2,2,Sun,L 21-42,,7,70,8,60,15,130
3996,DET,2020,2020-09-27,4:25,2:25,@,ARI,3,3,Sun,W 26-23,,7,46,7,38,14,84
3997,DET,2020,2020-10-18,1:00,1:00,@,JAX,6,5,Sun,W 34-16,,7,60,5,56,12,116
3998,DET,2020,2020-12-06,1:00,12:00,@,CHI,13,12,Sun,W 34-30,,7,45,3,20,10,65
3999,DET,2020,2021-01-03,1:00,1:00,,MIN,17,16,Sun,L 35-37,,7,51,4,35,11,86
4000,DET,2021,2021-09-26,1:00,1:00,,BAL,3,3,Sun,L 17-19,,7,35,6,69,13,104
4001,DET,2021,2021-11-21,1:00,1:00,@,CLE,11,10,Sun,L 10-13,,7,67,10,82,17,149
4002,GNB,2000,2000-10-29,1:02,1:02,@,MIA,9,8,Sun,L 20-28,,7,59,7,104,14,163
4003,GNB,2000,2000-11-19,1:02,12:02,,IND,12,11,Sun,W 26-24,,7,46,5,69,12,115
4004,GNB,2001,2001-11-04,1:02,12:02,,TAM,8,7,Sun,W 21-20,,7,67,9,66,16,133
4005,GNB,2001,2001-11-11,1:02,12:02,@,CHI,9,8,Sun,W 20-12,,7,50,1,15,8,65
4006,GNB,2002,2002-09-15,1:04,12:04,@,NOR,2,2,Sun,L 20-35,,7,73,9,59,16,132
4007,GNB,2002,2002-11-24,4:15,4:15,@,TAM,12,11,Sun,L 7-21,,7,62,6,54,13,116
4008,GNB,2003,2003-09-14,1:02,12:02,,DET,2,2,Sun,W 31-6,,7,35,7,60,14,95
4009,GNB,2003,2003-11-16,4:15,4:15,@,TAM,11,10,Sun,W 20-13,,7,29,8,48,15,77
4010,GNB,2004,2004-10-03,1:02,12:02,,NYG,4,4,Sun,L 7-14,,7,72,8,76,15,148
4011,GNB,2004,2004-11-29,9:09,8:09,,STL,12,11,Mon,W 45-17,,7,55,7,50,14,105
4012,GNB,2005,2005-10-30,1:02,1:02,@,CIN,8,7,Sun,L 14-21,,7,29,3,58,10,87
4013,GNB,2005,2005-11-27,4:16,4:16,@,PHI,12,11,Sun,L 14-19,,7,40,7,50,14,90
4014,GNB,2005,2006-01-01,1:02,12:02,,SEA,17,16,Sun,W 23-17,,7,50,5,58,12,108
4015,GNB,2006,2006-10-02,8:40,8:40,@,PHI,4,4,Mon,L 9-31,,7,62,5,53,12,115
4016,GNB,2008,2008-09-28,1:02,1:02,@,TAM,4,4,Sun,L 21-30,,7,74,8,70,15,144
4017,GNB,2009,2009-10-05,8:40,7:40,@,MIN,4,4,Mon,L 23-30,,7,57,2,10,9,67
4018,GNB,2009,2009-11-26,12:35,12:35,@,DET,12,11,Thu,W 34-12,,7,57,3,28,10,85
4019,GNB,2009,2009-12-20,4:15,4:15,@,PIT,15,14,Sun,L 36-37,,7,53,10,84,17,137
4020,GNB,2010,2010-10-17,1:02,12:02,,MIA,6,6,Sun,L 20-23,OT,7,45,4,30,11,75
4021,GNB,2011,2011-09-18,1:02,1:02,@,CAR,2,2,Sun,W 30-23,,7,57,6,50,13,107
4022,GNB,2011,2011-09-25,4:15,3:15,@,CHI,3,3,Sun,W 27-17,,7,35,10,70,17,105
4023,GNB,2011,2011-11-24,12:35,12:35,@,DET,12,11,Thu,W 27-15,,7,54,11,82,18,136
4024,GNB,2012,2012-09-30,4:25,3:25,,NOR,4,4,Sun,W 28-27,,7,43,10,72,17,115
4025,GNB,2012,2012-12-09,8:30,7:30,,DET,14,13,Sun,W 27-20,,7,50,5,55,12,105
4026,GNB,2012,2012-12-30,4:25,3:25,@,MIN,17,16,Sun,L 34-37,,7,43,10,98,17,141
4027,GNB,2013,2013-11-24,1:02,12:02,,MIN,12,11,Sun,T 26-26,OT,7,50,5,53,12,103
4028,GNB,2013,2013-12-15,4:25,3:25,@,DAL,15,14,Sun,W 37-36,,7,59,7,79,14,138
4029,GNB,2015,2015-10-11,1:02,12:02,,STL,5,5,Sun,W 24-10,,7,67,8,40,15,107
4030,GNB,2015,2015-11-08,1:04,1:04,@,CAR,9,8,Sun,L 29-37,,7,87,6,45,13,132
4031,GNB,2015,2015-12-03,8:26,8:26,@,DET,13,12,Thu,W 27-23,,7,55,9,108,16,163
4032,GNB,2015,2015-12-27,4:25,2:25,@,ARI,16,15,Sun,L 8-38,,7,59,10,119,17,178
4033,GNB,2015,2016-01-03,8:30,7:30,,MIN,17,16,Sun,L 13-20,,7,54,5,37,12,91
4034,GNB,2016,2016-11-28,8:30,8:30,@,PHI,12,11,Mon,W 27-13,,7,51,7,42,14,93
4035,GNB,2017,2017-09-28,8:25,7:25,,CHI,4,4,Thu,W 35-14,,7,55,8,62,15,117
4036,GNB,2017,2017-12-03,1:00,12:00,,TAM,13,12,Sun,W 26-20,OT,7,47,8,74,15,121
4037,GNB,2018,2018-09-16,1:00,12:00,,MIN,2,2,Sun,T 29-29,OT,7,54,8,70,15,124
4038,GNB,2018,2018-11-04,8:20,8:20,@,NWE,9,8,Sun,L 17-31,,7,63,5,30,12,93
4039,GNB,2018,2018-12-02,1:00,12:00,,ARI,13,12,Sun,L 17-20,,7,43,7,49,14,92
4040,GNB,2018,2018-12-16,1:00,12:00,@,CHI,15,14,Sun,L 17-24,,7,48,4,24,11,72
4041,GNB,2019,2019-09-22,1:00,12:00,,DEN,3,3,Sun,W 27-16,,7,53,3,27,10,80
4042,GNB,2019,2019-12-01,1:00,1:00,@,NYG,13,12,Sun,W 31-13,,7,54,4,31,11,85
4043,GNB,2020,2020-11-22,4:25,4:25,@,IND,11,10,Sun,L 31-34,OT,7,45,8,116,15,161
4044,GNB,2021,2021-09-26,8:20,5:20,@,SFO,3,3,Sun,W 30-28,,7,87,4,86,11,173
4045,GNB,2021,2021-10-28,8:20,6:20,@,ARI,8,8,Thu,W 24-21,,7,60,7,59,14,119
4046,HOU,2002,2002-12-29,1:03,12:03,,TEN,17,16,Sun,L 3-13,,7,53,6,52,13,105
4047,HOU,2003,2003-10-26,4:15,4:15,@,IND,8,7,Sun,L 21-30,,7,52,3,13,10,65
4048,HOU,2003,2003-11-02,1:02,12:02,,CAR,9,8,Sun,W 14-10,,7,55,4,40,11,95
4049,HOU,2003,2003-12-21,1:03,12:03,,TEN,16,15,Sun,L 24-27,,7,75,6,42,13,117
4050,HOU,2004,2004-09-26,1:00,12:00,@,KAN,3,3,Sun,W 24-21,,7,60,9,87,16,147
4051,HOU,2004,2005-01-02,1:02,12:02,,CLE,17,16,Sun,L 14-22,,7,52,6,46,13,98
4052,HOU,2005,2005-09-18,1:02,12:02,,PIT,2,2,Sun,L 7-27,,7,58,5,40,12,98
4053,HOU,2005,2005-12-24,1:03,12:03,,JAX,16,15,Sat,L 20-38,,7,40,6,50,13,90
4054,HOU,2006,2006-09-24,1:03,12:03,,WAS,3,3,Sun,L 15-31,,7,57,12,126,19,183
4055,HOU,2006,2006-10-15,1:02,12:02,@,DAL,6,5,Sun,L 6-34,,7,55,9,73,16,128
4056,HOU,2006,2006-11-26,1:02,1:02,@,NYJ,12,11,Sun,L 11-26,,7,77,1,5,8,82
4057,HOU,2006,2006-12-10,1:02,12:02,,TEN,14,13,Sun,L 20-26,OT,7,64,8,66,15,130
4058,HOU,2007,2007-09-30,1:02,1:02,@,ATL,4,4,Sun,L 16-26,,7,78,2,20,9,98
4059,HOU,2008,2008-10-26,3:47,2:47,,CIN,8,7,Sun,W 35-6,,7,55,7,51,14,106
4060,HOU,2008,2008-12-28,1:03,12:03,,CHI,17,16,Sun,W 31-24,,7,70,2,10,9,80
4061,HOU,2009,2009-10-18,1:02,1:02,@,CIN,6,6,Sun,W 28-17,,7,60,4,45,11,105
4062,HOU,2009,2009-10-25,1:04,12:04,,SFO,7,7,Sun,W 24-21,,7,77,11,65,18,142
4063,HOU,2009,2009-11-23,8:40,7:40,,TEN,11,10,Mon,L 17-20,,7,72,5,25,12,97
4064,HOU,2010,2010-09-12,1:02,12:02,,IND,1,1,Sun,W 34-24,,7,50,5,73,12,123
4065,HOU,2011,2011-09-25,1:02,12:02,@,NOR,3,3,Sun,L 33-40,,7,56,4,26,11,82
4066,HOU,2011,2011-10-30,1:02,12:02,,JAX,8,8,Sun,W 24-14,,7,60,5,39,12,99
4067,HOU,2011,2011-11-27,1:03,1:03,@,JAX,12,11,Sun,W 20-13,,7,80,4,30,11,110
4068,HOU,2011,2012-01-01,1:02,12:02,,TEN,17,16,Sun,L 22-23,,7,55,6,47,13,102
4069,HOU,2012,2012-10-08,8:40,8:40,@,NYJ,5,5,Mon,W 23-17,,7,50,5,25,12,75
4070,HOU,2012,2012-10-14,8:30,7:30,,GNB,6,6,Sun,L 24-42,,7,69,4,51,11,120
4071,HOU,2012,2012-11-04,1:02,12:02,,BUF,9,8,Sun,W 21-9,,7,42,3,15,10,57
4072,HOU,2012,2012-12-10,8:40,8:40,@,NWE,14,13,Mon,L 14-42,,7,70,6,56,13,126
4073,HOU,2013,2013-09-09,10:25,7:25,@,SDG,1,1,Mon,W 31-28,,7,73,7,55,14,128
4074,HOU,2013,2013-10-06,8:31,5:31,@,SFO,5,5,Sun,L 3-34,,7,52,3,17,10,69
4075,HOU,2013,2013-10-13,1:03,12:03,,STL,6,6,Sun,L 13-38,,7,95,9,74,16,169
4076,HOU,2013,2013-11-10,4:25,2:25,@,ARI,10,9,Sun,L 24-27,,7,53,5,29,12,82
4077,HOU,2014,2014-09-14,4:25,1:25,@,OAK,2,2,Sun,W 30-14,,7,85,5,24,12,109
4078,HOU,2014,2014-12-07,1:03,1:03,@,JAX,14,13,Sun,W 27-13,,7,64,6,40,13,104
4079,HOU,2014,2014-12-21,1:02,12:02,,BAL,16,15,Sun,W 25-13,,7,69,7,56,14,125
4080,HOU,2015,2015-11-01,1:02,12:02,,TEN,8,8,Sun,W 20-6,,7,85,6,45,13,130
4081,HOU,2016,2016-10-16,8:32,7:32,,IND,6,6,Sun,W 26-23,OT,7,59,7,42,14,101
4082,HOU,2016,2016-11-21,8:30,7:30,@,OAK,11,10,Mon,L 20-27,,7,101,4,21,11,122
4083,HOU,2016,2016-12-11,1:00,1:00,@,IND,14,13,Sun,W 22-17,,7,124,9,59,16,183
4084,HOU,2017,2017-10-08,8:30,7:30,,KAN,5,5,Sun,L 34-42,,7,59,6,64,13,123
4085,HOU,2017,2017-11-05,1:00,12:00,,IND,9,8,Sun,L 14-20,,7,74,6,68,13,142
4086,HOU,2017,2017-12-25,4:30,3:30,,PIT,16,15,Mon,L 6-34,,7,80,4,24,11,104
4087,HOU,2017,2017-12-31,1:00,1:00,@,IND,17,16,Sun,L 13-22,,7,34,4,20,11,54
4088,HOU,2018,2018-09-23,1:00,12:00,,NYG,3,3,Sun,L 22-27,,7,50,3,20,10,70
4089,HOU,2018,2018-11-04,4:05,2:05,@,DEN,9,9,Sun,W 19-17,,7,60,8,50,15,110
4090,HOU,2018,2018-11-18,1:00,1:00,@,WAS,11,10,Sun,W 23-21,,7,40,6,43,13,83
4091,HOU,2018,2018-12-09,1:00,12:00,,IND,14,13,Sun,L 21-24,,7,35,9,59,16,94
4092,HOU,2019,2019-09-15,1:00,12:00,,JAX,2,2,Sun,W 13-12,,7,47,9,70,16,117
4093,HOU,2019,2019-09-29,1:00,12:00,,CAR,4,4,Sun,L 10-16,,7,81,6,35,13,116
4094,HOU,2019,2019-10-27,4:25,3:25,,OAK,8,8,Sun,W 27-24,,7,50,11,100,18,150
4095,HOU,2019,2019-11-03,9:30,2:30,@,JAX,9,9,Sun,W 26-3,,7,60,4,34,11,94
4096,HOU,2021,2021-09-23,8:20,7:20,,CAR,3,3,Thu,L 9-24,,7,51,8,64,15,115
4097,HOU,2021,2021-11-21,1:00,12:00,@,TEN,11,10,Sun,W 22-13,,7,50,5,52,12,102
4098,JAX,2000,2000-09-17,1:02,1:02,,CIN,3,3,Sun,W 13-0,,7,76,6,44,13,120
4099,JAX,2000,2000-11-12,1:02,1:02,,SEA,11,10,Sun,L 21-28,,7,55,5,50,12,105
4100,JAX,2001,2001-11-18,4:05,4:05,@,PIT,10,9,Sun,L 7-20,,7,35,9,65,16,100
4101,JAX,2001,2001-12-09,1:02,1:02,@,CIN,13,12,Sun,W 14-10,,7,40,7,54,14,94
4102,JAX,2002,2002-11-17,1:02,12:02,@,HOU,11,10,Sun,W 24-21,,7,62,5,40,12,102
4103,JAX,2003,2003-09-21,1:00,12:00,@,IND,3,3,Sun,L 13-23,,7,38,4,20,11,58
4104,JAX,2003,2003-10-12,1:01,1:01,,MIA,6,6,Sun,L 10-24,,7,50,11,149,18,199
4105,JAX,2003,2003-11-02,1:02,1:02,@,BAL,9,8,Sun,L 17-24,,7,52,7,40,14,92
4106,JAX,2003,2003-11-09,1:02,1:02,,IND,10,9,Sun,W 28-23,,7,47,7,38,14,85
4107,JAX,2003,2003-12-07,1:02,1:02,,HOU,14,13,Sun,W 27-0,,7,70,10,86,17,156
4108,JAX,2003,2003-12-21,1:02,1:02,,NOR,16,15,Sun,W 20-19,,7,69,4,30,11,99
4109,JAX,2004,2004-12-19,4:15,3:15,@,GNB,15,14,Sun,W 28-25,,7,85,12,101,19,186
4110,JAX,2004,2005-01-02,4:15,1:15,@,OAK,17,16,Sun,W 13-6,,7,87,8,72,15,159
4111,JAX,2005,2005-09-18,12:03,12:03,@,IND,2,2,Sun,L 3-10,,7,60,6,45,13,105
4112,JAX,2005,2005-12-11,1:01,1:01,,IND,14,13,Sun,L 18-26,,7,65,5,47,12,112
4113,JAX,2005,2006-01-01,4:05,4:05,,TEN,17,16,Sun,W 40-13,,7,50,18,140,25,190
4114,JAX,2006,2006-10-22,1:03,12:03,@,HOU,7,6,Sun,L 7-27,,7,35,3,17,10,52
4115,JAX,2006,2006-12-03,4:05,4:05,@,MIA,13,12,Sun,W 24-10,,7,60,1,10,8,70
4116,JAX,2006,2006-12-24,1:03,1:03,,NWE,16,15,Sun,L 21-24,,7,60,7,51,14,111
4117,JAX,2008,2008-12-18,8:15,8:15,,IND,16,15,Thu,L 24-31,,7,60,6,50,13,110
4118,JAX,2008,2008-12-28,4:16,4:16,@,BAL,17,16,Sun,L 7-27,,7,28,7,55,14,83
4119,JAX,2010,2010-10-03,4:05,4:05,,IND,4,4,Sun,W 31-28,,7,45,3,35,10,80
4120,JAX,2010,2010-10-18,8:40,8:40,,TEN,6,6,Mon,L 3-30,,7,55,8,57,15,112
4121,JAX,2010,2010-12-26,1:03,1:03,,WAS,16,15,Sun,L 17-20,OT,7,66,5,40,12,106
4122,JAX,2012,2012-10-28,1:05,12:05,@,GNB,8,7,Sun,L 15-24,,7,77,5,33,12,110
4123,JAX,2012,2012-12-09,1:02,1:02,,NYJ,14,13,Sun,L 10-17,,7,54,1,15,8,69
4124,JAX,2012,2012-12-30,1:02,12:02,@,TEN,17,16,Sun,L 20-38,,7,35,5,43,12,78
4125,JAX,2013,2013-10-13,4:05,2:05,@,DEN,6,6,Sun,L 19-35,,7,62,4,31,11,93
4126,JAX,2013,2013-11-24,1:02,12:02,@,HOU,12,11,Sun,W 13-6,,7,63,2,22,9,85
4127,JAX,2014,2014-09-07,1:02,1:02,@,PHI,1,1,Sun,L 17-34,,7,55,6,50,13,105
4128,JAX,2014,2014-11-30,1:03,1:03,,NYG,13,12,Sun,W 25-24,,7,49,6,40,13,89
4129,JAX,2015,2015-09-27,1:06,1:06,@,NWE,3,3,Sun,L 17-51,,7,114,4,30,11,144
4130,JAX,2015,2015-10-18,1:02,1:02,,HOU,6,6,Sun,L 20-31,,7,64,10,69,17,133
4131,JAX,2015,2016-01-03,1:02,12:02,@,HOU,17,16,Sun,L 6-30,,7,53,9,55,16,108
4132,JAX,2016,2016-09-25,1:02,1:02,,BAL,3,3,Sun,L 17-19,,7,75,8,58,15,133
4133,JAX,2016,2016-10-27,8:26,7:26,@,TEN,8,7,Thu,L 22-36,,7,75,7,54,14,129
4134,JAX,2017,2017-12-10,4:25,1:00,,SEA,14,13,Sun,W 30-24,,7,48,6,73,13,121
4135,JAX,2018,2018-09-16,4:25,4:25,,NWE,2,2,Sun,W 31-20,,7,71,2,25,9,96
4136,JAX,2018,2018-12-06,8:20,7:20,@,TEN,14,13,Thu,L 9-30,,7,67,3,30,10,97
4137,JAX,2020,2020-11-15,1:00,12:00,@,GNB,10,9,Sun,L 20-24,,7,86,4,35,11,121
4138,JAX,2020,2020-12-20,1:00,1:00,@,BAL,15,14,Sun,L 14-40,,7,67,4,40,11,107
4139,JAX,2021,2021-09-19,1:00,1:00,,DEN,2,2,Sun,L 13-23,,7,70,10,101,17,171
4140,KAN,2000,2000-10-29,4:16,1:16,@,SEA,9,8,Sun,W 24-19,,7,53,10,99,17,152
4141,KAN,2000,2000-11-12,4:00,1:00,@,SFO,11,10,Sun,L 7-21,,7,50,6,53,13,103
4142,KAN,2000,2000-11-19,1:00,12:00,,BUF,12,11,Sun,L 17-21,,7,57,6,45,13,102
4143,KAN,2000,2000-12-04,9:09,9:09,@,NWE,14,13,Mon,L 24-30,,7,40,5,65,12,105
4144,KAN,2001,2001-09-30,1:01,1:01,@,WAS,3,3,Sun,W 45-13,,7,78,4,25,11,103
4145,KAN,2002,2002-10-06,4:06,4:06,@,NYJ,5,5,Sun,W 29-25,,7,65,4,25,11,90
4146,KAN,2003,2003-09-07,1:00,12:00,,SDG,1,1,Sun,W 27-14,,7,62,8,55,15,117
4147,KAN,2003,2003-10-05,1:00,12:00,,DEN,5,5,Sun,W 24-23,,7,47,7,59,14,106
4148,KAN,2003,2003-10-20,9:05,6:05,@,OAK,7,7,Mon,W 17-10,,7,67,6,50,13,117
4149,KAN,2004,2004-11-22,9:00,8:00,,NWE,11,10,Mon,L 19-27,,7,50,4,25,11,75
4150,KAN,2004,2004-12-05,4:05,1:05,@,OAK,13,12,Sun,W 34-27,,7,45,6,49,13,94
4151,KAN,2004,2004-12-13,9:08,8:08,@,TEN,14,13,Mon,W 49-38,,7,58,13,104,20,162
4152,KAN,2004,2004-12-25,5:00,4:00,,OAK,16,15,Sat,W 31-30,,7,52,12,90,19,142
4153,KAN,2005,2005-10-21,7:05,7:05,@,MIA,7,6,Fri,W 30-20,,7,63,4,30,11,93
4154,KAN,2005,2005-12-24,1:00,12:00,,SDG,16,15,Sat,W 20-7,,7,48,7,58,14,106
4155,KAN,2006,2006-11-12,1:03,1:03,@,MIA,10,9,Sun,L 10-13,,7,65,1,3,8,68
4156,KAN,2007,2007-11-25,1:00,12:00,,OAK,12,11,Sun,L 17-20,,7,48,7,58,14,106
4157,KAN,2007,2007-12-09,4:15,2:15,@,DEN,14,13,Sun,L 7-41,,7,34,4,35,11,69
4158,KAN,2008,2008-11-02,1:03,12:03,,TAM,9,8,Sun,L 27-30,OT,7,60,7,47,14,107
4159,KAN,2009,2009-10-04,1:00,12:00,,NYG,4,4,Sun,L 16-27,,7,55,8,54,15,109
4160,KAN,2009,2009-10-11,1:00,12:00,,DAL,5,5,Sun,L 20-26,OT,7,50,13,90,20,140
4161,KAN,2009,2009-10-25,1:00,12:00,,SDG,7,7,Sun,L 7-37,,7,41,9,59,16,100
4162,KAN,2010,2010-09-26,1:04,12:04,,SFO,3,3,Sun,W 31-10,,7,40,6,55,13,95
4163,KAN,2010,2010-10-24,1:03,12:03,,JAX,7,6,Sun,W 42-20,,7,92,6,43,13,135
4164,KAN,2010,2010-12-26,1:03,12:03,,TEN,16,15,Sun,W 34-14,,7,84,9,74,16,158
4165,KAN,2011,2011-09-25,4:05,1:05,@,SDG,3,3,Sun,L 17-20,,7,65,4,40,11,105
4166,KAN,2011,2011-12-18,1:03,12:03,,GNB,15,14,Sun,W 19-14,,7,55,5,37,12,92
4167,KAN,2012,2012-10-14,1:00,1:00,@,TAM,6,6,Sun,L 10-38,,7,55,6,33,13,88
4168,KAN,2012,2012-11-25,1:03,12:03,,DEN,12,11,Sun,L 9-17,,7,50,4,35,11,85
4169,KAN,2012,2012-12-16,4:25,1:25,@,OAK,15,14,Sun,L 0-15,,7,60,5,62,12,122
4170,KAN,2013,2013-09-29,1:02,12:02,,NYG,4,4,Sun,W 31-7,,7,62,7,65,14,127
4171,KAN,2013,2013-11-24,1:03,12:03,,SDG,12,11,Sun,L 38-41,,7,62,9,97,16,159
4172,KAN,2013,2013-12-22,1:02,12:02,,IND,16,15,Sun,L 7-23,,7,65,3,31,10,96
4173,KAN,2014,2014-09-14,4:25,2:25,@,DEN,2,2,Sun,L 17-24,,7,62,11,71,18,133
4174,KAN,2014,2014-10-19,4:05,1:05,@,SDG,7,6,Sun,W 23-20,,7,73,4,49,11,122
4175,KAN,2014,2014-10-26,1:04,12:04,,STL,8,7,Sun,W 34-7,,7,51,8,68,15,119
4176,KAN,2014,2014-11-20,8:26,8:26,@,OAK,12,11,Thu,L 20-24,,7,59,7,60,14,119
4177,KAN,2014,2014-12-28,1:03,12:03,,SDG,17,16,Sun,W 19-7,,7,46,10,67,17,113
4178,KAN,2015,2015-09-28,8:30,7:30,@,GNB,3,3,Mon,L 28-38,,7,38,12,89,19,127
4179,KAN,2015,2015-10-04,1:03,1:03,@,CIN,4,4,Sun,L 21-36,,7,46,11,84,18,130
4180,KAN,2016,2016-10-02,8:30,8:30,@,PIT,4,4,Sun,L 14-43,,7,40,9,68,16,108
4181,KAN,2017,2017-10-15,4:25,3:25,,PIT,6,6,Sun,L 13-19,,7,48,6,57,13,105
4182,KAN,2017,2017-10-30,8:30,7:30,,DEN,8,8,Mon,W 29-19,,7,69,7,53,14,122
4183,KAN,2017,2017-12-10,1:00,12:00,,OAK,14,13,Sun,W 26-15,,7,69,7,39,14,108
4184,KAN,2017,2017-12-16,8:25,7:25,,LAC,15,14,Sat,W 30-13,,7,71,9,61,16,132
4185,KAN,2018,2018-10-28,1:00,12:00,,DEN,8,8,Sun,W 30-23,,7,50,10,83,17,133
4186,KAN,2018,2018-12-09,1:00,12:00,,BAL,14,13,Sun,W 27-24,OT,7,53,11,112,18,165
4187,KAN,2019,2019-09-29,1:00,1:00,@,DET,4,4,Sun,W 34-30,,7,51,8,48,15,99
4188,KAN,2020,2020-11-01,1:00,12:00,,NYJ,8,8,Sun,W 35-9,,7,61,3,25,10,86
4189,KAN,2021,2021-10-03,1:00,1:00,@,PHI,4,4,Sun,W 42-30,,7,46,9,49,16,95
4190,KAN,2021,2021-10-10,8:20,7:20,,BUF,5,5,Sun,L 20-38,,7,55,10,103,17,158
4191,KAN,2021,2021-12-05,8:20,7:20,,DEN,13,12,Sun,W 22-9,,7,60,5,37,12,97
4192,MIA,2000,2000-09-10,12:00,12:00,@,MIN,2,2,Sun,L 7-13,,7,40,7,60,14,100
4193,MIA,2000,2000-10-29,1:02,1:02,,GNB,9,8,Sun,W 28-20,,7,104,7,59,14,163
4194,MIA,2000,2000-11-05,1:01,1:01,@,DET,10,9,Sun,W 23-8,,7,62,5,40,12,102
4195,MIA,2001,2001-12-02,1:02,1:02,,DEN,12,11,Sun,W 21-10,,7,70,5,39,12,109
4196,MIA,2001,2002-01-06,4:17,4:17,,BUF,17,16,Sun,W 34-7,,7,56,5,36,12,92
4197,MIA,2002,2002-09-22,1:02,1:02,,NYJ,3,3,Sun,W 30-3,,7,55,7,55,14,110
4198,MIA,2002,2002-11-24,1:02,1:02,,SDG,12,11,Sun,W 30-3,,7,70,6,41,13,111
4199,MIA,2003,2003-11-23,8:37,8:37,,WAS,12,11,Sun,W 24-23,,7,45,5,38,12,83
4200,MIA,2003,2003-12-15,9:09,9:09,,PHI,15,14,Mon,L 27-34,,7,76,6,60,13,136
4201,MIA,2004,2004-11-28,4:15,1:15,@,SFO,12,11,Sun,W 24-17,,7,50,6,58,13,108
4202,MIA,2004,2004-12-05,1:03,1:03,,BUF,13,12,Sun,L 32-42,,7,46,11,73,18,119
4203,MIA,2004,2004-12-26,8:37,8:37,,CLE,16,15,Sun,W 10-7,,7,35,5,25,12,60
4204,MIA,2005,2005-11-06,1:03,1:03,,ATL,9,8,Sun,L 10-17,,7,60,4,28,11,88
4205,MIA,2005,2005-11-20,1:03,1:03,@,CLE,11,10,Sun,L 0-22,,7,43,5,35,12,78
4206,MIA,2005,2005-11-27,4:05,1:05,@,OAK,12,11,Sun,W 33-21,,7,70,13,90,20,160
4207,MIA,2006,2006-12-25,8:43,8:43,,NYJ,16,15,Mon,L 10-13,,7,78,1,12,8,90
4208,MIA,2007,2007-09-16,4:05,4:05,,DAL,2,2,Sun,L 20-37,,7,57,11,101,18,158
4209,MIA,2007,2007-10-28,1:03,5:03,,NYG,8,8,Sun,L 10-13,,7,61,7,60,14,121
4210,MIA,2007,2007-11-11,1:02,1:02,,BUF,10,9,Sun,L 10-13,,7,39,2,10,9,49
4211,MIA,2008,2008-10-26,1:05,1:05,,BUF,8,7,Sun,W 25-16,,7,51,7,64,14,115
4212,MIA,2009,2009-09-27,4:15,1:15,@,SDG,3,3,Sun,L 13-23,,7,39,3,20,10,59
4213,MIA,2011,2011-11-06,1:03,12:03,@,KAN,9,8,Sun,W 31-3,,7,49,8,70,15,119
4214,MIA,2011,2011-12-11,1:03,1:03,,PHI,14,13,Sun,L 10-26,,7,81,7,69,14,150
4215,MIA,2012,2012-09-09,1:03,12:03,@,HOU,1,1,Sun,L 10-30,,7,78,4,35,11,113
4216,MIA,2012,2012-11-11,1:03,1:03,,TEN,10,9,Sun,L 3-37,,7,67,4,39,11,106
4217,MIA,2012,2012-12-02,1:02,1:02,,NWE,13,12,Sun,L 16-23,,7,77,6,50,13,127
4218,MIA,2013,2013-10-27,1:02,1:02,@,NWE,8,7,Sun,L 17-27,,7,61,5,35,12,96
4219,MIA,2014,2014-10-19,1:00,12:00,@,CHI,7,6,Sun,W 27-14,,7,84,2,15,9,99
4220,MIA,2014,2014-10-26,1:02,1:02,@,JAX,8,7,Sun,W 27-13,,7,52,6,37,13,89
4221,MIA,2014,2014-12-21,1:03,1:03,,MIN,16,15,Sun,W 37-35,,7,54,8,74,15,128
4222,MIA,2015,2015-10-29,8:26,8:26,@,NWE,8,7,Thu,L 7-36,,7,40,8,69,15,109
4223,MIA,2016,2016-09-29,8:26,8:26,@,CIN,4,4,Thu,L 7-22,,7,68,6,40,13,108
4224,MIA,2016,2016-12-04,1:00,1:00,@,BAL,13,12,Sun,L 6-38,,7,57,7,68,14,125
4225,MIA,2017,2017-10-26,8:25,8:25,@,BAL,8,7,Thu,L 0-40,,7,43,5,40,12,83
4226,MIA,2017,2017-11-13,8:30,8:30,@,CAR,10,9,Mon,L 21-45,,7,57,6,37,13,94
4227,MIA,2017,2017-12-03,1:00,1:00,,DEN,13,12,Sun,W 35-9,,7,85,9,57,16,142
4228,MIA,2017,2017-12-17,1:00,1:00,@,BUF,15,14,Sun,L 16-24,,7,60,3,28,10,88
4229,MIA,2018,2018-09-09,1:00,1:00,,TEN,1,1,Sun,W 27-20,,7,51,5,48,12,99
4230,MIA,2018,2018-10-14,1:00,1:00,,CHI,6,6,Sun,W 31-28,OT,7,67,6,58,13,125
4231,MIA,2018,2018-12-09,1:00,1:00,,NWE,14,13,Sun,W 34-33,,7,81,5,30,12,111
4232,MIA,2019,2019-12-01,1:00,1:00,,PHI,13,12,Sun,W 37-31,,7,59,10,91,17,150
4233,MIA,2019,2019-12-15,1:00,1:00,@,NYG,15,14,Sun,L 20-36,,7,42,4,32,11,74
4234,MIA,2020,2020-10-11,4:05,1:05,@,SFO,5,5,Sun,W 43-17,,7,69,7,75,14,144
4235,MIA,2020,2020-11-08,4:25,2:25,@,ARI,9,8,Sun,W 34-31,,7,75,7,71,14,146
4236,MIA,2020,2020-12-20,1:00,1:00,,NWE,15,14,Sun,W 22-12,,7,40,2,20,9,60
4237,MIA,2021,2021-10-17,9:30,2:30,@,JAX,6,6,Sun,L 20-23,,7,55,8,54,15,109
4238,MIA,2021,2021-12-27,8:15,7:15,@,NOR,16,15,Mon,W 20-3,,7,65,7,62,14,127
4239,MIN,2000,2000-09-10,12:00,12:00,,MIA,2,2,Sun,W 13-7,,7,60,7,40,14,100
4240,MIN,2000,2000-10-15,8:35,7:35,@,CHI,7,6,Sun,W 28-16,,7,73,8,53,15,126
4241,MIN,2000,2000-12-10,4:15,3:15,@,STL,15,14,Sun,L 29-40,,7,60,7,43,14,103
4242,MIN,2001,2001-09-09,1:00,12:00,,CAR,1,1,Sun,L 13-24,,7,40,7,57,14,97
4243,MIN,2001,2001-10-21,3:15,3:15,,GNB,6,6,Sun,W 35-13,,7,54,5,48,12,102
4244,MIN,2001,2001-11-11,4:15,4:15,@,PHI,9,8,Sun,L 17-48,,7,51,2,8,9,59
4245,MIN,2002,2002-12-21,1:30,12:30,,MIA,16,15,Sat,W 20-17,,7,54,8,65,15,119
4246,MIN,2002,2002-12-29,1:02,1:02,@,DET,17,16,Sun,W 38-36,,7,79,6,60,13,139
4247,MIN,2003,2003-09-07,1:04,12:04,@,GNB,1,1,Sun,W 30-25,,7,65,6,60,13,125
4248,MIN,2003,2003-12-14,1:03,12:03,@,CHI,15,14,Sun,L 10-13,,7,68,3,30,10,98
4249,MIN,2003,2003-12-28,4:05,2:05,@,ARI,17,16,Sun,L 17-18,,7,71,1,5,8,76
4250,MIN,2004,2004-11-21,1:00,12:00,,DET,11,10,Sun,W 22-19,,7,51,9,116,16,167
4251,MIN,2004,2005-01-02,1:04,1:04,@,WAS,17,16,Sun,L 18-21,,7,49,3,13,10,62
4252,MIN,2005,2005-09-18,1:03,1:03,@,CIN,2,2,Sun,L 8-37,,7,49,17,115,24,164
4253,MIN,2005,2005-11-13,1:03,1:03,@,NYG,10,9,Sun,W 24-21,,7,90,9,75,16,165
4254,MIN,2005,2005-11-27,1:02,12:02,,CLE,12,11,Sun,W 24-12,,7,49,6,30,13,79
4255,MIN,2005,2006-01-01,4:15,3:15,,CHI,17,16,Sun,W 34-10,,7,45,8,45,15,90
4256,MIN,2006,2006-11-12,1:05,12:05,,GNB,10,9,Sun,L 17-23,,7,49,5,34,12,83
4257,MIN,2006,2006-12-10,1:03,1:03,@,DET,14,13,Sun,W 30-20,,7,50,6,50,13,100
4258,MIN,2007,2007-09-30,1:05,12:05,,GNB,4,4,Sun,L 16-23,,7,40,6,40,13,80
4259,MIN,2008,2008-09-28,1:03,12:03,@,TEN,4,4,Sun,L 17-30,,7,50,4,18,11,68
4260,MIN,2008,2008-10-06,8:40,7:40,@,NOR,5,5,Mon,W 30-27,,7,60,11,102,18,162
4261,MIN,2008,2008-10-12,1:05,12:05,,DET,6,6,Sun,W 12-10,,7,99,5,96,12,195
4262,MIN,2008,2008-11-09,1:05,12:05,,GNB,10,9,Sun,W 28-27,,7,55,10,80,17,135
4263,MIN,2010,2010-09-19,1:05,12:05,,MIA,2,2,Sun,L 10-14,,7,44,2,15,9,59
4264,MIN,2012,2012-10-21,1:05,12:05,,ARI,7,7,Sun,W 21-14,,7,35,9,82,16,117
4265,MIN,2012,2012-11-11,1:05,12:05,,DET,10,10,Sun,W 34-24,,7,47,6,57,13,104
4266,MIN,2012,2012-12-09,1:05,12:05,,CHI,14,13,Sun,W 21-14,,7,54,10,80,17,134
4267,MIN,2013,2013-10-27,8:30,7:30,,GNB,8,7,Sun,L 31-44,,7,46,6,120,13,166
4268,MIN,2014,2014-09-07,1:00,12:00,@,STL,1,1,Sun,W 34-6,,7,60,13,121,20,181
4269,MIN,2014,2014-09-14,1:05,12:05,,NWE,2,2,Sun,L 7-30,,7,58,15,163,22,221
4270,MIN,2014,2014-10-19,1:02,1:02,@,BUF,7,7,Sun,L 16-17,,7,50,8,48,15,98
4271,MIN,2014,2014-11-23,1:03,12:03,,GNB,12,11,Sun,L 21-24,,7,77,8,75,15,152
4272,MIN,2016,2016-10-23,1:02,1:02,@,PHI,7,6,Sun,L 10-21,,7,56,7,53,14,109
4273,MIN,2016,2016-12-11,1:00,1:00,@,JAX,14,13,Sun,W 25-16,,7,93,14,114,21,207
4274,MIN,2017,2017-10-15,1:00,3:00,,GNB,6,6,Sun,W 23-10,,7,65,8,92,15,157
4275,MIN,2017,2017-11-19,1:00,3:00,,LAR,11,10,Sun,W 24-7,,7,65,8,60,15,125
4276,MIN,2018,2018-09-09,1:00,3:00,,SFO,1,1,Sun,W 24-16,,7,52,3,21,10,73
4277,MIN,2019,2019-09-29,4:25,3:25,@,CHI,4,4,Sun,L 6-16,,7,55,7,50,14,105
4278,MIN,2019,2019-10-24,8:20,10:20,,WAS,8,8,Thu,W 19-9,,7,74,4,46,11,120
4279,MIN,2020,2020-11-01,1:00,12:00,@,GNB,8,7,Sun,W 28-22,,7,36,9,85,16,121
4280,MIN,2021,2021-10-03,1:00,11:00,,CLE,4,4,Sun,L 7-14,,7,42,7,73,14,115
4281,MIN,2021,2021-10-10,1:00,11:00,,DET,5,5,Sun,W 19-17,,7,74,3,30,10,104
4282,MIN,2021,2021-10-31,8:20,6:20,,DAL,8,7,Sun,L 16-20,,7,57,11,96,18,153
4283,MIN,2021,2021-12-05,1:00,1:00,@,DET,13,12,Sun,L 27-29,,7,66,3,11,10,77
4284,MIN,2021,2021-12-20,8:15,7:15,@,CHI,15,14,Mon,W 17-9,,7,54,9,91,16,145
4285,NOR,2000,2000-12-17,1:03,12:03,,ATL,16,15,Sun,W 23-7,,7,50,5,33,12,83
4286,NOR,2000,2000-12-24,1:02,12:02,,STL,17,16,Sun,L 21-26,,7,48,6,65,13,113
4287,NOR,2001,2001-10-28,1:02,12:02,@,STL,7,6,Sun,W 34-31,,7,81,8,58,15,139
4288,NOR,2003,2003-10-05,1:02,1:02,@,CAR,5,5,Sun,L 13-19,,7,64,4,20,11,84
4289,NOR,2003,2003-10-19,1:03,1:03,@,ATL,7,7,Sun,W 45-17,,7,54,5,78,12,132
4290,NOR,2003,2003-11-16,1:04,12:04,,ATL,11,10,Sun,W 23-20,OT,7,46,5,44,12,90
4291,NOR,2003,2003-12-14,8:36,7:36,,NYG,15,14,Sun,W 45-7,,7,55,7,70,14,125
4292,NOR,2003,2003-12-28,1:03,12:03,,DAL,17,16,Sun,W 13-7,,7,60,7,44,14,104
4293,NOR,2005,2005-11-27,8:37,8:37,@,NYJ,12,11,Sun,W 21-19,,7,60,7,55,14,115
4294,NOR,2005,2006-01-01,1:02,1:02,@,TAM,17,16,Sun,L 13-27,,7,53,10,107,17,160
4295,NOR,2006,2006-10-15,1:02,12:02,,PHI,6,6,Sun,W 27-24,,7,64,8,67,15,131
4296,NOR,2006,2006-12-10,8:21,7:21,@,DAL,14,13,Sun,W 42-17,,7,54,6,43,13,97
4297,NOR,2008,2008-09-07,1:02,12:02,,TAM,1,1,Sun,W 24-20,,7,51,7,66,14,117
4298,NOR,2008,2008-11-09,1:03,1:03,@,ATL,10,9,Sun,L 20-34,,7,45,2,25,9,70
4299,NOR,2008,2008-12-28,1:03,12:03,,CAR,17,16,Sun,L 31-33,,7,48,5,30,12,78
4300,NOR,2009,2009-09-13,1:03,12:03,,DET,1,1,Sun,W 45-27,,7,36,8,80,15,116
4301,NOR,2009,2009-10-04,4:05,3:05,,NYJ,4,4,Sun,W 24-10,,7,70,3,21,10,91
4302,NOR,2009,2009-11-02,8:40,7:40,,ATL,8,7,Mon,W 35-27,,7,65,4,25,11,90
4303,NOR,2009,2009-11-08,4:05,3:05,,CAR,9,8,Sun,W 30-20,,7,55,6,37,13,92
4304,NOR,2009,2009-12-06,1:03,1:03,@,WAS,13,12,Sun,W 33-30,OT,7,102,2,15,9,117
4305,NOR,2010,2010-10-24,1:02,12:02,,CLE,7,7,Sun,L 17-30,,7,98,4,30,11,128
4306,NOR,2010,2010-11-07,1:04,1:04,@,CAR,9,9,Sun,W 34-3,,7,64,10,65,17,129
4307,NOR,2011,2011-09-18,1:02,12:02,,CHI,2,2,Sun,W 30-13,,7,41,6,47,13,88
4308,NOR,2011,2011-10-16,4:15,4:15,@,TAM,6,6,Sun,L 20-26,,7,53,7,64,14,117
4309,NOR,2012,2012-10-21,1:02,1:02,@,TAM,7,6,Sun,W 35-28,,7,55,7,50,14,105
4310,NOR,2013,2013-10-13,4:25,4:25,@,NWE,6,6,Sun,L 27-30,,7,56,4,33,11,89
4311,NOR,2013,2013-12-02,8:41,5:41,@,SEA,13,12,Mon,L 7-34,,7,52,8,66,15,118
4312,NOR,2015,2015-09-13,4:05,1:05,@,ARI,1,1,Sun,L 19-31,,7,73,5,30,12,103
4313,NOR,2015,2015-10-11,1:04,1:04,@,PHI,5,5,Sun,L 17-39,,7,78,4,35,11,113
4314,NOR,2015,2015-11-15,1:05,1:05,@,WAS,10,10,Sun,L 14-47,,7,50,5,26,12,76
4315,NOR,2016,2016-09-11,1:05,12:05,,OAK,1,1,Sun,L 34-35,,7,53,14,141,21,194
4316,NOR,2016,2016-09-18,1:03,1:03,@,NYG,2,2,Sun,L 13-16,,7,76,3,25,10,101
4317,NOR,2016,2016-12-24,4:25,3:25,,TAM,16,15,Sat,W 31-24,,7,59,7,63,14,122
4318,NOR,2017,2017-10-22,1:00,12:00,@,GNB,7,6,Sun,W 26-17,,7,80,8,54,15,134
4319,NOR,2017,2017-10-29,1:00,12:00,,CHI,8,7,Sun,W 20-12,,7,51,4,31,11,82
4320,NOR,2017,2017-11-19,1:00,12:00,,WAS,11,10,Sun,W 34-31,OT,7,54,9,67,16,121
4321,NOR,2017,2017-11-26,4:25,1:05,@,LAR,12,11,Sun,L 20-26,,7,112,9,90,16,202
4322,NOR,2017,2017-12-03,4:25,12:00,,CAR,13,12,Sun,W 31-21,,7,68,6,54,13,122
4323,NOR,2017,2017-12-31,4:25,1:00,@,TAM,17,16,Sun,L 24-31,,7,38,2,15,9,53
4324,NOR,2018,2018-10-28,8:20,10:20,@,MIN,8,7,Sun,W 30-20,,7,64,6,54,13,118
4325,NOR,2019,2019-09-09,7:10,6:10,,HOU,1,1,Mon,W 30-28,,7,48,8,69,15,117
4326,NOR,2021,2021-10-25,8:15,5:15,@,SEA,7,6,Mon,W 13-10,,7,90,6,53,13,143
4327,NOR,2021,2021-12-02,8:20,7:20,,DAL,13,12,Thu,L 17-27,,7,59,5,35,12,94
4328,NOR,2021,2021-12-27,8:15,7:15,,MIA,16,15,Mon,L 3-20,,7,62,7,65,14,127
4329,NWE,2000,2000-10-08,1:02,1:02,,IND,6,6,Sun,W 24-16,,7,34,5,52,12,86
4330,NWE,2000,2000-12-10,1:02,12:02,@,CHI,15,14,Sun,L 17-24,,7,60,3,35,10,95
4331,NWE,2001,2001-09-30,1:03,1:03,,IND,3,3,Sun,W 44-13,,7,65,5,60,12,125
4332,NWE,2001,2001-10-14,1:03,1:03,,SDG,5,5,Sun,W 29-26,OT,7,51,11,93,18,144
4333,NWE,2001,2001-10-28,2:15,2:15,@,DEN,7,7,Sun,L 20-31,,7,53,6,66,13,119
4334,NWE,2001,2001-11-04,1:01,1:01,@,ATL,8,8,Sun,W 24-10,,7,60,7,55,14,115
4335,NWE,2001,2001-11-11,1:02,1:02,,BUF,9,9,Sun,W 21-11,,7,75,9,75,16,150
4336,NWE,2001,2001-12-16,1:02,1:02,@,BUF,14,14,Sun,W 12-9,OT,7,60,4,30,11,90
4337,NWE,2001,2001-12-22,1:35,1:35,,MIA,15,15,Sat,W 20-13,,7,75,9,67,16,142
4338,NWE,2002,2002-09-09,9:12,9:12,,PIT,1,1,Mon,W 30-14,,7,88,13,112,20,200
4339,NWE,2002,2002-11-17,8:36,5:36,@,OAK,11,10,Sun,L 20-27,,7,34,12,115,19,149
4340,NWE,2003,2003-11-16,8:37,8:37,,DAL,11,10,Sun,W 12-0,,7,84,10,78,17,162
4341,NWE,2004,2004-10-10,1:02,1:02,,MIA,5,4,Sun,W 24-10,,7,55,12,86,19,141
4342,NWE,2004,2004-11-07,4:15,3:15,@,STL,9,8,Sun,W 40-22,,7,48,10,80,17,128
4343,NWE,2004,2004-12-05,1:02,1:02,@,CLE,13,12,Sun,W 42-15,,7,60,7,84,14,144
4344,NWE,2005,2005-09-08,9:07,9:07,,OAK,1,1,Thu,W 30-20,,7,46,16,149,23,195
4345,NWE,2005,2005-10-30,8:37,8:37,,BUF,8,7,Sun,W 21-16,,7,57,12,74,19,131
4346,NWE,2005,2005-12-04,4:15,4:15,,NYJ,13,12,Sun,W 16-3,,7,68,7,60,14,128
4347,NWE,2006,2006-10-01,4:15,4:15,@,CIN,4,4,Sun,W 38-13,,7,61,9,74,16,135
4348,NWE,2006,2006-10-08,1:02,1:02,,MIA,5,5,Sun,W 20-10,,7,59,10,81,17,140
4349,NWE,2006,2006-12-24,1:03,1:03,@,JAX,16,15,Sun,W 24-21,,7,51,7,60,14,111
4350,NWE,2007,2007-11-25,8:23,8:23,,PHI,12,11,Sun,W 31-28,,7,44,3,18,10,62
4351,NWE,2008,2008-12-21,1:02,1:02,,ARI,16,15,Sun,W 47-7,,7,65,3,20,10,85
4352,NWE,2010,2010-10-24,4:15,1:15,@,SDG,7,6,Sun,W 23-20,,7,51,6,69,13,120
4353,NWE,2010,2010-12-19,8:30,8:30,,GNB,15,14,Sun,W 31-27,,7,52,2,15,9,67
4354,NWE,2011,2011-09-12,7:13,7:13,@,MIA,1,1,Mon,W 38-24,,7,50,8,60,15,110
4355,NWE,2011,2011-11-06,4:15,4:15,,NYG,9,8,Sun,L 20-24,,7,81,6,50,13,131
4356,NWE,2012,2012-11-11,1:02,1:02,,BUF,10,9,Sun,W 37-31,,7,73,14,148,21,221
4357,NWE,2013,2013-10-20,1:03,1:03,@,NYJ,7,7,Sun,L 27-30,OT,7,100,9,45,16,145
4358,NWE,2013,2013-12-22,4:25,4:25,@,BAL,16,15,Sun,W 41-7,,7,58,9,83,16,141
4359,NWE,2014,2014-10-26,1:02,1:02,,CHI,8,8,Sun,W 51-23,,7,38,5,41,12,79
4360,NWE,2015,2015-09-10,8:40,8:40,,PIT,1,1,Thu,W 28-21,,7,64,8,77,15,141
4361,NWE,2015,2015-11-15,4:31,4:31,@,NYG,10,9,Sun,W 27-26,,7,93,8,49,15,142
4362,NWE,2015,2016-01-03,1:02,1:02,@,MIA,17,16,Sun,L 10-20,,7,41,10,93,17,134
4363,NWE,2016,2016-09-18,1:02,1:02,,MIA,2,2,Sun,W 31-24,,7,65,5,49,12,114
4364,NWE,2016,2016-11-13,8:30,8:30,,SEA,10,9,Sun,L 24-31,,7,61,8,60,15,121
4365,NWE,2016,2017-01-01,1:00,1:00,@,MIA,17,16,Sun,W 35-14,,7,64,9,73,16,137
4366,NWE,2017,2017-10-01,1:00,1:00,,CAR,4,4,Sun,L 30-33,,7,55,1,33,8,88
4367,NWE,2017,2017-11-26,1:00,1:00,,MIA,12,11,Sun,W 35-17,,7,70,6,52,13,122
4368,NWE,2018,2018-10-04,8:20,8:20,,IND,5,5,Thu,W 38-24,,7,50,4,35,11,85
4369,NWE,2018,2018-10-21,1:00,12:00,@,CHI,7,7,Sun,W 38-31,,7,64,5,40,12,104
4370,NWE,2018,2018-12-02,4:25,4:25,,MIN,13,12,Sun,W 24-10,,7,60,5,55,12,115
4371,NWE,2019,2019-09-08,8:20,8:20,,PIT,1,1,Sun,W 33-3,,7,55,6,54,13,109
4372,NWE,2019,2019-10-06,1:00,1:00,@,WAS,5,5,Sun,W 33-7,,7,55,6,72,13,127
4373,NWE,2019,2019-10-21,8:15,8:15,@,NYJ,7,7,Mon,W 33-0,,7,92,8,60,15,152
4374,NWE,2019,2019-11-03,8:20,8:20,@,BAL,9,9,Sun,L 20-37,,7,48,4,34,11,82
4375,NWE,2020,2020-11-22,1:00,12:00,@,HOU,11,10,Sun,L 20-27,,7,55,5,35,12,90
4376,NYG,2000,2000-10-01,1:03,12:03,@,TEN,5,5,Sun,L 14-28,,7,48,6,64,13,112
4377,NYG,2000,2000-11-12,4:15,4:15,,STL,11,10,Sun,L 24-38,,7,49,2,10,9,59
4378,NYG,2000,2000-12-17,8:20,7:20,@,DAL,16,15,Sun,W 17-13,,7,79,7,75,14,154
4379,NYG,2001,2001-09-10,7:07,7:07,@,DEN,1,1,Mon,L 20-31,,7,35,6,36,13,71
4380,NYG,2001,2001-10-07,1:04,1:04,,WAS,4,4,Sun,W 23-9,,7,64,7,53,14,117
4381,NYG,2002,2002-11-03,8:39,8:39,,JAX,9,8,Sun,W 24-17,,7,59,8,63,15,122
4382,NYG,2002,2002-12-28,1:36,1:36,,PHI,17,16,Sat,W 10-7,OT,7,64,8,55,15,119
4383,NYG,2003,2003-09-07,1:05,1:05,,STL,1,1,Sun,W 23-13,,7,59,5,35,12,94
4384,NYG,2003,2003-12-07,1:02,1:02,,WAS,14,13,Sun,L 7-20,,7,70,6,35,13,105
4385,NYG,2003,2003-12-14,8:36,7:36,@,NOR,15,14,Sun,L 7-45,,7,70,7,55,14,125
4386,NYG,2004,2004-10-31,1:00,12:00,@,MIN,8,7,Sun,W 34-13,,7,87,9,83,16,170
4387,NYG,2004,2004-12-05,4:16,4:16,@,WAS,13,12,Sun,L 7-31,,7,40,8,66,15,106
4388,NYG,2005,2005-09-11,4:18,4:18,,ARI,1,1,Sun,W 42-19,,7,52,10,53,17,105
4389,NYG,2005,2005-10-23,4:15,4:15,,DEN,7,6,Sun,W 24-23,,7,52,6,53,13,105
4390,NYG,2005,2005-12-17,5:11,5:11,,KAN,15,14,Sat,W 27-17,,7,70,9,75,16,145
4391,NYG,2006,2006-12-24,1:04,1:04,,NOR,16,15,Sun,L 7-30,,7,67,2,15,9,82
4392,NYG,2007,2007-10-28,1:03,5:03,@,MIA,8,8,Sun,W 13-10,,7,60,7,61,14,121
4393,NYG,2008,2008-09-04,7:08,7:08,,WAS,1,1,Thu,W 16-7,,7,70,7,35,14,105
4394,NYG,2008,2008-09-14,1:00,12:00,@,STL,2,2,Sun,W 41-13,,7,69,5,40,12,109
4395,NYG,2008,2008-10-26,4:15,4:15,@,PIT,8,7,Sun,W 21-14,,7,71,8,59,15,130
4396,NYG,2008,2008-12-14,8:24,7:24,@,DAL,15,14,Sun,L 8-20,,7,40,11,108,18,148
4397,NYG,2008,2008-12-28,1:05,12:05,@,MIN,17,16,Sun,L 19-20,,7,49,2,20,9,69
4398,NYG,2009,2009-10-25,8:30,8:30,,ARI,7,7,Sun,L 17-24,,7,30,7,60,14,90
4399,NYG,2009,2009-12-13,8:30,8:30,,PHI,14,13,Sun,L 38-45,,7,54,6,45,13,99
4400,NYG,2010,2010-12-13,7:20,7:20,@,MIN,14,13,Mon,W 21-3,,7,55,10,71,17,126
4401,NYG,2011,2011-10-02,4:05,1:05,@,ARI,4,4,Sun,W 31-27,,7,55,11,118,18,173
4402,NYG,2011,2011-10-09,1:04,1:04,,SEA,5,5,Sun,L 25-36,,7,52,10,70,17,122
4403,NYG,2011,2011-10-16,1:02,1:02,,BUF,6,6,Sun,W 27-24,,7,79,7,75,14,154
4404,NYG,2011,2011-10-30,1:02,1:02,,MIA,8,7,Sun,W 20-17,,7,46,4,30,11,76
4405,NYG,2012,2012-09-16,1:03,1:03,,TAM,2,2,Sun,W 41-34,,7,53,5,33,12,86
4406,NYG,2012,2012-09-30,8:30,8:30,@,PHI,4,4,Sun,L 17-19,,7,55,5,49,12,104
4407,NYG,2012,2012-11-04,4:26,4:26,,PIT,9,9,Sun,L 20-24,,7,40,6,119,13,159
4408,NYG,2013,2013-09-29,1:02,12:02,@,KAN,4,4,Sun,L 7-31,,7,65,7,62,14,127
4409,NYG,2013,2013-12-08,4:25,1:25,@,SDG,14,13,Sun,L 14-37,,7,72,6,30,13,102
4410,NYG,2014,2014-09-25,8:26,8:26,@,WAS,4,4,Thu,W 45-14,,7,66,11,88,18,154
4411,NYG,2014,2014-12-07,1:03,12:03,@,TEN,14,13,Sun,W 36-7,,7,70,5,39,12,109
4412,NYG,2015,2015-12-20,1:02,1:02,,CAR,15,14,Sun,L 35-38,,7,47,7,88,14,135
4413,NYG,2015,2015-12-27,8:30,7:30,@,MIN,16,15,Sun,L 17-49,,7,48,2,10,9,58
4414,NYG,2016,2016-10-16,1:02,1:02,,BAL,6,6,Sun,W 27-23,,7,119,15,111,22,230
4415,NYG,2016,2016-12-11,8:30,8:30,,DAL,14,13,Sun,W 10-7,,7,50,5,54,12,104
4416,NYG,2017,2017-09-18,8:30,8:30,,DET,2,2,Mon,L 10-24,,7,50,6,50,13,100
4417,NYG,2017,2017-10-22,4:25,4:25,,SEA,7,7,Sun,L 7-24,,7,28,15,110,22,138
4418,NYG,2017,2017-12-10,1:00,1:00,,DAL,14,13,Sun,L 10-30,,7,69,8,51,15,120
4419,NYG,2019,2019-09-15,1:00,1:00,,BUF,2,2,Sun,L 14-28,,7,40,9,65,16,105
4420,NYG,2019,2019-12-09,8:15,8:15,@,PHI,14,13,Mon,L 17-23,OT,7,54,4,30,11,84
4421,NYG,2020,2020-11-02,8:15,8:15,,TAM,8,8,Mon,L 23-25,,7,73,3,20,10,93
4422,NYG,2020,2020-11-15,1:00,1:00,,PHI,10,10,Sun,W 27-17,,7,64,11,74,18,138
4423,NYJ,2000,2000-12-17,1:02,1:02,,DET,16,15,Sun,L 7-10,,7,45,4,25,11,70
4424,NYJ,2001,2001-12-16,1:02,1:02,,CIN,14,13,Sun,W 15-14,,7,55,6,65,13,120
4425,NYJ,2001,2002-01-06,4:15,1:15,@,OAK,17,16,Sun,W 24-22,,7,60,5,35,12,95
4426,NYJ,2002,2002-09-15,1:03,1:03,,NWE,2,2,Sun,L 7-44,,7,55,3,36,10,91
4427,NYJ,2002,2002-09-22,1:02,1:02,@,MIA,3,3,Sun,L 3-30,,7,55,7,55,14,110
4428,NYJ,2002,2002-12-15,1:05,12:05,@,CHI,15,14,Sun,L 13-20,,7,54,8,74,15,128
4429,NYJ,2002,2002-12-22,8:36,8:36,@,NWE,16,15,Sun,W 30-17,,7,60,4,30,11,90
4430,NYJ,2003,2003-09-14,1:02,1:02,,MIA,2,2,Sun,L 10-21,,7,52,4,30,11,82
4431,NYJ,2004,2004-11-07,1:02,1:02,@,BUF,9,8,Sun,L 17-22,,7,40,8,66,15,106
4432,NYJ,2004,2005-01-02,1:02,12:02,@,STL,17,16,Sun,L 29-32,OT,7,75,10,76,17,151
4433,NYJ,2005,2005-10-16,4:15,4:15,@,BUF,6,6,Sun,L 17-27,,7,50,13,99,20,149
4434,NYJ,2005,2005-11-20,4:15,2:15,@,DEN,11,10,Sun,L 0-27,,7,41,3,30,10,71
4435,NYJ,2005,2005-11-27,8:37,8:37,,NOR,12,11,Sun,L 19-21,,7,55,7,60,14,115
4436,NYJ,2005,2005-12-04,4:15,4:15,@,NWE,13,12,Sun,L 3-16,,7,60,7,68,14,128
4437,NYJ,2006,2006-12-17,1:05,12:05,@,MIN,15,14,Sun,W 26-13,,7,55,8,56,15,111
4438,NYJ,2008,2008-09-07,1:02,1:02,@,MIA,1,1,Sun,W 20-14,,7,40,4,59,11,99
4439,NYJ,2008,2008-10-19,4:15,1:15,@,OAK,7,6,Sun,L 13-16,OT,7,60,14,85,21,145
4440,NYJ,2010,2010-10-31,1:03,1:03,,GNB,8,7,Sun,L 0-9,,7,55,3,15,10,70
4441,NYJ,2011,2011-09-18,1:02,1:02,,JAX,2,2,Sun,W 32-3,,7,60,4,50,11,110
4442,NYJ,2011,2011-09-25,4:04,1:04,@,OAK,3,3,Sun,L 24-34,,7,61,7,55,14,116
4443,NYJ,2012,2012-09-16,4:25,4:25,@,PIT,2,2,Sun,L 10-27,,7,63,10,107,17,170
4444,NYJ,2014,2014-09-14,4:25,3:25,@,GNB,2,2,Sun,L 24-31,,7,82,3,34,10,116
4445,NYJ,2014,2014-10-16,8:25,8:25,@,NWE,7,7,Thu,L 25-27,,7,70,9,64,16,134
4446,NYJ,2014,2014-12-01,8:30,8:30,,MIA,13,12,Mon,L 13-16,,7,57,3,20,10,77
4447,NYJ,2014,2014-12-14,4:05,3:05,@,TEN,15,14,Sun,W 16-11,,7,46,9,76,16,122
4448,NYJ,2015,2015-11-22,1:03,12:03,@,HOU,11,10,Sun,L 17-24,,7,54,3,54,10,108
4449,NYJ,2016,2016-09-11,1:05,1:05,,CIN,1,1,Sun,L 22-23,,7,95,5,44,12,139
4450,NYJ,2016,2016-09-15,8:26,8:26,@,BUF,2,2,Thu,W 37-31,,7,50,6,59,13,109
4451,NYJ,2016,2016-10-02,1:03,1:03,,SEA,4,4,Sun,L 17-27,,7,60,7,71,14,131
4452,NYJ,2017,2017-11-26,1:00,1:00,,CAR,12,11,Sun,L 27-35,,7,68,10,84,17,152
4453,NYJ,2018,2018-09-10,7:10,7:10,@,DET,1,1,Mon,W 48-17,,7,49,3,15,10,64
4454,NYJ,2018,2018-09-16,1:00,1:00,,MIA,2,2,Sun,L 12-20,,7,50,2,10,9,60
4455,NYJ,2018,2018-10-14,1:00,1:00,,IND,6,6,Sun,W 42-34,,7,49,8,66,15,115
4456,NYJ,2018,2018-12-09,1:00,1:00,@,BUF,14,13,Sun,W 27-23,,7,93,7,47,14,140
4457,NYJ,2019,2019-11-10,1:00,1:00,,NYG,10,9,Sun,W 34-27,,7,54,6,62,13,116
4458,NYJ,2020,2020-09-27,4:05,4:05,@,IND,3,3,Sun,L 7-36,,7,57,4,40,11,97
4459,NYJ,2020,2020-10-18,4:05,4:05,@,MIA,6,6,Sun,L 0-24,,7,80,5,25,12,105
4460,NYJ,2020,2020-12-13,4:05,1:05,@,SEA,14,13,Sun,L 3-40,,7,50,4,35,11,85
4461,NYJ,2020,2020-12-27,1:00,1:00,,CLE,16,15,Sun,W 23-16,,7,58,6,51,13,109
4462,NYJ,2021,2021-10-10,9:30,2:30,@,ATL,5,5,Sun,L 20-27,,7,58,4,66,11,124
4463,NYJ,2021,2021-11-04,8:20,8:20,@,IND,9,8,Thu,L 30-45,,7,43,2,22,9,65
4464,NYJ,2021,2021-11-21,1:00,1:00,,MIA,11,10,Sun,L 17-24,,7,48,8,62,15,110
4465,NYJ,2021,2021-12-26,1:00,1:00,,JAX,16,15,Sun,W 26-21,,7,81,2,10,9,91
4466,TEN,2000,2000-09-10,1:03,12:03,,KAN,2,2,Sun,W 17-14,OT,7,70,10,72,17,142
4467,TEN,2000,2000-12-10,1:03,12:03,,CIN,15,14,Sun,W 35-3,,7,39,4,34,11,73
4468,TEN,2000,2000-12-25,9:10,8:10,,DAL,17,16,Mon,W 31-0,,7,51,7,51,14,102
4469,TEN,2001,2001-11-12,9:08,8:08,,BAL,9,8,Mon,L 10-16,,7,72,6,60,13,132
4470,TEN,2001,2001-12-22,9:00,6:00,@,OAK,15,14,Sat,W 13-10,,7,54,4,66,11,120
4471,TEN,2002,2002-10-06,1:03,12:03,,WAS,5,5,Sun,L 14-31,,7,46,7,46,14,92
4472,TEN,2002,2002-10-27,1:02,1:02,@,CIN,8,7,Sun,W 30-24,,7,40,9,81,16,121
4473,TEN,2004,2004-09-11,1:07,1:07,@,MIA,1,1,Sat,W 17-7,,7,55,13,71,20,126
4474,TEN,2004,2004-10-31,1:03,12:03,,CIN,8,8,Sun,W 27-20,,7,58,10,64,17,122
4475,TEN,2004,2005-01-02,1:03,12:03,,DET,17,16,Sun,W 24-19,,7,50,6,52,13,102
4476,TEN,2005,2005-09-11,1:05,1:05,@,PIT,1,1,Sun,L 7-34,,7,49,3,27,10,76
4477,TEN,2005,2005-10-09,1:02,12:02,@,HOU,5,5,Sun,W 34-20,,7,65,6,39,13,104
4478,TEN,2005,2005-12-04,1:02,1:02,@,IND,13,12,Sun,L 3-35,,7,35,5,33,12,68
4479,TEN,2007,2007-10-28,1:02,12:02,,OAK,8,7,Sun,W 13-9,,7,62,14,100,21,162
4480,TEN,2007,2007-12-02,1:02,12:02,,HOU,13,12,Sun,W 28-20,,7,44,5,36,12,80
4481,TEN,2008,2008-12-14,1:05,12:05,@,HOU,15,14,Sun,L 12-13,,7,64,11,127,18,191
4482,TEN,2010,2011-01-02,4:16,4:16,@,IND,17,16,Sun,L 20-23,,7,58,5,25,12,83
4483,TEN,2011,2011-09-11,1:05,1:05,@,JAX,1,1,Sun,L 14-16,,7,60,5,39,12,99
4484,TEN,2011,2011-11-06,4:05,3:05,,CIN,9,8,Sun,L 17-24,,7,100,9,87,16,187
4485,TEN,2011,2011-12-18,1:03,1:03,@,IND,15,14,Sun,L 13-27,,7,70,4,25,11,95
4486,TEN,2012,2012-09-30,1:03,12:03,@,HOU,4,4,Sun,L 14-38,,7,73,1,3,8,76
4487,TEN,2013,2013-10-13,4:06,1:06,@,SEA,6,6,Sun,L 13-20,,7,44,6,65,13,109
4488,TEN,2013,2013-12-29,1:02,12:02,,HOU,17,16,Sun,W 16-10,,7,76,5,55,12,131
4489,TEN,2014,2014-10-05,1:02,12:02,,CLE,5,5,Sun,L 28-29,,7,68,7,74,14,142
4490,TEN,2014,2014-11-23,1:02,1:02,@,PHI,12,11,Sun,L 24-43,,7,56,9,69,16,125
4491,TEN,2014,2014-12-18,8:26,8:26,@,JAX,16,15,Thu,L 13-21,,7,47,3,25,10,72
4492,TEN,2015,2015-10-18,1:03,12:03,,MIA,6,5,Sun,L 10-38,,7,50,9,97,16,147
4493,TEN,2016,2016-10-16,1:02,12:02,,CLE,6,6,Sun,W 28-26,,7,96,11,69,18,165
4494,TEN,2016,2016-10-27,8:26,7:26,,JAX,8,8,Thu,W 36-22,,7,54,7,75,14,129
4495,TEN,2016,2016-11-13,1:00,12:00,,GNB,10,10,Sun,W 47-25,,7,65,12,107,19,172
4496,TEN,2016,2017-01-01,1:00,12:00,,HOU,17,16,Sun,W 24-17,,7,50,6,35,13,85
4497,TEN,2017,2017-09-17,1:00,1:00,@,JAX,2,2,Sun,W 37-16,,7,70,10,99,17,169
4498,TEN,2017,2017-12-03,1:00,12:00,,HOU,13,12,Sun,W 24-13,,7,63,11,85,18,148
4499,TEN,2018,2018-11-26,8:15,7:15,@,HOU,12,11,Mon,L 17-34,,7,50,3,53,10,103
4500,TEN,2019,2019-10-20,4:05,3:05,,LAC,7,7,Sun,W 23-20,,7,54,4,29,11,83
4501,TEN,2020,2020-10-18,1:00,12:00,,HOU,6,5,Sun,W 42-36,OT,7,73,4,46,11,119
4502,TEN,2020,2020-10-25,1:00,12:00,,PIT,7,6,Sun,L 24-27,,7,73,8,69,15,142
4503,TEN,2020,2020-11-01,1:00,1:00,@,CIN,8,7,Sun,L 20-31,,7,68,7,45,14,113
4504,TEN,2020,2020-12-13,1:00,1:00,@,JAX,14,13,Sun,W 31-10,,7,78,10,80,17,158
4505,TEN,2021,2021-09-12,1:00,12:00,,ARI,1,1,Sun,L 13-38,,7,57,8,59,15,116
4506,TEN,2021,2021-10-10,1:00,1:00,@,JAX,5,5,Sun,W 37-19,,7,44,4,33,11,77
4507,TEN,2021,2021-10-18,8:15,7:15,,BUF,6,6,Mon,W 34-31,,7,91,8,60,15,151
4508,TEN,2021,2021-12-19,1:00,1:00,@,PIT,15,14,Sun,L 13-19,,7,68,5,30,12,98
4509,PHI,2000,2000-11-05,1:03,1:03,,DAL,10,10,Sun,W 16-13,OT,7,91,12,97,19,188
4510,PHI,2001,2001-10-22,9:09,9:09,@,NYG,6,5,Mon,W 10-9,,7,35,3,31,10,66
4511,PHI,2001,2001-11-25,1:03,1:03,,WAS,11,10,Sun,L 3-13,,7,52,5,41,12,93
4512,PHI,2003,2003-09-14,4:15,4:15,,NWE,2,2,Sun,L 10-31,,7,53,8,84,15,137
4513,PHI,2003,2003-09-28,1:02,1:02,@,BUF,4,3,Sun,W 23-13,,7,45,10,84,17,129
4514,PHI,2003,2003-10-05,4:15,4:15,,WAS,5,4,Sun,W 27-25,,7,86,11,85,18,171
4515,PHI,2003,2003-11-16,1:01,1:01,,NYG,11,10,Sun,W 28-10,,7,49,11,113,18,162
4516,PHI,2003,2003-12-27,8:36,8:36,@,WAS,17,16,Sat,W 31-7,,7,48,9,78,16,126
4517,PHI,2004,2004-09-26,1:03,1:03,@,DET,3,3,Sun,W 30-13,,7,54,6,39,13,93
4518,PHI,2004,2005-01-02,1:05,1:05,,CIN,17,16,Sun,L 10-38,,7,50,4,35,11,85
4519,PHI,2005,2005-11-20,1:04,1:04,@,NYG,11,10,Sun,L 17-27,,7,105,6,58,13,163
4520,PHI,2005,2005-11-27,4:16,4:16,,GNB,12,11,Sun,W 19-14,,7,50,7,40,14,90
4521,PHI,2006,2006-10-22,1:02,1:02,@,TAM,7,7,Sun,L 21-23,,7,65,2,15,9,80
4522,PHI,2006,2006-11-12,1:02,1:02,,WAS,10,9,Sun,W 27-3,,7,65,8,58,15,123
4523,PHI,2007,2007-12-09,1:02,1:02,,NYG,14,13,Sun,L 13-16,,7,41,3,15,10,56
4524,PHI,2008,2008-09-21,4:14,4:14,,PIT,3,3,Sun,W 15-6,,7,62,7,35,14,97
4525,PHI,2008,2008-10-26,1:02,1:02,,ATL,8,7,Sun,W 27-14,,7,70,6,51,13,121
4526,PHI,2008,2008-11-23,1:02,1:02,@,BAL,12,11,Sun,L 7-36,,7,64,5,30,12,94
4527,PHI,2009,2009-09-20,1:04,1:04,,NOR,2,2,Sun,L 22-48,,7,45,3,13,10,58
4528,PHI,2009,2009-11-29,1:03,1:03,,WAS,12,11,Sun,W 27-24,,7,60,7,39,14,99
4529,PHI,2010,2010-09-26,4:05,4:05,@,JAX,3,3,Sun,W 28-3,,7,84,4,67,11,151
4530,PHI,2011,2011-09-25,1:03,1:03,,NYG,3,3,Sun,L 16-29,,7,36,4,21,11,57
4531,PHI,2011,2011-12-11,1:03,1:03,@,MIA,14,13,Sun,W 26-10,,7,69,7,81,14,150
4532,PHI,2011,2011-12-18,4:16,4:16,,NYJ,15,14,Sun,W 45-19,,7,62,11,93,18,155
4533,PHI,2012,2012-09-16,1:03,1:03,,BAL,2,2,Sun,W 24-23,,7,58,6,45,13,103
4534,PHI,2012,2012-11-05,8:40,7:40,@,NOR,9,8,Mon,L 13-28,,7,58,4,35,11,93
4535,PHI,2013,2013-11-03,4:05,1:05,@,OAK,9,9,Sun,W 49-20,,7,52,8,70,15,122
4536,PHI,2014,2014-11-02,1:03,12:03,@,HOU,9,8,Sun,W 31-21,,7,55,9,54,16,109
4537,PHI,2015,2015-10-25,8:31,8:31,@,CAR,7,7,Sun,L 16-27,,7,46,5,43,12,89
4538,PHI,2015,2015-11-15,1:05,1:05,,MIA,10,9,Sun,L 19-20,,7,54,8,84,15,138
4539,PHI,2016,2016-09-11,1:05,1:05,,CLE,1,1,Sun,W 29-10,,7,46,4,15,11,61
4540,PHI,2016,2016-10-23,1:02,1:02,,MIN,7,6,Sun,W 21-10,,7,53,7,56,14,109
4541,PHI,2016,2016-11-28,8:30,8:30,,GNB,12,11,Mon,L 13-27,,7,42,7,51,14,93
4542,PHI,2017,2017-12-03,8:30,5:30,@,SEA,13,12,Sun,L 10-24,,7,64,5,46,12,110
4543,PHI,2017,2017-12-17,1:00,1:00,@,NYG,15,14,Sun,W 34-29,,7,44,5,67,12,111
4544,PHI,2017,2017-12-31,1:00,1:00,,DAL,17,16,Sun,L 0-6,,7,49,7,64,14,113
4545,PHI,2018,2018-11-25,1:00,1:00,,NYG,12,11,Sun,W 25-22,,7,46,11,91,18,137
4546,PHI,2019,2019-09-15,8:20,8:20,@,ATL,2,2,Sun,L 20-24,,7,60,10,58,17,118
4547,PHI,2019,2019-10-13,1:00,3:00,@,MIN,6,6,Sun,L 20-38,,7,49,4,30,11,79
4548,PHI,2019,2019-11-17,4:25,4:25,,NWE,11,10,Sun,L 10-17,,7,39,6,89,13,128
4549,PHI,2019,2019-12-15,1:00,1:00,@,WAS,15,14,Sun,W 37-27,,7,54,5,60,12,114
4550,PHI,2019,2019-12-29,4:25,4:25,@,NYG,17,16,Sun,W 34-17,,7,55,4,48,11,103
4551,PHI,2020,2020-10-22,8:20,8:20,,NYG,7,7,Thu,W 22-21,,7,75,9,62,16,137
4552,PHI,2021,2021-11-14,4:25,2:25,@,DEN,10,10,Sun,W 30-13,,7,89,4,29,11,118
4553,PIT,2000,2000-10-01,1:03,1:03,@,JAX,5,4,Sun,W 24-13,,7,55,10,75,17,130
4554,PIT,2000,2000-10-08,1:01,1:01,@,NYJ,6,5,Sun,W 20-3,,7,57,6,45,13,102
4555,PIT,2001,2001-12-16,8:35,8:35,@,BAL,14,13,Sun,W 26-21,,7,70,3,35,10,105
4556,PIT,2001,2001-12-30,1:02,1:02,@,CIN,16,15,Sun,L 23-26,OT,7,38,7,65,14,103
4557,PIT,2001,2002-01-06,1:01,1:01,,CLE,17,16,Sun,W 28-7,,7,42,6,70,13,112
4558,PIT,2002,2002-09-29,1:01,1:01,,CLE,4,3,Sun,W 16-13,OT,7,45,7,50,14,95
4559,PIT,2002,2002-10-06,1:02,12:02,@,NOR,5,4,Sun,L 29-32,,7,80,6,35,13,115
4560,PIT,2002,2002-10-13,1:02,1:02,@,CIN,6,5,Sun,W 34-7,,7,50,4,30,11,80
4561,PIT,2002,2002-10-27,1:02,1:02,@,BAL,8,7,Sun,W 31-18,,7,51,13,100,20,151
4562,PIT,2003,2003-11-30,1:01,1:01,,CIN,13,12,Sun,L 20-24,,7,70,6,55,13,125
4563,PIT,2004,2004-10-03,1:01,1:01,,CIN,4,4,Sun,W 28-17,,7,90,5,46,12,136
4564,PIT,2004,2005-01-02,1:02,1:02,@,BUF,17,16,Sun,W 29-24,,7,40,12,108,19,148
4565,PIT,2005,2005-10-16,1:02,1:02,,JAX,6,5,Sun,L 17-23,OT,7,80,10,106,17,186
4566,PIT,2005,2005-12-04,1:02,1:02,,CIN,13,12,Sun,L 31-38,,7,70,4,30,11,100
4567,PIT,2005,2005-12-11,1:02,1:02,,CHI,14,13,Sun,W 21-9,,7,55,1,5,8,60
4568,PIT,2006,2006-12-31,1:03,1:03,@,CIN,17,16,Sun,W 23-17,OT,7,101,6,40,13,141
4569,PIT,2007,2007-12-02,8:24,8:24,,CIN,13,12,Sun,W 24-10,,7,37,8,45,15,82
4570,PIT,2008,2008-09-14,8:23,8:23,@,CLE,2,2,Sun,W 10-6,,7,60,10,65,17,125
4571,PIT,2008,2008-09-21,4:14,4:14,@,PHI,3,3,Sun,L 6-15,,7,35,7,62,14,97
4572,PIT,2010,2010-11-08,8:40,8:40,@,CIN,9,8,Mon,W 27-21,,7,73,3,30,10,103
4573,PIT,2011,2011-12-24,1:02,1:02,,STL,16,15,Sat,W 27-0,,7,50,4,21,11,71
4574,PIT,2013,2013-10-13,1:03,1:03,@,NYJ,6,5,Sun,W 19-6,,7,49,5,60,12,109
4575,PIT,2013,2013-10-20,4:25,4:25,,BAL,7,6,Sun,W 19-16,,7,50,9,67,16,117
4576,PIT,2013,2013-12-22,4:25,3:25,@,GNB,16,15,Sun,W 38-31,,7,58,9,90,16,148
4577,PIT,2014,2014-10-05,1:02,1:02,@,JAX,5,5,Sun,W 17-9,,7,50,4,34,11,84
4578,PIT,2014,2014-11-02,8:30,8:30,,BAL,9,9,Sun,W 43-23,,7,67,10,108,17,175
4579,PIT,2015,2015-09-20,1:02,1:02,,SFO,2,2,Sun,W 43-18,,7,58,7,46,14,104
4580,PIT,2016,2016-09-25,4:25,4:25,@,PHI,3,3,Sun,L 3-34,,7,77,10,99,17,176
4581,PIT,2016,2016-11-24,8:30,8:30,@,IND,12,11,Thu,W 28-7,,7,67,2,10,9,77
4582,PIT,2016,2016-12-18,1:00,1:00,@,CIN,15,14,Sun,W 24-20,,7,104,8,86,15,190
4583,PIT,2017,2017-11-16,8:25,8:25,,TEN,11,10,Thu,W 40-17,,7,61,9,65,16,126
4584,PIT,2017,2017-12-04,8:30,8:30,@,CIN,13,12,Mon,W 23-20,,7,66,13,173,20,239
4585,PIT,2018,2018-10-07,1:00,1:00,,ATL,5,5,Sun,W 41-17,,7,58,7,75,14,133
4586,PIT,2018,2018-12-02,8:20,1:00,,LAC,13,12,Sun,L 30-33,,7,59,5,80,12,139
4587,PIT,2021,2021-11-14,1:00,1:00,,DET,10,9,Sun,T 16-16,OT,7,59,8,84,15,143
4588,OAK,2000,2000-12-10,8:35,5:35,,NYJ,15,14,Sun,W 31-7,,7,60,6,27,13,87
4589,OAK,2000,2000-12-16,4:06,1:06,@,SEA,16,15,Sat,L 24-27,,7,45,5,55,12,100
4590,OAK,2000,2000-12-24,4:15,1:15,,CAR,17,16,Sun,W 52-9,,7,60,5,70,12,130
4591,OAK,2001,2001-10-28,4:15,4:15,@,PHI,7,6,Sun,W 20-10,,7,65,5,31,12,96
4592,OAK,2002,2002-09-15,8:35,8:35,@,PIT,2,2,Sun,W 30-17,,7,69,6,57,13,126
4593,OAK,2003,2003-09-28,4:05,1:05,,SDG,4,4,Sun,W 34-31,OT,7,57,9,111,16,168
4594,OAK,2003,2003-11-16,4:15,1:15,,MIN,11,10,Sun,W 28-18,,7,85,10,60,17,145
4595,OAK,2003,2003-11-23,4:15,3:15,@,KAN,12,11,Sun,L 24-27,,7,65,2,20,9,85
4596,OAK,2005,2005-09-18,8:30,5:30,,KAN,2,2,Sun,L 17-23,,7,84,9,78,16,162
4597,OAK,2005,2005-10-30,1:02,12:02,@,TEN,8,7,Sun,W 34-25,,7,55,9,79,16,134
4598,OAK,2005,2005-12-18,4:05,1:05,,CLE,15,14,Sun,L 7-9,,7,45,1,15,8,60
4599,OAK,2006,2006-09-11,10:25,7:25,,SDG,1,1,Mon,L 0-27,,7,54,3,25,10,79
4600,OAK,2006,2006-12-03,4:05,1:05,,HOU,13,12,Sun,L 14-23,,7,60,5,46,12,106
4601,OAK,2007,2007-09-23,4:05,1:05,,CLE,3,3,Sun,W 26-24,,7,55,9,64,16,119
4602,OAK,2007,2007-11-25,1:00,12:00,@,KAN,12,11,Sun,W 20-17,,7,58,7,48,14,106
4603,OAK,2008,2008-11-02,4:15,1:15,,ATL,9,8,Sun,L 0-24,,7,55,4,40,11,95
4604,OAK,2008,2008-11-16,1:02,1:02,@,MIA,11,10,Sun,L 15-17,,7,35,3,55,10,90
4605,OAK,2008,2008-12-14,4:15,1:15,,NWE,15,14,Sun,L 26-49,,7,45,4,20,11,65
4606,OAK,2009,2009-09-20,1:00,12:00,@,KAN,2,2,Sun,W 13-10,,7,45,9,70,16,115
4607,OAK,2009,2009-10-11,1:02,1:02,@,NYG,5,5,Sun,L 7-44,,7,67,4,37,11,104
4608,OAK,2009,2009-11-26,4:15,3:15,@,DAL,12,11,Thu,L 7-24,,7,70,6,48,13,118
4609,OAK,2010,2010-11-21,1:02,1:02,@,PIT,11,10,Sun,L 3-35,,7,55,14,163,21,218
4610,OAK,2011,2011-09-25,4:04,1:04,,NYJ,3,3,Sun,W 34-24,,7,55,7,61,14,116
4611,OAK,2011,2011-11-10,8:29,5:29,@,SDG,10,9,Thu,W 24-17,,7,45,6,31,13,76
4612,OAK,2014,2014-11-20,8:26,8:26,,KAN,12,11,Thu,W 24-20,,7,60,7,59,14,119
4613,OAK,2015,2016-01-03,4:26,3:26,@,KAN,17,16,Sun,L 17-23,,7,59,5,55,12,114
4614,OAK,2016,2016-11-27,4:25,1:25,,CAR,12,11,Sun,W 35-32,,7,46,7,67,14,113
4615,OAK,2016,2016-12-04,4:05,1:05,,BUF,13,12,Sun,W 38-24,,7,65,8,73,15,138
4616,OAK,2017,2017-10-01,4:25,2:25,@,DEN,4,4,Sun,L 10-16,,7,75,6,40,13,115
4617,OAK,2017,2017-11-26,4:25,1:25,,DEN,12,11,Sun,W 21-14,,7,68,9,75,16,143
4618,OAK,2017,2017-12-10,1:00,12:00,@,KAN,14,13,Sun,L 15-26,,7,39,7,69,14,108
4619,OAK,2017,2017-12-25,8:30,8:30,@,PHI,16,15,Mon,L 10-19,,7,50,8,60,15,110
4620,OAK,2018,2018-10-07,4:05,1:05,@,LAC,5,5,Sun,L 10-26,,7,55,9,82,16,137
4621,OAK,2019,2019-09-15,4:05,1:05,,KAN,2,2,Sun,L 10-28,,7,52,10,114,17,166
4622,OAK,2019,2019-09-22,1:00,3:00,@,MIN,3,3,Sun,L 14-34,,7,84,6,59,13,143
4623,OAK,2019,2019-11-17,4:25,1:25,,CIN,11,10,Sun,W 17-10,,7,42,4,40,11,82
4624,LVR,2020,2020-10-04,4:25,1:25,,BUF,4,4,Sun,L 23-30,,7,65,5,81,12,146
4625,LVR,2021,2021-10-24,4:05,1:05,,PHI,7,7,Sun,W 33-22,,7,65,4,37,11,102
4626,LVR,2021,2021-11-21,4:05,1:05,,CIN,11,10,Sun,L 13-32,,7,77,1,5,8,82
4627,LVR,2021,2021-12-20,5:00,5:00,@,CLE,15,14,Mon,W 16-14,,7,64,3,61,10,125
4628,STL,2000,2000-11-05,8:35,7:35,,CAR,10,9,Sun,L 24-27,,7,52,5,40,12,92
4629,STL,2000,2000-12-10,4:15,3:15,,MIN,15,14,Sun,W 40-29,,7,43,7,60,14,103
4630,STL,2001,2001-09-09,4:16,4:16,@,PHI,1,1,Sun,W 20-17,OT,7,45,2,20,9,65
4631,STL,2001,2001-11-11,1:02,12:02,,CAR,9,8,Sun,W 48-14,,7,48,4,38,11,86
4632,STL,2001,2001-12-09,1:02,12:02,,SFO,13,12,Sun,W 27-14,,7,48,5,30,12,78
4633,STL,2002,2002-12-15,8:35,7:35,,ARI,15,14,Sun,W 30-28,,7,43,8,75,15,118
4634,STL,2003,2003-11-02,4:17,1:17,@,SFO,9,8,Sun,L 10-30,,7,50,7,39,14,89
4635,STL,2003,2003-11-09,8:38,7:38,,BAL,10,9,Sun,W 33-22,,7,75,10,80,17,155
4636,STL,2003,2003-11-16,1:03,12:03,@,CHI,11,10,Sun,W 23-21,,7,45,6,47,13,92
4637,STL,2003,2003-12-14,1:02,12:02,,SEA,15,14,Sun,W 27-22,,7,50,9,64,16,114
4638,STL,2003,2003-12-28,1:03,1:03,@,DET,17,16,Sun,L 20-30,,7,35,6,50,13,85
4639,STL,2004,2004-09-12,1:04,12:04,,ARI,1,1,Sun,W 17-10,,7,55,8,59,15,114
4640,STL,2004,2004-10-18,9:09,8:09,,TAM,6,6,Mon,W 28-21,,7,50,3,12,10,62
4641,STL,2004,2004-10-24,1:02,1:02,@,MIA,7,7,Sun,L 14-31,,7,63,4,37,11,100
4642,STL,2004,2004-11-14,1:02,12:02,,SEA,10,9,Sun,W 23-12,,7,55,4,20,11,75
4643,STL,2004,2004-11-29,9:09,8:09,@,GNB,12,11,Mon,L 17-45,,7,50,7,55,14,105
4644,STL,2004,2004-12-27,9:09,8:09,,PHI,16,15,Mon,W 20-7,,7,55,13,95,20,150
4645,STL,2005,2005-09-11,4:15,1:15,@,SFO,1,1,Sun,L 25-28,,7,48,5,30,12,78
4646,STL,2005,2005-10-09,1:02,12:02,,SEA,5,5,Sun,L 31-37,,7,74,7,50,14,124
4647,STL,2005,2006-01-01,8:36,7:36,@,DAL,17,16,Sun,W 20-10,,7,40,10,78,17,118
4648,STL,2006,2006-11-12,4:17,1:17,@,SEA,10,9,Sun,L 22-24,,7,58,3,16,10,74
4649,STL,2007,2007-09-30,1:02,12:02,@,DAL,4,4,Sun,L 7-35,,7,50,2,10,9,60
4650,STL,2007,2007-10-14,1:02,1:02,@,BAL,6,6,Sun,L 3-22,,7,63,6,40,13,103
4651,STL,2007,2007-12-30,4:15,2:15,@,ARI,17,16,Sun,L 19-48,,7,50,8,63,15,113
4652,STL,2008,2008-09-21,4:06,1:06,@,SEA,3,3,Sun,L 13-37,,7,51,5,55,12,106
4653,STL,2008,2008-12-21,1:00,12:00,,SFO,16,15,Sun,L 16-17,,7,45,5,32,12,77
4654,STL,2009,2009-10-11,1:00,12:00,,MIN,5,5,Sun,L 10-38,,7,82,5,44,12,126
4655,STL,2009,2009-11-22,4:05,3:05,,ARI,11,10,Sun,L 13-21,,7,50,6,40,13,90
4656,STL,2009,2010-01-03,1:00,12:00,,SFO,17,16,Sun,L 6-28,,7,50,6,40,13,90
4657,STL,2010,2010-10-10,12:56,12:56,@,DET,5,5,Sun,L 6-44,,7,40,11,78,18,118
4658,STL,2010,2010-10-31,1:00,12:00,,CAR,8,8,Sun,W 20-10,,7,65,6,30,13,95
4659,STL,2010,2010-11-21,4:05,3:05,,ATL,11,10,Sun,L 17-34,,7,54,3,30,10,84
4660,STL,2011,2011-09-19,8:40,8:40,@,NYG,2,2,Mon,L 16-28,,7,62,5,55,12,117
4661,STL,2011,2011-10-16,1:02,12:02,@,GNB,6,5,Sun,L 3-24,,7,45,3,16,10,61
4662,STL,2011,2011-11-13,1:03,1:03,@,CLE,10,9,Sun,W 13-12,,7,55,6,60,13,115
4663,STL,2012,2012-09-09,1:03,1:03,@,DET,1,1,Sun,L 23-27,,7,65,3,27,10,92
4664,STL,2012,2012-09-16,4:05,3:05,,WAS,2,2,Sun,W 31-28,,7,60,11,96,18,156
4665,STL,2012,2012-10-04,8:20,7:20,,ARI,5,5,Thu,W 17-3,,7,60,5,35,12,95
4666,STL,2013,2013-09-08,4:23,3:23,,ARI,1,1,Sun,W 27-24,,7,59,6,68,13,127
4667,STL,2013,2013-09-15,1:03,1:03,@,ATL,2,2,Sun,L 24-31,,7,53,7,53,14,106
4668,STL,2013,2013-12-22,1:00,12:00,,TAM,16,15,Sun,W 23-13,,7,85,3,26,10,111
4669,STL,2015,2015-09-27,1:00,12:00,,PIT,3,3,Sun,L 6-12,,7,97,4,63,11,160
4670,STL,2015,2015-10-04,4:25,1:25,@,ARI,4,4,Sun,W 24-22,,7,66,3,20,10,86
4671,STL,2015,2015-11-29,1:02,1:02,@,CIN,12,11,Sun,L 7-31,,7,45,3,35,10,80
4672,STL,2015,2015-12-06,1:00,12:00,,ARI,13,12,Sun,L 3-27,,7,104,3,25,10,129
4673,LAR,2016,2016-11-13,1:00,1:00,@,NYJ,10,9,Sun,W 9-6,,7,55,4,31,11,86
4674,LAR,2017,2017-09-10,4:05,1:05,,IND,1,1,Sun,W 46-9,,7,50,4,20,11,70
4675,LAR,2017,2017-09-17,4:25,1:25,,WAS,2,2,Sun,L 20-27,,7,75,4,25,11,100
4676,LAR,2017,2017-09-21,8:25,5:25,@,SFO,3,3,Thu,W 41-39,,7,52,10,55,17,107
4677,LAR,2017,2017-10-01,1:00,12:00,@,DAL,4,4,Sun,W 35-30,,7,41,4,45,11,86
4678,LAR,2017,2017-10-15,4:05,4:05,@,JAX,6,6,Sun,W 27-17,,7,70,5,40,12,110
4679,LAR,2017,2017-12-03,4:25,2:25,@,ARI,13,12,Sun,W 32-16,,7,36,4,25,11,61
4680,LAR,2017,2017-12-10,4:25,1:25,,PHI,14,13,Sun,L 35-43,,7,102,10,67,17,169
4681,LAR,2018,2018-10-07,4:25,1:25,@,SEA,5,5,Sun,W 33-31,,7,45,7,50,14,95
4682,LAR,2018,2018-12-02,1:00,1:00,@,DET,13,12,Sun,W 30-16,,7,105,8,54,15,159
4683,LAR,2019,2019-09-22,8:20,8:20,@,CLE,3,3,Sun,W 20-13,,7,49,8,60,15,109
4684,LAR,2019,2019-12-21,8:15,5:15,@,SFO,16,15,Sat,L 31-34,,7,43,3,26,10,69
4685,LAR,2021,2021-10-17,1:00,1:00,@,NYG,6,6,Sun,W 38-11,,7,50,5,27,12,77
4686,LAR,2021,2021-12-05,4:25,1:25,,JAX,13,12,Sun,W 37-7,,7,47,3,39,10,86
4687,BAL,2000,2000-10-15,1:01,1:01,@,WAS,7,7,Sun,L 3-10,,7,41,6,51,13,92
4688,BAL,2001,2001-09-23,1:11,1:11,@,CIN,2,2,Sun,L 10-21,,7,45,8,46,15,91
4689,BAL,2001,2001-09-30,4:15,2:15,@,DEN,3,3,Sun,W 20-13,,7,74,4,52,11,126
4690,BAL,2001,2001-11-18,1:01,1:01,,CLE,10,10,Sun,L 17-27,,7,47,7,50,14,97
4691,BAL,2002,2002-10-06,8:36,8:36,@,CLE,5,4,Sun,W 26-21,,7,65,9,117,16,182
4692,BAL,2002,2002-11-03,1:05,1:05,@,ATL,9,8,Sun,L 17-20,,7,62,4,33,11,95
4693,BAL,2002,2002-11-17,4:16,4:16,@,MIA,11,10,Sun,L 7-26,,7,50,3,34,10,84
4694,BAL,2003,2003-11-02,1:02,1:02,,JAX,9,8,Sun,W 24-17,,7,40,7,52,14,92
4695,BAL,2004,2004-12-19,8:36,8:36,@,IND,15,14,Sun,L 10-20,,7,35,5,28,12,63
4696,BAL,2005,2005-11-06,1:02,1:02,,CIN,9,8,Sun,L 9-21,,7,40,5,54,12,94
4697,BAL,2005,2005-12-19,9:07,9:07,,GNB,15,14,Mon,W 48-3,,7,71,10,94,17,165
4698,BAL,2005,2005-12-25,8:36,8:36,,MIN,16,15,Sun,W 30-23,,7,35,6,50,13,85
4699,BAL,2006,2006-11-19,1:02,1:02,,ATL,11,10,Sun,W 24-10,,7,56,4,47,11,103
4700,BAL,2007,2007-09-30,1:02,1:02,@,CLE,4,4,Sun,L 13-27,,7,41,6,41,13,82
4701,BAL,2007,2007-10-07,4:15,1:15,@,SFO,5,5,Sun,W 9-7,,7,40,4,48,11,88
4702,BAL,2008,2008-10-19,1:02,1:02,@,MIA,7,6,Sun,W 27-13,,7,67,6,28,13,95
4703,BAL,2008,2008-11-02,1:02,1:02,@,CLE,9,8,Sun,W 37-27,,7,42,8,37,15,79
4704,BAL,2008,2008-11-09,1:02,12:02,@,HOU,10,9,Sun,W 41-13,,7,55,10,76,17,131
4705,BAL,2008,2008-12-28,4:16,4:16,,JAX,17,16,Sun,W 27-7,,7,55,7,28,14,83
4706,BAL,2009,2009-11-08,1:02,1:02,@,CIN,9,8,Sun,L 7-17,,7,80,6,40,13,120
4707,BAL,2009,2009-11-16,8:40,8:40,@,CLE,10,9,Mon,W 16-0,,7,43,6,52,13,95
4708,BAL,2010,2010-10-03,1:02,1:02,@,PIT,4,4,Sun,W 17-14,,7,52,11,88,18,140
4709,BAL,2010,2011-01-02,1:02,1:02,,CIN,17,16,Sun,W 13-7,,7,45,4,49,11,94
4710,BAL,2011,2011-09-11,1:05,1:05,,PIT,1,1,Sun,W 35-7,,7,75,6,53,13,128
4711,BAL,2011,2011-09-18,1:02,12:02,@,TEN,2,2,Sun,L 13-26,,7,44,6,70,13,114
4712,BAL,2011,2011-10-02,8:30,8:30,,NYJ,4,4,Sun,W 34-17,,7,46,9,69,16,115
4713,BAL,2011,2012-01-01,4:16,4:16,@,CIN,17,16,Sun,W 24-16,,7,59,4,35,11,94
4714,BAL,2013,2013-09-05,9:13,7:13,@,DEN,1,1,Thu,L 27-49,,7,53,8,61,15,114
4715,BAL,2013,2013-12-16,8:40,8:40,@,DET,15,14,Mon,W 18-16,,7,60,8,89,15,149
4716,BAL,2014,2014-10-26,1:02,1:02,@,CIN,8,8,Sun,L 24-27,,7,51,6,40,13,91
4717,BAL,2014,2014-12-07,1:02,1:02,@,MIA,14,13,Sun,W 28-13,,7,36,6,30,13,66
4718,BAL,2014,2014-12-21,1:02,12:02,@,HOU,16,15,Sun,L 13-25,,7,56,7,69,14,125
4719,BAL,2015,2015-11-30,8:30,8:30,@,CLE,12,11,Mon,W 33-27,,7,50,2,15,9,65
4720,BAL,2015,2015-12-20,1:02,1:02,,KAN,15,14,Sun,L 14-34,,7,63,6,55,13,118
4721,BAL,2016,2016-12-04,1:00,1:00,,MIA,13,12,Sun,W 38-6,,7,68,7,57,14,125
4722,BAL,2016,2016-12-18,1:00,1:00,,PHI,15,14,Sun,W 27-26,,7,62,3,30,10,92
4723,BAL,2016,2016-12-25,4:30,4:30,@,PIT,16,15,Sun,L 27-31,,7,95,4,45,11,140
4724,BAL,2017,2017-09-17,1:00,1:00,,CLE,2,2,Sun,W 24-10,,7,45,11,65,18,110
4725,BAL,2017,2017-11-27,8:30,8:30,,HOU,12,11,Mon,W 23-16,,7,89,6,36,13,125
4726,BAL,2017,2017-12-17,1:00,1:00,@,CLE,15,14,Sun,W 27-10,,7,57,6,35,13,92
4727,BAL,2018,2018-09-13,8:20,8:20,@,CIN,2,2,Thu,L 23-34,,7,51,9,92,16,143
4728,BAL,2018,2018-09-23,1:00,1:00,,DEN,3,3,Sun,W 27-14,,7,52,13,120,20,172
4729,BAL,2018,2018-09-30,8:20,8:20,@,PIT,4,4,Sun,W 26-14,,7,50,5,40,12,90
4730,BAL,2019,2019-09-22,1:00,12:00,@,KAN,3,3,Sun,L 28-33,,7,60,4,31,11,91
4731,BAL,2019,2019-12-22,1:00,1:00,@,CLE,16,15,Sun,W 31-15,,7,50,7,62,14,112
4732,BAL,2020,2020-09-13,1:00,1:00,,CLE,1,1,Sun,W 38-6,,7,66,8,80,15,146
4733,BAL,2020,2020-12-02,3:40,3:40,@,PIT,12,11,Wed,L 14-19,,7,86,5,40,12,126
4734,SDG,2000,2000-09-10,4:15,1:15,,NOR,2,2,Sun,L 27-28,,7,85,6,37,13,122
4735,SDG,2001,2001-10-28,1:15,1:15,,BUF,7,7,Sun,W 27-24,,7,62,9,68,16,130
4736,SDG,2001,2001-12-02,4:05,1:05,@,SEA,12,12,Sun,L 10-13,OT,7,46,3,24,10,70
4737,SDG,2001,2001-12-09,1:03,1:03,@,PHI,13,13,Sun,L 14-24,,7,67,4,30,11,97
4738,SDG,2001,2001-12-23,1:00,12:00,@,KAN,15,15,Sun,L 17-20,,7,47,2,10,9,57
4739,SDG,2003,2003-11-23,4:15,1:15,,CIN,12,11,Sun,L 27-34,,7,69,6,80,13,149
4740,SDG,2003,2003-12-28,4:15,1:15,,OAK,17,16,Sun,W 21-14,,7,50,5,38,12,88
4741,SDG,2004,2004-10-03,4:15,1:15,,TEN,4,4,Sun,W 38-17,,7,41,4,25,11,66
4742,SDG,2004,2004-10-24,1:02,1:02,@,CAR,7,7,Sun,W 17-6,,7,83,8,94,15,177
4743,SDG,2004,2004-10-31,4:15,1:15,,OAK,8,8,Sun,W 42-14,,7,46,10,75,17,121
4744,SDG,2004,2004-12-26,1:00,1:00,@,IND,16,15,Sun,L 31-34,OT,7,63,10,70,17,133
4745,SDG,2004,2005-01-02,4:15,1:15,,KAN,17,16,Sun,W 24-17,,7,50,5,45,12,95
4746,SDG,2005,2005-09-18,4:15,2:15,@,DEN,2,2,Sun,L 17-20,,7,42,5,45,12,87
4747,SDG,2005,2005-09-25,8:30,5:30,,NYG,3,3,Sun,W 45-23,,7,50,12,83,19,133
4748,SDG,2005,2005-10-02,1:02,1:02,@,NWE,4,4,Sun,W 41-17,,7,50,4,62,11,112
4749,SDG,2005,2005-12-11,4:15,1:15,,MIA,14,13,Sun,L 21-23,,7,49,3,12,10,61
4750,SDG,2005,2005-12-24,1:00,12:00,@,KAN,16,15,Sat,L 7-20,,7,58,7,48,14,106
4751,SDG,2006,2006-09-17,4:15,1:15,,TEN,2,2,Sun,W 40-7,,7,53,6,55,13,108
4752,SDG,2006,2006-10-22,1:00,12:00,@,KAN,7,6,Sun,L 27-30,,7,60,6,50,13,110
4753,SDG,2006,2006-12-17,8:15,5:15,,KAN,15,14,Sun,W 20-9,,7,61,3,23,10,84
4754,SDG,2007,2007-09-16,8:24,8:24,@,NWE,2,2,Sun,L 14-38,,7,75,6,67,13,142
4755,SDG,2010,2010-10-10,4:15,1:15,@,OAK,5,5,Sun,L 27-35,,7,53,12,85,19,138
4756,SDG,2012,2012-09-30,1:03,12:03,@,KAN,4,4,Sun,W 37-20,,7,75,9,80,16,155
4757,SDG,2012,2012-10-07,8:31,7:31,@,NOR,5,5,Sun,L 24-31,,7,56,10,99,17,155
4758,SDG,2013,2013-09-09,10:25,7:25,,HOU,1,1,Mon,L 28-31,,7,55,7,73,14,128
4759,SDG,2013,2013-09-29,4:25,1:25,,DAL,4,4,Sun,W 30-21,,7,85,5,33,12,118
4760,SDG,2013,2013-11-03,1:03,1:03,@,WAS,9,8,Sun,L 24-30,OT,7,63,7,65,14,128
4761,SDG,2014,2014-09-28,4:05,1:05,,JAX,4,4,Sun,W 33-14,,7,57,3,32,10,89
4762,SDG,2014,2014-10-12,4:05,1:05,@,OAK,6,6,Sun,W 31-28,,7,60,11,78,18,138
4763,SDG,2014,2014-10-23,8:26,6:26,@,DEN,8,8,Thu,L 21-35,,7,77,9,71,16,148
4764,SDG,2014,2014-11-02,1:02,1:02,@,MIA,9,9,Sun,L 0-37,,7,57,3,25,10,82
4765,SDG,2015,2015-09-27,1:02,12:02,@,MIN,3,3,Sun,L 14-31,,7,74,3,39,10,113
4766,SDG,2015,2015-10-12,8:30,5:30,,PIT,5,5,Mon,L 20-24,,7,54,8,86,15,140
4767,SDG,2015,2015-12-13,1:03,12:03,@,KAN,14,13,Sun,L 3-10,,7,48,8,53,15,101
4768,SDG,2015,2015-12-20,4:25,1:25,,MIA,15,14,Sun,W 30-14,,7,48,9,72,16,120
4769,SDG,2015,2016-01-03,4:25,2:25,@,DEN,17,16,Sun,L 20-27,,7,45,6,35,13,80
4770,SDG,2016,2016-12-11,1:00,1:00,@,CAR,14,13,Sun,L 16-28,,7,32,5,35,12,67
4771,LAC,2017,2017-11-12,1:00,1:00,@,JAX,10,9,Sun,L 17-20,OT,7,77,9,106,16,183
4772,LAC,2017,2017-12-31,4:25,1:25,,OAK,17,16,Sun,W 30-10,,7,65,6,85,13,150
4773,LAC,2018,2018-09-09,4:05,1:05,,KAN,1,1,Sun,L 28-38,,7,45,6,50,13,95
4774,LAC,2018,2018-12-13,8:20,7:20,@,KAN,15,14,Thu,W 29-28,,7,50,10,66,17,116
4775,LAC,2019,2019-09-22,4:25,1:25,,HOU,3,3,Sun,L 20-27,,7,69,6,65,13,134
4776,LAC,2019,2019-12-01,4:25,2:25,@,DEN,13,12,Sun,L 20-23,,7,82,3,25,10,107
4777,LAC,2020,2020-10-04,1:00,1:00,@,TAM,4,4,Sun,L 31-38,,7,60,8,90,15,150
4778,LAC,2021,2021-11-14,4:05,1:05,,MIN,10,9,Sun,L 20-27,,7,52,10,118,17,170
4779,LAC,2021,2021-12-05,1:00,1:00,@,CIN,13,12,Sun,W 41-22,,7,51,7,63,14,114
4780,SEA,2000,2000-10-02,9:00,8:00,@,KAN,5,5,Mon,L 17-24,,7,45,12,77,19,122
4781,SEA,2001,2001-09-23,4:27,1:27,,PHI,2,2,Sun,L 3-27,,7,62,5,30,12,92
4782,SEA,2001,2001-10-07,4:05,1:05,,JAX,4,4,Sun,W 24-15,,7,60,4,24,11,84
4783,SEA,2001,2001-11-18,1:02,1:02,@,BUF,10,9,Sun,W 23-20,,7,57,4,23,11,80
4784,SEA,2002,2002-09-15,4:05,1:05,,ARI,2,2,Sun,L 13-24,,7,35,7,42,14,77
4785,SEA,2002,2002-12-15,1:03,1:03,@,ATL,15,14,Sun,W 30-24,OT,7,45,11,95,18,140
4786,SEA,2002,2002-12-29,4:15,1:15,@,SDG,17,16,Sun,W 31-28,OT,7,58,5,22,12,80
4787,SEA,2003,2003-10-05,1:02,12:02,@,GNB,5,4,Sun,L 13-35,,7,57,3,25,10,82
4788,SEA,2003,2003-12-07,1:00,12:00,@,MIN,14,13,Sun,L 7-34,,7,39,5,30,12,69
4789,SEA,2004,2004-09-19,4:05,4:05,@,TAM,2,2,Sun,W 10-6,,7,59,1,5,8,64
4790,SEA,2004,2004-11-07,4:05,1:05,@,SFO,9,8,Sun,W 42-27,,7,55,3,29,10,84
4791,SEA,2004,2004-11-28,4:16,1:16,,BUF,12,11,Sun,L 9-38,,7,64,6,44,13,108
4792,SEA,2005,2005-10-09,1:02,12:02,@,STL,5,5,Sun,W 37-31,,7,50,7,74,14,124
4793,SEA,2006,2006-09-17,4:06,1:06,,ARI,2,2,Sun,W 21-10,,7,73,11,66,18,139
4794,SEA,2006,2006-10-01,8:21,7:21,@,CHI,4,4,Sun,L 6-37,,7,59,5,60,12,119
4795,SEA,2009,2009-11-29,1:00,12:00,@,STL,12,11,Sun,W 27-17,,7,52,4,35,11,87
4796,SEA,2009,2009-12-13,1:02,12:02,@,HOU,14,13,Sun,L 7-34,,7,63,4,35,11,98
4797,SEA,2010,2010-09-19,4:06,2:06,@,DEN,2,2,Sun,L 14-31,,7,64,3,35,10,99
4798,SEA,2010,2010-10-31,4:15,1:15,@,OAK,8,7,Sun,L 3-33,,7,55,11,105,18,160
4799,SEA,2010,2011-01-02,8:31,5:31,,STL,17,16,Sun,W 16-6,,7,70,6,46,13,116
4800,SEA,2011,2012-01-01,4:15,2:15,@,ARI,17,16,Sun,L 20-23,OT,7,55,9,76,16,131
4801,SEA,2012,2012-10-07,4:04,4:04,@,CAR,5,5,Sun,W 16-12,,7,65,3,25,10,90
4802,SEA,2012,2012-11-11,4:06,1:06,,NYJ,10,10,Sun,W 28-7,,7,45,6,35,13,80
4803,SEA,2013,2013-10-06,1:03,1:03,@,IND,5,5,Sun,L 28-34,,7,85,3,35,10,120
4804,SEA,2013,2013-11-17,4:26,1:26,,MIN,11,11,Sun,W 41-20,,7,96,4,20,11,116
4805,SEA,2013,2013-12-29,4:26,1:26,,STL,17,16,Sun,W 27-9,,7,65,12,87,19,152
4806,SEA,2014,2014-09-21,4:25,1:25,,DEN,3,3,Sun,W 26-20,OT,7,34,4,27,11,61
4807,SEA,2014,2014-10-26,1:04,1:04,@,CAR,8,7,Sun,W 13-9,,7,41,4,20,11,61
4808,SEA,2014,2014-11-23,4:06,1:06,,ARI,12,11,Sun,W 19-3,,7,74,3,25,10,99
4809,SEA,2014,2014-12-14,4:26,1:26,,SFO,15,14,Sun,W 17-7,,7,50,8,78,15,128
4810,SEA,2015,2015-09-13,1:00,12:00,@,STL,1,1,Sun,L 31-34,OT,7,46,4,30,11,76
4811,SEA,2015,2015-10-18,4:06,1:06,,CAR,6,6,Sun,L 23-27,,7,48,5,25,12,73
4812,SEA,2016,2016-10-02,1:03,1:03,@,NYJ,4,4,Sun,W 27-17,,7,71,7,60,14,131
4813,SEA,2016,2016-11-20,4:25,1:25,,PHI,11,10,Sun,W 26-15,,7,48,8,48,15,96
4814,SEA,2016,2016-12-11,4:25,3:25,@,GNB,14,13,Sun,L 10-38,,7,63,5,50,12,113
4815,SEA,2017,2017-10-08,4:05,1:05,@,LAR,5,5,Sun,W 16-10,,7,40,5,45,12,85
4816,SEA,2018,2018-09-09,4:25,2:25,@,DEN,1,1,Sun,L 24-27,,7,45,7,60,14,105
4817,SEA,2018,2018-10-07,4:25,1:25,,LAR,5,5,Sun,L 31-33,,7,50,7,45,14,95
4818,SEA,2018,2018-10-28,1:00,1:00,@,DET,8,7,Sun,W 28-14,,7,111,4,32,11,143
4819,SEA,2018,2018-11-11,4:25,1:25,@,LAR,10,9,Sun,L 31-36,,7,56,10,102,17,158
4820,SEA,2019,2019-09-22,4:25,1:25,,NOR,3,3,Sun,L 27-33,,7,53,11,70,18,123
4821,SEA,2019,2019-09-29,4:05,2:05,@,ARI,4,4,Sun,W 27-10,,7,65,7,44,14,109
4822,SEA,2019,2019-12-22,4:25,1:25,,ARI,16,15,Sun,L 13-27,,7,55,5,47,12,102
4823,SEA,2021,2021-09-12,1:00,1:00,@,IND,1,1,Sun,W 28-16,,7,53,2,16,9,69
4824,SEA,2021,2021-12-26,4:05,1:05,,CHI,16,15,Sun,L 24-25,,7,88,8,73,15,161
4825,SFO,2000,2000-09-03,1:02,1:02,@,ATL,1,1,Sun,L 28-36,,7,42,4,51,11,93
4826,SFO,2000,2000-09-17,1:02,12:02,@,STL,3,3,Sun,L 24-41,,7,53,3,25,10,78
4827,SFO,2001,2001-10-01,9:10,9:10,@,NYJ,3,3,Mon,W 19-17,,7,48,1,5,8,53
4828,SFO,2003,2003-11-02,4:17,1:17,,STL,9,9,Sun,W 30-10,,7,39,7,50,14,89
4829,SFO,2003,2003-12-14,1:03,1:03,@,CIN,15,14,Sun,L 38-41,,7,50,4,40,11,90
4830,SFO,2004,2004-10-17,1:03,1:03,@,NYJ,6,6,Sun,L 14-22,,7,61,4,29,11,90
4831,SFO,2004,2004-11-14,4:15,1:15,,CAR,10,9,Sun,L 27-37,,7,60,7,49,14,109
4832,SFO,2004,2004-12-12,4:15,2:15,@,ARI,14,13,Sun,W 31-28,OT,7,70,9,61,16,131
4833,SFO,2004,2005-01-02,1:02,1:02,@,NWE,17,16,Sun,L 7-21,,7,64,4,37,11,101
4834,SFO,2005,2005-10-09,4:05,1:05,,IND,5,5,Sun,L 3-28,,7,40,10,80,17,120
4835,SFO,2005,2005-10-30,4:15,1:15,,TAM,8,7,Sun,W 15-10,,7,65,8,65,15,130
4836,SFO,2005,2005-12-11,4:06,1:06,@,SEA,14,13,Sun,L 3-41,,7,82,8,54,15,136
4837,SFO,2006,2006-12-03,1:04,12:04,@,NOR,13,12,Sun,L 10-34,,7,37,3,47,10,84
4838,SFO,2007,2007-10-28,4:17,1:17,,NOR,8,7,Sun,L 10-31,,7,66,4,25,11,91
4839,SFO,2007,2007-11-18,4:15,1:15,,STL,11,10,Sun,L 9-13,,7,39,3,20,10,59
4840,SFO,2007,2007-12-02,1:03,1:03,@,CAR,13,12,Sun,L 14-31,,7,55,7,65,14,120
4841,SFO,2007,2007-12-09,4:05,1:05,,MIN,14,13,Sun,L 7-27,,7,35,3,25,10,60
4842,SFO,2008,2008-10-26,4:15,1:15,,SEA,8,8,Sun,L 13-34,,7,65,3,15,10,80
4843,SFO,2008,2008-11-16,4:05,1:05,,STL,11,10,Sun,W 35-16,,7,33,6,52,13,85
4844,SFO,2009,2009-09-27,1:03,12:03,@,MIN,3,3,Sun,L 24-27,,7,60,9,52,16,112
4845,SFO,2009,2009-11-01,1:03,1:03,@,IND,8,7,Sun,L 14-18,,7,50,5,38,12,88
4846,SFO,2009,2009-12-14,8:40,5:40,,ARI,14,13,Mon,W 24-9,,7,55,11,78,18,133
4847,SFO,2011,2011-11-20,4:05,1:05,,ARI,11,10,Sun,W 23-7,,7,87,6,75,13,162
4848,SFO,2011,2011-11-24,8:29,8:29,@,BAL,12,11,Thu,L 6-16,,7,97,3,20,10,117
4849,SFO,2011,2011-12-19,9:00,6:00,,PIT,15,14,Mon,W 20-3,,7,49,9,72,16,121
4850,SFO,2012,2012-10-07,4:25,1:25,,BUF,5,5,Sun,W 45-3,,7,53,5,30,12,83
4851,SFO,2012,2012-11-11,4:25,1:25,,STL,10,9,Sun,T 24-24,OT,7,66,13,85,20,151
4852,SFO,2013,2013-12-08,4:26,1:26,,SEA,14,13,Sun,W 19-17,,7,70,9,85,16,155
4853,SFO,2013,2013-12-23,8:40,5:40,,ATL,16,15,Mon,W 34-24,,7,45,5,37,12,82
4854,SFO,2014,2014-12-07,4:25,1:25,@,OAK,14,13,Sun,L 13-24,,7,50,10,84,17,134
4855,SFO,2015,2015-09-20,1:02,1:02,@,PIT,2,2,Sun,L 18-43,,7,46,7,58,14,104
4856,SFO,2015,2016-01-03,4:25,1:25,,STL,17,16,Sun,W 19-16,OT,7,60,11,105,18,165
4857,SFO,2016,2016-11-27,1:00,1:00,@,MIA,12,11,Sun,L 24-31,,7,65,4,42,11,107
4858,SFO,2017,2017-10-15,1:00,1:00,@,WAS,6,6,Sun,L 24-26,,7,40,5,43,12,83
4859,SFO,2017,2017-11-26,4:05,1:05,,SEA,12,11,Sun,L 13-24,,7,74,6,35,13,109
4860,SFO,2017,2017-12-17,4:25,1:25,,TEN,15,14,Sun,W 25-23,,7,70,3,22,10,92
4861,SFO,2019,2019-12-15,4:25,1:25,,ATL,15,14,Sun,L 22-29,,7,67,11,98,18,165
4862,SFO,2020,2020-10-11,4:05,1:05,,MIA,5,5,Sun,L 17-43,,7,75,7,69,14,144
4863,SFO,2020,2020-10-18,8:20,5:20,,LAR,6,6,Sun,W 24-16,,7,63,6,34,13,97
4864,SFO,2020,2020-12-07,8:15,6:15,,BUF,13,12,Mon,L 24-34,,7,43,4,50,11,93
4865,SFO,2021,2021-09-12,1:00,1:00,@,DET,1,1,Sun,W 41-33,,7,79,5,45,12,124
4866,SFO,2021,2021-10-10,4:25,2:25,@,ARI,5,5,Sun,L 10-17,,7,60,6,62,13,122
4867,SFO,2021,2021-10-24,8:20,5:20,,IND,7,6,Sun,L 18-30,,7,122,6,45,13,167
4868,SFO,2021,2021-10-31,1:00,12:00,@,CHI,8,7,Sun,W 33-22,,7,55,4,30,11,85
4869,SFO,2021,2022-01-02,4:05,1:05,,HOU,17,16,Sun,W 23-7,,7,111,5,67,12,178
4870,TAM,2000,2000-10-09,9:10,8:10,@,MIN,6,6,Mon,L 23-30,,7,58,4,44,11,102
4871,TAM,2000,2000-10-19,8:35,8:35,,DET,8,7,Thu,L 14-28,,7,54,7,55,14,109
4872,TAM,2000,2000-11-26,1:00,1:00,,BUF,13,12,Sun,W 31-17,,7,71,8,70,15,141
4873,TAM,2000,2000-12-10,1:02,1:02,@,MIA,15,14,Sun,W 16-13,,7,63,6,46,13,109
4874,TAM,2001,2001-10-07,4:15,4:15,,GNB,4,3,Sun,W 14-10,,7,60,4,26,11,86
4875,TAM,2001,2001-12-02,1:02,1:02,@,CIN,12,11,Sun,W 16-13,OT,7,52,8,47,15,99
4876,TAM,2002,2002-09-29,4:05,4:05,@,CIN,4,4,Sun,W 35-7,,7,65,4,30,11,95
4877,TAM,2002,2002-10-20,4:15,4:15,@,PHI,7,7,Sun,L 10-20,,7,59,8,56,15,115
4878,TAM,2002,2002-11-03,1:01,1:01,,MIN,9,9,Sun,W 38-24,,7,52,12,83,19,135
4879,TAM,2003,2003-09-08,9:09,9:09,@,PHI,1,1,Mon,W 17-0,,7,64,3,25,10,89
4880,TAM,2003,2003-11-30,8:36,8:36,@,JAX,13,12,Sun,L 10-17,,7,80,5,48,12,128
4881,TAM,2003,2003-12-20,1:32,1:32,,ATL,16,15,Sat,L 28-30,,7,46,4,30,11,76
4882,TAM,2004,2004-11-28,1:04,1:04,@,CAR,12,11,Sun,L 14-21,,7,40,5,50,12,90
4883,TAM,2005,2005-10-02,1:02,1:02,,DET,4,4,Sun,W 17-13,,7,55,8,55,15,110
4884,TAM,2005,2005-12-11,1:03,1:03,@,CAR,14,13,Sun,W 20-10,,7,50,5,35,12,85
4885,TAM,2007,2007-10-21,1:03,1:03,@,DET,7,7,Sun,L 16-23,,7,60,4,23,11,83
4886,TAM,2007,2007-10-28,4:05,4:05,,JAX,8,8,Sun,L 23-24,,7,74,5,45,12,119
4887,TAM,2007,2007-12-02,4:15,3:15,@,NOR,13,12,Sun,W 27-23,,7,55,6,40,13,95
4888,TAM,2008,2008-09-07,1:02,12:02,@,NOR,1,1,Sun,L 20-24,,7,66,7,51,14,117
4889,TAM,2008,2008-10-12,1:02,1:02,,CAR,6,6,Sun,W 27-3,,7,80,4,16,11,96
4890,TAM,2008,2008-10-26,1:02,12:02,@,DAL,8,8,Sun,L 9-13,,7,58,5,35,12,93
4891,TAM,2008,2008-11-02,1:03,12:03,@,KAN,9,9,Sun,W 30-27,OT,7,47,7,60,14,107
4892,TAM,2009,2009-12-27,1:03,12:03,@,NOR,16,15,Sun,W 20-17,OT,7,42,2,14,9,56
4893,TAM,2010,2011-01-02,1:00,12:00,@,NOR,17,16,Sun,W 23-13,,7,54,5,45,12,99
4894,TAM,2011,2011-10-16,4:15,4:15,,NOR,6,6,Sun,W 26-20,,7,64,7,53,14,117
4895,TAM,2011,2011-12-24,1:04,1:04,@,CAR,16,15,Sat,L 16-48,,7,64,8,77,15,141
4896,TAM,2012,2012-10-21,1:02,1:02,,NOR,7,6,Sun,L 28-35,,7,50,7,55,14,105
4897,TAM,2012,2012-12-16,1:03,12:03,@,NOR,15,14,Sun,L 0-41,,7,84,6,55,13,139
4898,TAM,2015,2015-11-15,1:05,1:05,,DAL,10,9,Sun,W 10-6,,7,62,6,68,13,130
4899,TAM,2016,2016-10-23,4:05,1:05,@,SFO,7,6,Sun,W 34-17,,7,78,4,31,11,109
4900,TAM,2016,2016-11-20,1:00,12:00,@,KAN,11,10,Sun,W 19-17,,7,42,5,30,12,72
4901,TAM,2016,2016-11-27,4:05,4:05,,SEA,12,11,Sun,W 14-5,,7,68,2,27,9,95
4902,TAM,2016,2016-12-11,4:25,4:25,,NOR,14,13,Sun,W 16-11,,7,65,13,104,20,169
4903,TAM,2016,2016-12-24,4:25,3:25,@,NOR,16,15,Sat,L 24-31,,7,63,7,59,14,122
4904,TAM,2017,2017-09-24,1:00,3:00,@,MIN,3,2,Sun,L 17-34,,7,37,5,53,12,90
4905,TAM,2017,2017-11-05,1:00,12:00,@,NOR,9,8,Sun,L 10-30,,7,50,4,28,11,78
4906,TAM,2017,2017-12-10,1:00,1:00,,DET,14,13,Sun,L 21-24,,7,65,8,105,15,170
4907,TAM,2017,2017-12-18,8:30,8:30,,ATL,15,14,Mon,L 21-24,,7,53,6,60,13,113
4908,TAM,2018,2018-09-09,1:00,12:00,@,NOR,1,1,Sun,W 48-40,,7,70,8,77,15,147
4909,TAM,2019,2019-11-17,1:00,1:00,,NOR,11,10,Sun,L 17-34,,7,55,9,76,16,131
4910,TAM,2021,2021-09-26,4:25,1:25,@,LAR,3,3,Sun,L 24-34,,7,41,1,4,8,45
4911,TAM,2021,2021-10-03,8:20,8:20,@,NWE,4,4,Sun,W 19-17,,7,74,8,77,15,151
4912,TAM,2021,2021-10-14,8:20,8:20,@,PHI,6,6,Thu,W 28-22,,7,120,4,41,11,161
4913,WAS,2000,2000-09-03,1:01,1:01,,CAR,1,1,Sun,W 20-17,,7,64,9,65,16,129
4914,WAS,2000,2000-10-30,9:01,9:01,,TEN,9,9,Mon,L 21-27,,7,62,10,56,17,118
4915,WAS,2000,2000-12-16,12:37,12:37,@,PIT,16,15,Sat,L 3-24,,7,70,6,40,13,110
4916,WAS,2001,2001-10-07,1:04,1:04,@,NYG,4,4,Sun,L 9-23,,7,53,7,64,14,117
4917,WAS,2001,2001-10-15,8:08,8:08,@,DAL,5,5,Mon,L 7-9,,7,60,3,22,10,82
4918,WAS,2001,2001-11-18,4:15,2:15,@,DEN,10,9,Sun,W 17-10,,7,54,7,57,14,111
4919,WAS,2001,2001-12-16,4:15,4:15,,PHI,14,13,Sun,L 6-20,,7,58,6,45,13,103
4920,WAS,2002,2002-09-08,1:05,1:05,,ARI,1,1,Sun,W 31-23,,7,56,1,5,8,61
4921,WAS,2002,2002-09-16,9:05,9:05,,PHI,2,2,Mon,L 7-37,,7,55,4,30,11,85
4922,WAS,2002,2002-10-06,1:03,12:03,@,TEN,5,4,Sun,W 31-14,,7,46,7,46,14,92
4923,WAS,2002,2002-11-17,1:04,1:04,@,NYG,11,10,Sun,L 17-19,,7,39,8,75,15,114
4924,WAS,2003,2003-12-21,1:03,12:03,@,CHI,16,15,Sun,L 24-27,,7,50,5,33,12,83
4925,WAS,2004,2004-09-19,1:04,1:04,@,NYG,2,2,Sun,L 14-20,,7,50,8,50,15,100
4926,WAS,2004,2004-09-27,9:10,9:10,,DAL,3,3,Mon,L 18-21,,7,87,5,40,12,127
4927,WAS,2004,2004-10-03,1:02,1:02,@,CLE,4,4,Sun,L 13-17,,7,58,8,66,15,124
4928,WAS,2004,2004-11-07,1:04,1:04,@,DET,9,8,Sun,W 17-10,,7,75,4,40,11,115
4929,WAS,2004,2004-11-14,4:06,4:06,,CIN,10,9,Sun,L 10-17,,7,50,5,50,12,100
4930,WAS,2005,2005-11-27,1:02,1:02,,SDG,12,11,Sun,L 17-23,OT,7,60,6,40,13,100
4931,WAS,2005,2005-12-18,4:16,4:16,,DAL,15,14,Sun,W 35-7,,7,55,9,56,16,111
4932,WAS,2005,2006-01-01,4:16,4:16,@,PHI,17,16,Sun,W 31-20,,7,60,5,45,12,105
4933,WAS,2006,2006-09-11,7:11,7:11,,MIN,1,1,Mon,L 16-19,,7,55,9,60,16,115
4934,WAS,2007,2007-09-09,1:02,1:02,,MIA,1,1,Sun,W 16-13,OT,7,65,8,61,15,126
4935,WAS,2007,2007-10-14,1:02,12:02,@,GNB,6,5,Sun,L 14-17,,7,53,4,35,11,88
4936,WAS,2007,2007-12-06,8:16,8:16,,CHI,14,13,Thu,W 24-16,,7,48,9,49,16,97
4937,WAS,2007,2007-12-23,8:15,7:15,@,MIN,16,15,Sun,W 32-21,,7,52,6,40,13,92
4938,WAS,2008,2008-09-04,7:08,7:08,@,NYG,1,1,Thu,L 7-16,,7,35,7,70,14,105
4939,WAS,2008,2008-09-21,1:02,1:02,,ARI,3,3,Sun,W 24-17,,7,67,6,42,13,109
4940,WAS,2008,2008-10-12,1:03,1:03,,STL,6,6,Sun,L 17-19,,7,53,10,79,17,132
4941,WAS,2008,2008-11-30,1:04,1:04,,NYG,13,12,Sun,L 7-23,,7,47,3,19,10,66
4942,WAS,2008,2008-12-07,8:23,8:23,@,BAL,14,13,Sun,L 10-24,,7,39,4,35,11,74
4943,WAS,2009,2009-10-18,1:03,1:03,,KAN,6,6,Sun,L 6-14,,7,63,4,30,11,93
4944,WAS,2009,2009-11-29,1:03,1:03,@,PHI,12,11,Sun,L 24-27,,7,39,7,60,14,99
4945,WAS,2009,2009-12-13,4:05,1:05,@,OAK,14,13,Sun,W 34-13,,7,45,14,118,21,163
4946,WAS,2010,2010-09-19,4:15,4:15,,HOU,2,2,Sun,L 27-30,OT,7,58,5,45,12,103
4947,WAS,2010,2010-10-17,8:31,8:31,,IND,6,6,Sun,L 24-27,,7,53,3,15,10,68
4948,WAS,2010,2010-10-24,1:04,12:04,@,CHI,7,7,Sun,W 17-14,,7,48,6,51,13,99
4949,WAS,2012,2012-10-14,4:24,4:24,,MIN,6,6,Sun,W 38-26,,7,66,5,29,12,95
4950,WAS,2012,2012-10-21,1:03,1:03,@,NYG,7,7,Sun,L 23-27,,7,55,3,30,10,85
4951,WAS,2012,2012-10-28,1:02,1:02,@,PIT,8,8,Sun,L 12-27,,7,55,3,20,10,75
4952,WAS,2013,2013-09-15,1:02,12:02,@,GNB,2,2,Sun,L 20-38,,7,78,4,40,11,118
4953,WAS,2013,2013-11-03,1:03,1:03,,SDG,9,8,Sun,W 30-24,OT,7,65,7,63,14,128
4954,WAS,2014,2014-09-07,1:03,12:03,@,HOU,1,1,Sun,L 6-17,,7,71,6,45,13,116
4955,WAS,2014,2014-10-19,1:02,1:02,,TEN,7,7,Sun,W 19-17,,7,50,11,96,18,146
4956,WAS,2014,2014-11-23,4:25,1:25,@,SFO,12,11,Sun,L 13-17,,7,53,5,47,12,100
4957,WAS,2015,2015-09-20,1:03,1:03,,STL,2,2,Sun,W 24-10,,7,53,9,80,16,133
4958,WAS,2015,2015-09-24,8:26,8:26,@,NYG,3,3,Thu,L 21-32,,7,58,8,67,15,125
4959,WAS,2015,2015-11-29,1:03,1:03,,NYG,12,11,Sun,W 20-14,,7,80,4,35,11,115
4960,WAS,2016,2016-12-04,4:25,2:25,@,ARI,13,12,Sun,L 23-31,,7,35,6,51,13,86
4961,WAS,2016,2016-12-19,8:30,8:30,,CAR,15,14,Mon,L 15-26,,7,70,6,62,13,132
4962,WAS,2016,2016-12-24,1:00,12:00,@,CHI,16,15,Sat,W 41-21,,7,73,4,52,11,125
4963,WAS,2017,2017-10-02,8:30,7:30,@,KAN,4,4,Mon,L 20-29,,7,44,3,15,10,59
4964,WAS,2017,2017-11-05,4:05,1:05,@,SEA,9,8,Sun,W 17-14,,7,62,16,138,23,200
4965,WAS,2017,2017-11-30,8:25,7:25,@,DAL,13,12,Thu,L 14-38,,7,43,3,25,10,68
4966,WAS,2017,2017-12-17,1:00,1:00,,ARI,15,14,Sun,W 20-15,,7,82,8,71,15,153
4967,WAS,2018,2018-09-16,1:00,1:00,,IND,2,2,Sun,L 9-21,,7,90,6,26,13,116
4968,WAS,2019,2019-10-20,1:00,1:00,,SFO,7,7,Sun,L 0-9,,7,47,2,20,9,67
4969,WAS,2020,2020-09-13,1:00,1:00,,PHI,1,1,Sun,W 27-17,,7,55,3,20,10,75
4970,WAS,2021,2021-12-12,1:00,1:00,,DAL,14,13,Sun,L 20-27,,7,65,7,60,14,125
4971,ATL,2000,2000-11-19,4:16,1:16,@,SFO,12,12,Sun,L 6-16,,6,40,9,85,15,125
4972,ATL,2001,2001-10-07,1:05,1:05,,CHI,4,4,Sun,L 3-31,,6,55,5,67,11,122
4973,ATL,2001,2002-01-06,4:05,3:05,@,STL,17,16,Sun,L 13-31,,6,35,1,10,7,45
4974,ATL,2002,2002-10-06,1:03,1:03,,TAM,5,4,Sun,L 6-20,,6,41,6,35,12,76
4975,ATL,2002,2002-11-24,1:02,1:02,@,CAR,12,11,Sun,W 41-0,,6,65,5,39,11,104
4976,ATL,2003,2003-11-30,1:03,12:03,@,HOU,13,12,Sun,L 13-17,,6,49,5,53,11,102
4977,ATL,2003,2003-12-14,1:00,1:00,@,IND,15,14,Sun,L 7-38,,6,80,9,63,15,143
4978,ATL,2004,2004-09-19,1:03,1:03,,STL,2,2,Sun,W 34-17,,6,51,10,75,16,126
4979,ATL,2004,2004-11-14,1:05,1:05,,TAM,10,9,Sun,W 24-14,,6,45,13,83,19,128
4980,ATL,2004,2004-11-28,4:05,4:05,,NOR,12,11,Sun,W 24-21,,6,46,5,25,11,71
4981,ATL,2004,2004-12-18,8:36,8:36,,CAR,15,14,Sat,W 34-31,OT,6,66,7,50,13,116
4982,ATL,2004,2004-12-26,1:03,12:03,@,NOR,16,15,Sun,L 13-26,,6,35,10,73,16,108
4983,ATL,2005,2005-12-18,8:37,7:37,@,CHI,15,14,Sun,L 3-16,,6,75,3,16,9,91
4984,ATL,2006,2006-10-22,1:05,1:05,,PIT,7,6,Sun,W 41-38,OT,6,40,9,65,15,105
4985,ATL,2006,2006-12-03,1:03,1:03,@,WAS,13,12,Sun,W 24-14,,6,60,3,30,9,90
4986,ATL,2007,2007-09-09,1:00,12:00,@,MIN,1,1,Sun,L 3-24,,6,40,4,35,10,75
4987,ATL,2008,2008-10-12,1:02,1:02,,CHI,6,6,Sun,W 22-20,,6,46,6,57,12,103
4988,ATL,2008,2008-10-26,1:02,1:02,@,PHI,8,7,Sun,L 14-27,,6,51,7,70,13,121
4989,ATL,2008,2008-12-21,4:15,3:15,@,MIN,16,15,Sun,W 24-17,,6,70,3,15,9,85
4990,ATL,2009,2009-09-20,1:02,1:02,,CAR,2,2,Sun,W 28-20,,6,40,6,35,12,75
4991,ATL,2009,2009-10-18,8:30,8:30,,CHI,6,5,Sun,W 21-14,,6,70,9,65,15,135
4992,ATL,2009,2009-12-06,1:03,1:03,,PHI,13,12,Sun,L 7-34,,6,30,8,62,14,92
4993,ATL,2009,2009-12-27,1:02,1:02,,BUF,16,15,Sun,W 31-3,,6,70,10,60,16,130
4994,ATL,2010,2010-09-19,1:03,1:03,,ARI,2,2,Sun,W 41-7,,6,75,10,109,16,184
4995,ATL,2010,2010-09-26,1:03,12:03,@,NOR,3,3,Sun,W 27-24,OT,6,40,4,38,10,78
4996,ATL,2010,2010-10-10,1:03,1:03,@,CLE,5,5,Sun,W 20-10,,6,60,7,58,13,118
4997,ATL,2010,2010-12-05,4:16,4:16,@,TAM,13,12,Sun,W 28-24,,6,55,9,102,15,157
4998,ATL,2012,2012-10-28,1:03,1:03,@,PHI,8,7,Sun,W 30-17,,6,40,6,57,12,97
4999,ATL,2012,2012-11-11,1:02,12:02,@,NOR,10,9,Sun,L 27-31,,6,53,5,35,11,88
5000,ATL,2013,2013-09-29,8:30,8:30,,NWE,4,4,Sun,L 23-30,,6,55,9,93,15,148
5001,ATL,2014,2014-10-12,4:25,4:25,,CHI,6,6,Sun,L 13-27,,6,52,7,47,13,99
5002,ATL,2014,2014-12-21,1:03,12:03,@,NOR,16,15,Sun,W 30-14,,6,64,3,25,9,89
5003,ATL,2014,2014-12-28,4:25,4:25,,CAR,17,16,Sun,L 3-34,,6,36,5,36,11,72
5004,ATL,2015,2015-09-20,1:02,1:02,@,NYG,2,2,Sun,W 24-20,,6,65,6,35,12,100
5005,ATL,2015,2015-09-27,1:03,12:03,@,DAL,3,3,Sun,W 39-28,,6,70,5,31,11,101
5006,ATL,2015,2015-10-25,1:02,12:02,@,TEN,7,7,Sun,W 10-7,,6,53,5,45,11,98
5007,ATL,2015,2015-11-08,4:05,1:05,@,SFO,9,9,Sun,L 16-17,,6,63,5,30,11,93
5008,ATL,2015,2015-11-22,1:02,1:02,,IND,11,10,Sun,L 21-24,,6,69,7,42,13,111
5009,ATL,2015,2015-11-29,1:02,1:02,,MIN,12,11,Sun,L 10-20,,6,78,9,53,15,131
5010,ATL,2015,2015-12-13,1:03,1:03,@,CAR,14,13,Sun,L 0-38,,6,54,6,60,12,114
5011,ATL,2016,2016-11-03,8:25,8:25,@,TAM,9,9,Thu,W 43-28,,6,34,11,85,17,119
5012,ATL,2016,2016-12-24,1:00,1:00,@,CAR,16,15,Sat,W 33-16,,6,45,4,24,10,69
5013,ATL,2017,2017-09-17,8:30,8:30,,GNB,2,2,Sun,W 34-23,,6,34,10,70,16,104
5014,ATL,2017,2017-10-15,1:00,1:00,,MIA,6,5,Sun,L 17-20,,6,73,4,42,10,115
5015,ATL,2017,2017-10-22,8:30,8:30,@,NWE,7,6,Sun,L 7-23,,6,40,8,65,14,105
5016,ATL,2017,2017-10-29,1:00,1:00,@,NYJ,8,7,Sun,W 25-20,,6,68,6,50,12,118
5017,ATL,2017,2017-12-18,8:30,8:30,@,TAM,15,14,Mon,W 24-21,,6,60,7,53,13,113
5018,ATL,2018,2018-12-16,1:00,1:00,,ARI,15,14,Sun,W 40-14,,6,50,8,75,14,125
5019,ATL,2019,2019-12-08,1:00,1:00,,CAR,14,13,Sun,W 40-20,,6,58,7,44,13,102
5020,ATL,2020,2020-09-13,1:00,1:00,,SEA,1,1,Sun,L 25-38,,6,72,6,46,12,118
5021,ATL,2020,2020-10-29,8:20,8:20,@,CAR,8,8,Thu,W 25-17,,6,63,6,30,12,93
5022,ATL,2020,2020-11-29,1:00,1:00,,LVR,12,11,Sun,W 43-6,,6,49,11,141,17,190
5023,ATL,2021,2021-09-19,4:05,4:05,@,TAM,2,2,Sun,L 25-48,,6,49,9,83,15,132
5024,ATL,2021,2021-11-07,1:00,12:00,@,NOR,9,8,Sun,W 27-25,,6,76,10,74,16,150
5025,ATL,2021,2021-11-14,1:00,12:00,@,DAL,10,9,Sun,L 3-43,,6,41,8,80,14,121
5026,ATL,2021,2021-12-05,1:00,1:00,,TAM,13,12,Sun,L 17-30,,6,39,3,15,9,54
5027,ATL,2021,2021-12-12,1:00,1:00,@,CAR,14,13,Sun,W 29-21,,6,60,6,45,12,105
5028,BUF,2000,2000-09-03,8:35,8:35,,TEN,1,1,Sun,W 16-13,,6,91,12,112,18,203
5029,BUF,2000,2000-11-19,1:00,12:00,@,KAN,12,11,Sun,W 21-17,,6,45,7,57,13,102
5030,BUF,2000,2000-12-17,1:02,1:02,,NWE,16,15,Sun,L 10-13,OT,6,54,9,75,15,129
5031,BUF,2001,2001-09-30,1:03,1:03,,PIT,3,3,Sun,L 3-20,,6,57,12,125,18,182
5032,BUF,2002,2002-09-15,4:15,3:15,@,MIN,2,2,Sun,W 45-39,OT,6,65,8,65,14,130
5033,BUF,2002,2002-10-27,1:02,1:02,,DET,8,8,Sun,W 24-17,,6,51,8,71,14,122
5034,BUF,2003,2003-09-14,1:03,1:03,@,JAX,2,2,Sun,W 38-17,,6,55,8,97,14,152
5035,BUF,2003,2003-10-05,1:02,1:02,,CIN,5,5,Sun,W 22-16,OT,6,49,7,49,13,98
5036,BUF,2003,2003-11-16,1:01,1:01,,HOU,11,10,Sun,L 10-12,,6,44,11,65,17,109
5037,BUF,2003,2003-11-23,1:02,1:02,,IND,12,11,Sun,L 14-17,,6,42,6,49,12,91
5038,BUF,2004,2004-11-28,4:16,1:16,@,SEA,12,11,Sun,W 38-9,,6,44,7,64,13,108
5039,BUF,2005,2005-12-24,1:03,1:03,@,CIN,16,15,Sat,W 37-27,,6,55,3,15,9,70
5040,BUF,2006,2006-09-24,1:02,1:02,,NYJ,3,3,Sun,L 20-28,,6,43,8,52,14,95
5041,BUF,2007,2007-09-30,1:02,1:02,,NYJ,4,4,Sun,W 17-14,,6,38,9,66,15,104
5042,BUF,2007,2007-12-23,1:02,1:02,,NYG,16,15,Sun,L 21-38,,6,45,4,25,10,70
5043,BUF,2008,2008-10-05,4:16,1:16,@,ARI,5,5,Sun,L 17-41,,6,36,4,20,10,56
5044,BUF,2008,2008-11-23,1:00,12:00,@,KAN,12,11,Sun,W 54-31,,6,45,9,75,15,120
5045,BUF,2008,2008-11-30,1:01,1:01,,SFO,13,12,Sun,L 3-10,,6,43,4,35,10,78
5046,BUF,2009,2009-11-22,1:03,1:03,@,JAX,11,10,Sun,L 15-18,,6,43,6,50,12,93
5047,BUF,2010,2010-09-26,1:02,1:02,@,NWE,3,3,Sun,L 30-38,,6,45,4,35,10,80
5048,BUF,2010,2010-10-24,1:02,1:02,@,BAL,7,6,Sun,L 34-37,OT,6,78,4,18,10,96
5049,BUF,2010,2010-12-05,1:05,12:05,@,MIN,13,12,Sun,L 14-38,,6,54,4,20,10,74
5050,BUF,2010,2010-12-12,1:02,1:02,,CLE,14,13,Sun,W 13-6,,6,44,2,10,8,54
5051,BUF,2010,2010-12-26,1:02,1:02,,NWE,16,15,Sun,L 3-34,,6,40,6,40,12,80
5052,BUF,2011,2011-10-30,4:05,4:05,,WAS,8,7,Sun,W 23-0,,6,35,4,59,10,94
5053,BUF,2011,2011-11-06,1:03,1:03,,NYJ,9,8,Sun,L 11-27,,6,84,9,60,15,144
5054,BUF,2012,2012-09-09,1:03,1:03,@,NYJ,1,1,Sun,L 28-48,,6,34,5,34,11,68
5055,BUF,2013,2013-10-20,1:02,1:02,@,MIA,7,7,Sun,W 23-21,,6,53,4,32,10,85
5056,BUF,2013,2013-10-27,1:02,12:02,@,NOR,8,8,Sun,L 17-35,,6,45,8,59,14,104
5057,BUF,2013,2013-11-03,1:02,1:02,,KAN,9,9,Sun,L 13-23,,6,48,5,38,11,86
5058,BUF,2013,2013-12-01,4:05,4:05,,ATL,13,12,Sun,L 31-34,OT,6,49,8,75,14,124
5059,BUF,2013,2013-12-29,4:25,4:25,@,NWE,17,16,Sun,L 20-34,,6,54,4,31,10,85
5060,BUF,2014,2014-09-14,1:02,1:02,,MIA,2,2,Sun,W 29-10,,6,40,3,20,9,60
5061,BUF,2014,2014-11-09,1:02,1:02,,KAN,10,9,Sun,L 13-17,,6,44,3,19,9,63
5062,BUF,2014,2014-11-30,1:02,1:02,,CLE,13,12,Sun,W 26-10,,6,45,10,76,16,121
5063,BUF,2016,2016-09-15,8:26,8:26,,NYJ,2,2,Thu,L 31-37,,6,59,7,50,13,109
5064,BUF,2016,2016-10-02,1:02,1:02,@,NWE,4,4,Sun,W 16-0,,6,60,9,74,15,134
5065,BUF,2016,2016-10-23,1:02,1:02,@,MIA,7,7,Sun,L 25-28,,6,45,13,116,19,161
5066,BUF,2016,2016-11-27,1:00,1:00,,JAX,12,11,Sun,W 28-21,,6,31,6,60,12,91
5067,BUF,2017,2017-09-10,1:00,1:00,,NYJ,1,1,Sun,W 21-12,,6,50,5,62,11,112
5068,BUF,2017,2017-10-08,1:00,1:00,@,CIN,5,5,Sun,L 16-20,,6,71,6,71,12,142
5069,BUF,2017,2017-11-19,4:05,1:05,@,LAC,11,10,Sun,L 24-54,,6,48,1,13,7,61
5070,BUF,2017,2017-11-26,1:00,12:00,@,KAN,12,11,Sun,W 16-10,,6,50,6,50,12,100
5071,BUF,2017,2017-12-31,4:25,1:00,@,MIA,17,16,Sun,W 22-16,,6,45,14,145,20,190
5072,BUF,2018,2018-09-16,1:00,1:00,,LAC,2,2,Sun,L 20-31,,6,31,6,45,12,76
5073,BUF,2018,2018-10-29,8:15,8:15,,NWE,8,8,Mon,L 6-25,,6,51,5,33,11,84
5074,BUF,2020,2020-09-20,1:00,1:00,@,MIA,2,2,Sun,W 31-28,,6,55,3,20,9,75
5075,BUF,2020,2020-11-08,1:00,1:00,,SEA,9,9,Sun,W 44-34,,6,70,4,13,10,83
5076,BUF,2021,2021-09-19,1:00,1:00,@,MIA,2,2,Sun,W 35-0,,6,53,9,83,15,136
5077,CAR,2000,2000-09-10,4:15,1:15,@,SFO,2,2,Sun,W 38-22,,6,50,9,67,15,117
5078,CAR,2000,2000-10-22,1:02,1:02,,SFO,8,7,Sun,W 34-16,,6,63,13,82,19,145
5079,CAR,2001,2001-11-25,1:02,1:02,,ATL,11,11,Sun,L 7-10,,6,30,4,30,10,60
5080,CAR,2002,2002-09-08,1:04,1:04,,BAL,1,1,Sun,W 10-7,,6,35,6,45,12,80
5081,CAR,2002,2002-09-22,1:00,12:00,@,MIN,3,3,Sun,W 21-14,,6,41,6,55,12,96
5082,CAR,2002,2002-10-06,1:02,1:02,,ARI,5,5,Sun,L 13-16,,6,45,6,62,12,107
5083,CAR,2002,2002-10-20,1:05,1:05,@,ATL,7,7,Sun,L 0-30,,6,40,9,65,15,105
5084,CAR,2003,2003-10-26,1:03,12:03,@,NOR,8,7,Sun,W 23-20,OT,6,50,4,43,10,93
5085,CAR,2003,2003-12-21,1:03,1:03,,DET,16,15,Sun,W 20-14,,6,35,7,55,13,90
5086,CAR,2004,2004-09-19,1:00,12:00,@,KAN,2,2,Sun,W 28-17,,6,51,8,88,14,139
5087,CAR,2004,2004-12-05,1:03,12:03,@,NOR,13,12,Sun,W 32-21,,6,44,10,104,16,148
5088,CAR,2004,2005-01-02,1:02,1:02,,NOR,17,16,Sun,L 18-21,,6,45,8,87,14,132
5089,CAR,2005,2005-09-18,1:02,1:02,,NWE,2,2,Sun,W 27-17,,6,45,12,86,18,131
5090,CAR,2005,2005-10-30,1:02,1:02,,MIN,8,7,Sun,W 38-13,,6,53,10,60,16,113
5091,CAR,2005,2005-12-24,1:03,1:03,,DAL,16,15,Sat,L 20-24,,6,49,5,44,11,93
5092,CAR,2005,2006-01-01,1:05,1:05,@,ATL,17,16,Sun,W 44-11,,6,55,7,70,13,125
5093,CAR,2006,2006-09-17,1:03,12:03,@,MIN,2,2,Sun,L 13-16,OT,6,32,9,54,15,86
5094,CAR,2007,2007-11-11,1:03,1:03,,ATL,10,9,Sun,L 13-20,,6,43,9,68,15,111
5095,CAR,2008,2008-09-07,4:15,1:15,@,SDG,1,1,Sun,W 26-24,,6,29,2,12,8,41
5096,CAR,2009,2009-09-20,1:02,1:02,@,ATL,2,2,Sun,L 20-28,,6,35,6,40,12,75
5097,CAR,2009,2009-09-28,8:40,7:40,@,DAL,3,3,Mon,L 7-21,,6,60,9,80,15,140
5098,CAR,2009,2009-11-08,4:05,3:05,@,NOR,9,8,Sun,L 20-30,,6,37,7,55,13,92
5099,CAR,2009,2009-12-20,8:30,8:30,,MIN,15,14,Sun,W 26-7,,6,49,5,45,11,94
5100,CAR,2010,2010-09-26,1:02,1:02,,CIN,3,3,Sun,L 7-20,,6,45,8,74,14,119
5101,CAR,2010,2010-10-31,1:00,12:00,@,STL,8,7,Sun,L 10-20,,6,30,7,65,13,95
5102,CAR,2010,2010-12-12,1:03,1:03,,ATL,14,13,Sun,L 10-31,,6,50,1,10,7,60
5103,CAR,2010,2010-12-19,1:04,1:04,,ARI,15,14,Sun,W 19-12,,6,58,4,39,10,97
5104,CAR,2010,2010-12-23,8:29,8:29,@,PIT,16,15,Thu,L 3-27,,6,62,4,40,10,102
5105,CAR,2011,2011-09-18,1:02,1:02,,GNB,2,2,Sun,L 23-30,,6,50,7,57,13,107
5106,CAR,2011,2011-10-30,1:03,1:03,,MIN,8,8,Sun,L 21-24,,6,60,4,43,10,103
5107,CAR,2011,2011-11-27,1:03,1:03,@,IND,12,11,Sun,W 27-19,,6,92,2,15,8,107
5108,CAR,2012,2012-09-09,4:26,4:26,@,TAM,1,1,Sun,L 10-16,,6,65,4,35,10,100
5109,CAR,2012,2012-11-26,8:32,8:32,@,PHI,12,11,Mon,W 30-22,,6,101,5,30,11,131
5110,CAR,2012,2012-12-16,4:05,1:05,@,SDG,15,14,Sun,W 31-7,,6,48,9,70,15,118
5111,CAR,2013,2013-10-13,1:05,12:05,@,MIN,6,5,Sun,W 35-10,,6,40,5,55,11,95
5112,CAR,2013,2013-10-24,8:29,8:29,@,TAM,8,7,Thu,W 31-13,,6,59,3,21,9,80
5113,CAR,2013,2013-12-15,4:05,4:05,,NYJ,15,14,Sun,W 30-20,,6,59,3,20,9,79
5114,CAR,2014,2014-09-07,4:25,4:25,@,TAM,1,1,Sun,W 20-14,,6,55,3,15,9,70
5115,CAR,2014,2014-10-30,8:30,8:30,,NOR,9,9,Thu,L 10-28,,6,67,4,36,10,103
5116,CAR,2014,2014-12-07,1:03,12:03,@,NOR,14,13,Sun,W 41-10,,6,55,4,30,10,85
5117,CAR,2015,2015-11-02,8:30,8:30,,IND,8,7,Mon,W 29-26,OT,6,55,2,15,8,70
5118,CAR,2015,2015-11-08,1:04,1:04,,GNB,9,8,Sun,W 37-29,,6,45,7,87,13,132
5119,CAR,2015,2015-12-13,1:03,1:03,,ATL,14,13,Sun,W 38-0,,6,60,6,54,12,114
5120,CAR,2016,2016-10-02,1:04,1:04,@,ATL,4,4,Sun,L 33-48,,6,55,8,77,14,132
5121,CAR,2016,2016-11-13,1:00,1:00,,KAN,10,9,Sun,L 17-20,,6,53,9,45,15,98
5122,CAR,2016,2016-11-17,8:25,8:25,,NOR,11,10,Thu,W 23-20,,6,45,6,48,12,93
5123,CAR,2016,2016-12-04,8:30,5:30,@,SEA,13,12,Sun,L 7-40,,6,63,6,37,12,100
5124,CAR,2016,2016-12-19,8:30,8:30,@,WAS,15,14,Mon,W 26-15,,6,62,7,70,13,132
5125,CAR,2017,2017-09-17,1:00,1:00,,BUF,2,2,Sun,W 9-3,,6,40,5,44,11,84
5126,CAR,2017,2017-11-13,8:30,8:30,,MIA,10,10,Mon,W 45-21,,6,37,7,57,13,94
5127,CAR,2017,2017-12-03,4:25,12:00,@,NOR,13,12,Sun,L 21-31,,6,54,7,68,13,122
5128,CAR,2017,2017-12-10,1:00,1:00,,MIN,14,13,Sun,W 31-24,,6,48,2,30,8,78
5129,CAR,2017,2017-12-24,1:00,1:00,,TAM,16,15,Sun,W 22-19,,6,50,12,72,18,122
5130,CAR,2019,2019-09-08,1:00,1:00,,LAR,1,1,Sun,L 27-30,,6,46,5,43,11,89
5131,CAR,2019,2019-09-29,1:00,12:00,@,HOU,4,4,Sun,W 16-10,,6,35,7,81,13,116
5132,CAR,2019,2019-11-03,1:00,1:00,,TEN,9,8,Sun,W 30-20,,6,77,11,99,17,176
5133,CAR,2019,2019-12-22,1:00,1:00,@,IND,16,15,Sun,L 6-38,,6,46,0,0,6,46
5134,CAR,2020,2020-10-29,8:20,8:20,,ATL,8,8,Thu,L 17-25,,6,30,6,63,12,93
5135,CAR,2021,2021-09-12,1:00,1:00,,NYJ,1,1,Sun,W 19-14,,6,38,5,30,11,68
5136,CAR,2021,2021-10-03,1:00,12:00,@,DAL,4,4,Sun,L 28-36,,6,32,7,50,13,82
5137,CAR,2021,2021-10-17,1:00,1:00,,MIN,6,6,Sun,L 28-34,OT,6,28,11,98,17,126
5138,CAR,2021,2021-12-12,1:00,1:00,,ATL,14,13,Sun,L 21-29,,6,45,6,60,12,105
5139,CAR,2021,2021-12-26,1:00,1:00,,TAM,16,15,Sun,L 6-32,,6,32,6,50,12,82
5140,CHI,2001,2001-11-04,4:15,3:15,,CLE,8,7,Sun,W 27-21,OT,6,55,9,80,15,135
5141,CHI,2002,2002-10-27,1:00,12:00,@,MIN,8,7,Sun,L 7-25,,6,33,11,65,17,98
5142,CHI,2002,2002-11-24,1:03,12:03,,DET,12,11,Sun,W 20-17,OT,6,64,7,50,13,114
5143,CHI,2003,2003-09-14,8:30,7:30,@,MIN,2,2,Sun,L 13-24,,6,50,3,25,9,75
5144,CHI,2003,2003-09-29,9:09,8:09,,GNB,4,3,Mon,L 23-38,,6,62,4,38,10,100
5145,CHI,2003,2003-10-19,4:15,1:15,@,SEA,7,6,Sun,L 17-24,,6,64,5,45,11,109
5146,CHI,2003,2003-11-16,1:03,12:03,,STL,11,10,Sun,L 21-23,,6,47,7,45,13,92
5147,CHI,2003,2003-11-23,4:05,2:05,@,DEN,12,11,Sun,W 19-10,,6,29,8,114,14,143
5148,CHI,2004,2004-11-14,1:03,12:03,@,TEN,10,9,Sun,W 19-17,OT,6,50,4,25,10,75
5149,CHI,2005,2005-09-18,1:02,12:02,,DET,2,2,Sun,W 38-6,,6,40,3,30,9,70
5150,CHI,2006,2006-09-17,1:03,12:03,,DET,2,2,Sun,W 34-7,,6,93,14,104,20,197
5151,CHI,2006,2006-10-16,8:42,5:42,@,ARI,6,6,Mon,W 24-23,,6,50,9,65,15,115
5152,CHI,2006,2006-12-31,8:15,7:15,,GNB,17,16,Sun,L 7-26,,6,44,3,35,9,79
5153,CHI,2007,2007-10-07,8:24,7:24,@,GNB,5,5,Sun,W 27-20,,6,40,12,93,18,133
5154,CHI,2007,2007-11-18,4:16,1:16,@,SEA,11,10,Sun,L 23-30,,6,40,2,20,8,60
5155,CHI,2007,2007-12-23,1:03,12:03,,GNB,16,15,Sun,W 35-7,,6,30,1,10,7,40
5156,CHI,2008,2008-10-05,1:02,1:02,@,DET,5,5,Sun,W 34-7,,6,45,6,41,12,86
5157,CHI,2008,2008-10-12,1:02,1:02,@,ATL,6,6,Sun,L 20-22,,6,57,6,46,12,103
5158,CHI,2009,2009-09-27,4:06,1:06,@,SEA,3,3,Sun,W 25-19,,6,60,4,45,10,105
5159,CHI,2009,2009-10-25,4:16,4:16,@,CIN,7,6,Sun,L 10-45,,6,44,3,20,9,64
5160,CHI,2009,2009-11-29,4:15,3:15,@,MIN,12,11,Sun,L 10-36,,6,44,10,70,16,114
5161,CHI,2010,2010-10-24,1:04,12:04,,WAS,7,7,Sun,L 14-17,,6,51,7,48,13,99
5162,CHI,2010,2010-11-28,4:15,3:15,,PHI,12,11,Sun,W 31-26,,6,56,3,19,9,75
5163,CHI,2010,2010-12-26,1:02,12:02,,NYJ,16,15,Sun,W 38-34,,6,31,3,34,9,65
5164,CHI,2010,2011-01-02,4:15,3:15,@,GNB,17,16,Sun,L 3-10,,6,46,4,30,10,76
5165,CHI,2011,2011-09-18,1:02,12:02,@,NOR,2,2,Sun,L 13-30,,6,47,7,41,13,88
5166,CHI,2011,2011-11-07,8:41,8:41,@,PHI,9,8,Mon,W 30-24,,6,53,6,44,12,97
5167,CHI,2011,2011-11-20,4:16,3:16,,SDG,11,10,Sun,W 31-20,,6,61,3,20,9,81
5168,CHI,2011,2011-12-25,8:30,7:30,@,GNB,16,15,Sun,L 21-35,,6,28,0,0,6,28
5169,CHI,2012,2012-09-23,1:04,12:04,,STL,3,3,Sun,W 23-6,,6,45,4,40,10,85
5170,CHI,2012,2012-11-19,8:40,5:40,@,SFO,11,10,Mon,L 7-32,,6,55,5,50,11,105
5171,CHI,2013,2013-10-06,1:02,12:02,,NOR,5,5,Sun,L 18-26,,6,43,2,10,8,53
5172,CHI,2013,2013-12-01,1:05,12:05,@,MIN,13,12,Sun,L 20-23,OT,6,51,6,60,12,111
5173,CHI,2014,2014-09-28,1:02,12:02,,GNB,4,4,Sun,L 17-38,,6,46,9,70,15,116
5174,CHI,2014,2014-11-23,1:02,12:02,,TAM,12,11,Sun,W 21-13,,6,45,9,87,15,132
5175,CHI,2015,2015-09-13,1:00,12:00,,GNB,1,1,Sun,L 23-31,,6,64,10,74,16,138
5176,CHI,2015,2015-09-27,4:26,1:26,@,SEA,3,3,Sun,L 0-26,,6,40,5,41,11,81
5177,CHI,2015,2015-10-11,1:02,12:02,@,KAN,5,5,Sun,W 18-17,,6,49,3,49,9,98
5178,CHI,2015,2015-11-09,8:30,5:30,@,SDG,9,8,Mon,W 22-19,,6,55,8,54,14,109
5179,CHI,2015,2015-12-20,1:02,12:02,@,MIN,15,14,Sun,L 17-38,,6,39,4,45,10,84
5180,CHI,2016,2016-09-25,8:31,7:31,@,DAL,3,3,Sun,L 17-31,,6,45,4,45,10,90
5181,CHI,2016,2016-12-18,1:00,12:00,,GNB,15,14,Sun,L 27-30,,6,40,8,64,14,104
5182,CHI,2016,2017-01-01,1:00,3:00,@,MIN,17,16,Sun,L 10-38,,6,49,2,15,8,64
5183,CHI,2018,2018-10-14,1:00,1:00,@,MIA,6,5,Sun,L 28-31,OT,6,58,7,67,13,125
5184,CHI,2018,2018-11-11,1:00,12:00,,DET,10,9,Sun,W 34-22,,6,46,6,41,12,87
5185,CHI,2018,2018-12-09,8:20,12:00,,LAR,14,13,Sun,W 15-6,,6,45,9,57,15,102
5186,CHI,2019,2019-11-24,1:00,12:00,,NYG,12,11,Sun,W 19-14,,6,40,6,35,12,75
5187,CHI,2020,2020-09-13,1:00,1:00,@,DET,1,1,Sun,W 27-23,,6,48,8,77,14,125
5188,CHI,2020,2020-10-08,8:20,7:20,,TAM,5,5,Thu,W 20-19,,6,66,11,109,17,175
5189,CHI,2020,2020-10-26,8:15,5:15,@,LAR,7,7,Mon,L 10-24,,6,46,4,46,10,92
5190,CHI,2021,2021-11-21,1:00,12:00,,BAL,11,10,Sun,L 13-16,,6,58,6,36,12,94
5191,CHI,2021,2021-12-05,1:00,12:00,,ARI,13,12,Sun,L 22-33,,6,45,8,63,14,108
5192,CIN,2000,2000-09-17,1:02,1:02,@,JAX,3,2,Sun,L 0-13,,6,44,7,76,13,120
5193,CIN,2000,2000-10-15,1:01,1:01,@,PIT,7,6,Sun,L 0-15,,6,46,8,65,14,111
5194,CIN,2000,2000-10-29,1:03,1:03,@,CLE,9,8,Sun,W 12-3,,6,84,9,71,15,155
5195,CIN,2000,2000-11-05,1:03,1:03,,BAL,10,9,Sun,L 7-27,,6,40,6,50,12,90
5196,CIN,2000,2000-12-17,1:02,1:02,,JAX,16,15,Sun,W 17-14,,6,40,6,47,12,87
5197,CIN,2000,2000-12-24,1:03,1:03,@,PHI,17,16,Sun,L 7-16,,6,39,4,34,10,73
5198,CIN,2001,2001-10-07,1:02,1:02,@,PIT,4,4,Sun,L 7-16,,6,35,4,29,10,64
5199,CIN,2001,2001-12-16,1:02,1:02,@,NYJ,14,13,Sun,L 14-15,,6,65,7,55,13,120
5200,CIN,2001,2001-12-23,1:02,1:02,@,BAL,15,14,Sun,L 0-16,,6,40,3,40,9,80
5201,CIN,2002,2002-10-06,12:00,12:00,@,IND,5,5,Sun,L 21-28,,6,63,5,71,11,134
5202,CIN,2002,2002-12-22,1:02,1:02,,NOR,16,15,Sun,W 20-13,,6,40,4,30,10,70
5203,CIN,2003,2003-11-23,4:15,1:15,@,SDG,12,11,Sun,W 34-27,,6,80,7,69,13,149
5204,CIN,2003,2003-11-30,1:01,1:01,@,PIT,13,12,Sun,W 24-20,,6,55,7,70,13,125
5205,CIN,2004,2004-09-12,1:07,1:07,@,NYJ,1,1,Sun,L 24-31,,6,49,1,7,7,56
5206,CIN,2005,2005-12-11,1:03,1:03,,CLE,14,13,Sun,W 23-20,,6,33,7,45,13,78
5207,CIN,2005,2006-01-01,1:00,12:00,@,KAN,17,16,Sun,L 3-37,,6,50,9,80,15,130
5208,CIN,2006,2006-12-31,1:03,1:03,,PIT,17,16,Sun,L 17-23,OT,6,40,7,101,13,141
5209,CIN,2007,2007-10-14,1:00,12:00,@,KAN,6,5,Sun,L 20-27,,6,59,9,55,15,114
5210,CIN,2008,2008-09-28,1:02,1:02,,CLE,4,4,Sun,L 12-20,,6,55,9,52,15,107
5211,CIN,2008,2008-12-14,1:03,1:03,,WAS,15,14,Sun,W 20-13,,6,41,9,75,15,116
5212,CIN,2009,2009-10-04,1:03,1:03,@,CLE,4,4,Sun,W 23-20,OT,6,46,5,44,11,90
5213,CIN,2009,2009-11-08,1:02,1:02,,BAL,9,8,Sun,W 17-7,,6,40,7,80,13,120
5214,CIN,2009,2009-12-27,1:03,1:03,,KAN,16,15,Sun,W 17-10,,6,36,6,40,12,76
5215,CIN,2010,2010-12-19,1:02,1:02,,CLE,15,14,Sun,W 19-17,,6,55,3,25,9,80
5216,CIN,2010,2010-12-26,4:05,4:05,,SDG,16,15,Sun,W 34-20,,6,57,1,5,7,62
5217,CIN,2011,2011-09-25,1:02,1:02,,SFO,3,3,Sun,L 8-13,,6,40,12,70,18,110
5218,CIN,2011,2011-11-20,1:02,1:02,@,BAL,11,10,Sun,L 24-31,,6,43,6,69,12,112
5219,CIN,2011,2011-12-24,1:02,1:02,,ARI,16,15,Sat,W 23-16,,6,47,6,87,12,134
5220,CIN,2012,2012-09-16,1:02,1:02,,CLE,2,2,Sun,W 34-27,,6,54,10,103,16,157
5221,CIN,2012,2012-09-30,4:05,4:05,@,JAX,4,4,Sun,W 27-10,,6,50,3,37,9,87
5222,CIN,2013,2013-10-20,1:02,1:02,@,DET,7,7,Sun,W 27-24,,6,50,4,30,10,80
5223,CIN,2013,2013-12-15,8:30,8:30,@,PIT,15,14,Sun,L 20-30,,6,50,4,25,10,75
5224,CIN,2013,2013-12-22,1:02,1:02,,MIN,16,15,Sun,W 42-14,,6,55,5,40,11,95
5225,CIN,2014,2014-10-26,1:02,1:02,,BAL,8,7,Sun,W 27-24,,6,40,7,51,13,91
5226,CIN,2014,2014-11-02,1:02,1:02,,JAX,9,8,Sun,W 33-23,,6,40,3,35,9,75
5227,CIN,2014,2014-11-23,1:02,12:02,@,HOU,12,11,Sun,W 22-13,,6,60,3,15,9,75
5228,CIN,2015,2015-09-13,4:25,1:25,@,OAK,1,1,Sun,W 33-13,,6,50,5,32,11,82
5229,CIN,2015,2015-12-20,4:25,1:25,@,SFO,15,14,Sun,W 24-14,,6,45,11,98,17,143
5230,CIN,2015,2015-12-28,8:30,6:30,@,DEN,16,15,Mon,L 17-20,OT,6,45,5,40,11,85
5231,CIN,2016,2016-09-29,8:26,8:26,,MIA,4,4,Thu,W 22-7,,6,40,7,68,13,108
5232,CIN,2016,2016-10-09,4:25,3:25,@,DAL,5,5,Sun,L 14-28,,6,49,7,45,13,94
5233,CIN,2016,2016-12-11,1:00,1:00,@,CLE,14,13,Sun,W 23-10,,6,43,5,34,11,77
5234,CIN,2016,2016-12-24,8:25,7:25,@,HOU,16,15,Sat,L 10-12,,6,60,3,25,9,85
5235,CIN,2017,2017-10-08,1:00,1:00,,BUF,5,5,Sun,W 20-16,,6,71,6,71,12,142
5236,CIN,2017,2017-12-31,4:25,1:00,@,BAL,17,16,Sun,W 31-27,,6,60,5,47,11,107
5237,CIN,2018,2018-09-30,1:00,1:00,@,ATL,4,4,Sun,W 37-36,,6,55,10,95,16,150
5238,CIN,2018,2018-10-07,1:00,1:00,,MIA,5,5,Sun,W 27-17,,6,47,9,85,15,132
5239,CIN,2018,2018-10-14,1:00,1:00,,PIT,6,6,Sun,L 21-28,,6,30,9,69,15,99
5240,CIN,2018,2018-12-09,4:05,1:05,@,LAC,14,13,Sun,L 21-26,,6,34,6,38,12,72
5241,CIN,2019,2019-10-20,1:00,1:00,,JAX,7,7,Sun,L 17-27,,6,50,11,130,17,180
5242,CIN,2019,2019-10-27,1:00,6:00,@,LAR,8,8,Sun,L 10-24,,6,40,9,59,15,99
5243,CIN,2020,2020-10-18,1:00,1:00,@,IND,6,6,Sun,L 27-31,,6,20,6,55,12,75
5244,CIN,2020,2020-11-15,4:25,4:25,@,PIT,10,9,Sun,L 10-36,,6,65,6,45,12,110
5245,CIN,2020,2020-12-06,1:00,1:00,@,MIA,13,12,Sun,L 7-19,,6,62,8,54,14,116
5246,CIN,2021,2021-09-30,8:20,8:20,,JAX,4,4,Thu,W 24-21,,6,38,2,10,8,48
5247,CIN,2021,2021-12-19,4:05,2:05,@,DEN,15,14,Sun,W 15-10,,6,38,6,60,12,98
5248,CLE,2000,2000-09-10,1:00,1:00,@,CIN,2,2,Sun,W 24-7,,6,60,7,65,13,125
5249,CLE,2000,2000-12-10,1:03,1:03,,PHI,15,15,Sun,L 24-35,,6,55,4,21,10,76
5250,CLE,2001,2001-10-07,1:02,1:02,,SDG,4,4,Sun,W 20-16,,6,40,6,30,12,70
5251,CLE,2001,2002-01-06,1:01,1:01,@,PIT,17,16,Sun,L 7-28,,6,70,7,42,13,112
5252,CLE,2003,2003-09-14,1:02,1:02,@,BAL,2,2,Sun,L 13-33,,6,50,10,85,16,135
5253,CLE,2003,2003-10-12,1:03,1:03,,OAK,6,6,Sun,W 13-7,,6,55,19,128,25,183
5254,CLE,2004,2004-09-12,1:08,1:08,,BAL,1,1,Sun,W 20-3,,6,50,6,46,12,96
5255,CLE,2004,2004-09-19,4:15,3:15,@,DAL,2,2,Sun,L 12-19,,6,31,11,120,17,151
5256,CLE,2004,2004-10-17,1:03,1:03,,CIN,6,6,Sun,W 34-17,,6,50,10,75,16,125
5257,CLE,2004,2005-01-02,1:02,12:02,@,HOU,17,16,Sun,W 22-14,,6,46,7,52,13,98
5258,CLE,2005,2005-09-18,4:15,3:15,@,GNB,2,2,Sun,W 26-24,,6,40,6,41,12,81
5259,CLE,2005,2005-11-27,1:02,12:02,@,MIN,12,11,Sun,L 12-24,,6,30,7,49,13,79
5260,CLE,2006,2006-11-05,4:15,1:15,@,SDG,9,8,Sun,L 25-32,,6,50,12,113,18,163
5261,CLE,2007,2007-09-09,1:03,1:03,,PIT,1,1,Sun,L 7-34,,6,51,6,45,12,96
5262,CLE,2007,2007-09-16,1:03,1:03,,CIN,2,2,Sun,W 51-45,,6,45,3,15,9,60
5263,CLE,2007,2007-09-30,1:02,1:02,,BAL,4,4,Sun,W 27-13,,6,41,7,41,13,82
5264,CLE,2007,2007-11-04,4:06,4:06,,SEA,9,8,Sun,W 33-30,OT,6,49,4,20,10,69
5265,CLE,2008,2008-12-28,1:02,1:02,@,PIT,17,16,Sun,L 0-31,,6,47,8,65,14,112
5266,CLE,2009,2009-11-16,8:40,8:40,,BAL,10,9,Mon,L 0-16,,6,52,7,43,13,95
5267,CLE,2009,2009-12-10,8:21,8:21,,PIT,14,13,Thu,W 13-6,,6,55,4,40,10,95
5268,CLE,2009,2009-12-27,1:01,1:01,,OAK,16,15,Sun,W 23-9,,6,64,13,126,19,190
5269,CLE,2010,2011-01-02,1:02,1:02,,PIT,17,16,Sun,L 9-41,,6,46,3,25,9,71
5270,CLE,2011,2011-11-13,1:03,1:03,,STL,10,9,Sun,L 12-13,,6,60,7,55,13,115
5271,CLE,2011,2011-12-08,8:28,8:28,@,PIT,14,13,Thu,L 3-14,,6,54,12,97,18,151
5272,CLE,2011,2011-12-24,1:03,1:03,@,BAL,16,15,Sat,L 14-20,,6,95,5,51,11,146
5273,CLE,2012,2012-09-23,1:02,1:02,,BUF,3,3,Sun,L 14-24,,6,57,10,75,16,132
5274,CLE,2013,2013-10-03,8:29,8:29,,BUF,5,5,Thu,W 37-24,,6,66,7,56,13,122
5275,CLE,2013,2013-11-03,4:25,4:25,,BAL,9,9,Sun,W 24-18,,6,55,9,80,15,135
5276,CLE,2014,2014-10-12,1:02,1:02,,PIT,6,5,Sun,W 31-10,,6,60,6,42,12,102
5277,CLE,2014,2014-10-26,4:25,4:25,,OAK,8,7,Sun,W 23-13,,6,30,8,54,14,84
5278,CLE,2014,2014-11-06,8:29,8:29,@,CIN,10,9,Thu,W 24-3,,6,62,7,55,13,117
5279,CLE,2014,2014-12-21,1:04,1:04,@,CAR,16,15,Sun,L 13-17,,6,49,5,49,11,98
5280,CLE,2015,2015-09-27,1:02,1:02,,OAK,3,3,Sun,L 20-27,,6,50,12,85,18,135
5281,CLE,2015,2015-10-18,1:02,1:02,,DEN,6,6,Sun,L 23-26,OT,6,30,8,81,14,111
5282,CLE,2017,2017-10-08,1:00,1:00,,NYJ,5,5,Sun,L 14-17,,6,60,9,80,15,140
5283,CLE,2017,2017-12-10,1:00,1:00,,GNB,14,13,Sun,L 21-27,OT,6,45,3,20,9,65
5284,CLE,2017,2017-12-17,1:00,1:00,,BAL,15,14,Sun,L 10-27,,6,35,7,57,13,92
5285,CLE,2018,2018-10-14,1:00,1:00,,LAC,6,6,Sun,L 14-38,,6,53,10,72,16,125
5286,CLE,2018,2018-12-02,1:00,12:00,@,HOU,13,12,Sun,L 13-29,,6,45,5,77,11,122
5287,CLE,2018,2018-12-15,8:20,2:30,@,DEN,15,14,Sat,W 17-16,,6,75,8,51,14,126
5288,CLE,2018,2018-12-23,1:00,1:00,,CIN,16,15,Sun,W 26-18,,6,57,3,15,9,72
5289,CLE,2019,2019-09-29,1:00,1:00,@,BAL,4,4,Sun,W 40-25,,6,41,3,15,9,56
5290,CLE,2019,2019-12-08,1:00,1:00,,CIN,14,13,Sun,W 27-19,,6,30,8,99,14,129
5291,CLE,2019,2019-12-15,4:05,2:05,@,ARI,15,14,Sun,L 24-38,,6,55,5,34,11,89
5292,CLE,2020,2020-09-27,1:00,1:00,,WAS,3,3,Sun,W 34-20,,6,50,4,40,10,90
5293,CLE,2020,2020-11-15,1:00,1:00,,HOU,10,9,Sun,W 10-7,,6,63,6,49,12,112
5294,CLE,2020,2020-11-29,1:00,1:00,@,JAX,12,11,Sun,W 27-25,,6,47,5,24,11,71
5295,CLE,2020,2020-12-20,8:20,8:20,@,NYG,15,14,Sun,W 20-6,,6,60,2,25,8,85
5296,CLE,2020,2020-12-27,1:00,1:00,@,NYJ,16,15,Sun,L 16-23,,6,51,7,58,13,109
5297,CLE,2021,2021-11-14,1:00,1:00,@,NWE,10,10,Sun,L 7-45,,6,42,6,46,12,88
5298,CLE,2021,2021-12-25,4:30,3:30,@,GNB,16,15,Sat,L 22-24,,6,38,3,29,9,67
5299,IND,2001,2001-11-18,1:02,12:02,@,NOR,10,9,Sun,L 20-34,,6,77,6,51,12,128
5300,IND,2001,2001-12-02,1:02,1:02,@,BAL,12,11,Sun,L 27-39,,6,83,5,30,11,113
5301,IND,2002,2002-10-27,8:35,8:35,@,WAS,8,7,Sun,L 21-26,,6,40,5,30,11,70
5302,IND,2002,2002-11-03,1:00,1:00,,TEN,9,8,Sun,L 15-23,,6,48,5,45,11,93
5303,IND,2002,2002-12-08,1:03,12:03,@,TEN,14,13,Sun,L 17-27,,6,48,4,19,10,67
5304,IND,2002,2002-12-29,4:05,4:05,,JAX,17,16,Sun,W 20-13,,6,35,6,47,12,82
5305,IND,2003,2003-09-14,1:00,12:00,,TEN,2,2,Sun,W 33-7,,6,38,10,99,16,137
5306,IND,2003,2003-11-23,1:02,1:02,@,BUF,12,11,Sun,W 17-14,,6,49,6,42,12,91
5307,IND,2003,2003-12-07,1:03,12:03,@,TEN,14,13,Sun,W 29-27,,6,57,10,67,16,124
5308,IND,2003,2003-12-21,8:35,8:35,,DEN,16,15,Sun,L 17-31,,6,45,11,93,17,138
5309,IND,2003,2003-12-28,1:03,12:03,@,HOU,17,16,Sun,W 20-17,,6,60,6,40,12,100
5310,IND,2005,2005-09-18,12:03,12:03,,JAX,2,2,Sun,W 10-3,,6,45,7,60,13,105
5311,IND,2005,2005-10-23,1:03,12:03,@,HOU,7,7,Sun,W 38-20,,6,35,3,15,9,50
5312,IND,2005,2005-11-13,1:03,1:03,,HOU,10,9,Sun,W 31-17,,6,50,4,35,10,85
5313,IND,2006,2006-11-12,1:02,1:02,,BUF,10,9,Sun,W 17-16,,6,54,5,40,11,94
5314,IND,2007,2007-09-06,8:39,8:39,,NOR,1,1,Thu,W 41-10,,6,30,4,20,10,50
5315,IND,2007,2007-11-22,8:16,8:16,@,ATL,12,11,Thu,W 31-13,,6,55,5,41,11,96
5316,IND,2008,2008-09-07,8:23,8:23,,CHI,1,1,Sun,L 13-29,,6,40,7,60,13,100
5317,IND,2008,2008-09-21,4:15,4:15,,JAX,3,3,Sun,L 21-23,,6,37,5,44,11,81
5318,IND,2008,2008-10-05,1:02,12:02,@,HOU,5,4,Sun,W 31-27,,6,31,1,5,7,36
5319,IND,2008,2008-11-09,4:15,4:15,@,PIT,10,9,Sun,W 24-20,,6,45,3,20,9,65
5320,IND,2008,2008-11-16,1:02,1:02,,HOU,11,10,Sun,W 33-27,,6,45,3,23,9,68
5321,IND,2008,2008-12-18,8:15,8:15,@,JAX,16,15,Thu,W 31-24,,6,50,7,60,13,110
5322,IND,2009,2009-10-25,1:00,12:00,@,STL,7,6,Sun,W 42-6,,6,51,5,73,11,124
5323,IND,2010,2010-09-19,8:31,8:31,,NYG,2,2,Sun,W 38-14,,6,55,3,25,9,80
5324,IND,2010,2010-11-21,4:15,4:15,@,NWE,11,10,Sun,L 28-31,,6,48,1,15,7,63
5325,IND,2010,2010-12-19,1:02,1:02,,JAX,15,14,Sun,W 34-24,,6,68,6,55,12,123
5326,IND,2011,2011-09-11,1:05,12:05,@,HOU,1,1,Sun,L 7-34,,6,60,4,30,10,90
5327,IND,2011,2011-10-03,8:40,8:40,@,TAM,4,4,Mon,L 17-24,,6,50,14,106,20,156
5328,IND,2011,2011-11-06,1:02,1:02,,ATL,9,9,Sun,L 7-31,,6,32,1,10,7,42
5329,IND,2011,2011-11-13,1:02,1:02,,JAX,10,10,Sun,L 3-17,,6,40,5,55,11,95
5330,IND,2012,2012-11-08,8:30,8:30,@,JAX,10,9,Thu,W 27-10,,6,40,10,115,16,155
5331,IND,2012,2012-11-25,1:03,1:03,,BUF,12,11,Sun,W 20-13,,6,37,4,46,10,83
5332,IND,2012,2012-12-09,1:02,1:02,,TEN,14,13,Sun,W 27-23,,6,43,9,70,15,113
5333,IND,2013,2013-10-20,8:31,8:31,,DEN,7,7,Sun,W 39-33,,6,52,12,103,18,155
5334,IND,2013,2013-11-24,4:05,2:05,@,ARI,12,11,Sun,L 11-40,,6,89,9,84,15,173
5335,IND,2013,2013-12-08,1:02,1:02,@,CIN,14,13,Sun,L 28-42,,6,47,7,60,13,107
5336,IND,2014,2014-10-05,1:03,1:03,,BAL,5,5,Sun,W 20-13,,6,83,5,36,11,119
5337,IND,2014,2014-11-23,1:02,1:02,,JAX,12,11,Sun,W 23-3,,6,54,6,43,12,97
5338,IND,2014,2014-12-07,1:03,1:03,@,CLE,14,13,Sun,W 25-24,,6,40,7,85,13,125
5339,IND,2015,2015-11-29,1:02,1:02,,TAM,12,11,Sun,W 25-12,,6,45,12,95,18,140
5340,IND,2015,2015-12-27,1:02,1:02,@,MIA,16,15,Sun,W 18-12,,6,60,9,50,15,110
5341,IND,2015,2016-01-03,1:02,1:02,,TEN,17,16,Sun,W 30-24,,6,71,6,60,12,131
5342,IND,2017,2017-11-05,1:00,12:00,@,HOU,9,9,Sun,W 20-14,,6,68,7,74,13,142
5343,IND,2018,2018-09-16,1:00,1:00,@,WAS,2,2,Sun,W 21-9,,6,26,7,90,13,116
5344,IND,2018,2018-12-02,1:00,1:00,@,JAX,13,12,Sun,L 0-6,,6,65,8,74,14,139
5345,IND,2018,2018-12-16,1:00,1:00,,DAL,15,14,Sun,W 23-0,,6,55,9,74,15,129
5346,IND,2018,2018-12-23,1:00,1:00,,NYG,16,15,Sun,W 28-27,,6,29,6,24,12,53
5347,IND,2019,2019-10-20,1:00,1:00,,HOU,7,6,Sun,W 30-23,,6,45,10,54,16,99
5348,IND,2019,2019-12-01,1:00,1:00,,TEN,13,12,Sun,L 17-31,,6,40,3,33,9,73
5349,IND,2020,2020-10-18,1:00,1:00,,CIN,6,6,Sun,W 31-27,,6,55,6,20,12,75
5350,IND,2020,2020-11-29,1:00,1:00,,TEN,12,11,Sun,L 26-45,,6,50,9,63,15,113
5351,IND,2020,2020-12-13,4:05,1:05,@,LVR,14,13,Sun,W 44-27,,6,50,6,33,12,83
5352,IND,2021,2021-10-24,8:20,5:20,@,SFO,7,7,Sun,W 30-18,,6,45,7,122,13,167
5353,IND,2021,2021-11-28,1:00,1:00,,TAM,12,12,Sun,L 31-38,,6,66,4,44,10,110
5354,ARI,2000,2000-12-03,1:02,1:02,@,CIN,14,13,Sun,L 13-24,,6,39,5,47,11,86
5355,ARI,2001,2001-09-23,8:37,5:37,,DEN,2,1,Sun,L 17-38,,6,79,4,32,10,111
5356,ARI,2001,2001-10-14,12:03,12:03,@,CHI,5,4,Sun,L 13-20,,6,50,5,45,11,95
5357,ARI,2001,2001-10-21,4:05,1:05,,KAN,6,5,Sun,W 24-16,,6,50,10,107,16,157
5358,ARI,2002,2002-10-06,1:02,1:02,@,CAR,5,5,Sun,W 16-13,,6,62,6,45,12,107
5359,ARI,2002,2002-11-03,4:15,2:15,,STL,9,8,Sun,L 14-27,,6,40,9,80,15,120
5360,ARI,2002,2002-12-01,1:00,12:00,@,KAN,13,12,Sun,L 0-49,,6,50,4,51,10,101
5361,ARI,2002,2002-12-29,4:16,2:16,@,DEN,17,16,Sun,L 7-37,,6,36,8,53,14,89
5362,ARI,2003,2003-10-26,4:06,2:06,,SFO,8,7,Sun,W 16-13,OT,6,55,6,36,12,91
5363,ARI,2003,2003-12-21,4:15,1:15,@,SEA,16,15,Sun,L 10-28,,6,30,3,30,9,60
5364,ARI,2004,2004-09-19,4:16,1:16,,NWE,2,2,Sun,L 12-23,,6,43,12,79,18,122
5365,ARI,2004,2004-10-24,4:16,1:16,,SEA,7,6,Sun,W 25-17,,6,45,4,35,10,80
5366,ARI,2004,2004-11-28,4:16,2:16,,NYJ,12,11,Sun,L 3-13,,6,51,9,85,15,136
5367,ARI,2006,2006-12-17,4:05,2:05,,DEN,15,14,Sun,L 20-37,,6,52,1,5,7,57
5368,ARI,2007,2007-09-23,1:00,1:00,@,BAL,3,3,Sun,L 23-26,,6,65,5,40,11,105
5369,ARI,2008,2008-09-21,1:02,1:02,@,WAS,3,3,Sun,L 17-24,,6,42,7,67,13,109
5370,ARI,2009,2009-11-22,4:05,3:05,@,STL,11,10,Sun,W 21-13,,6,40,7,50,13,90
5371,ARI,2009,2009-12-06,8:20,6:20,,MIN,13,12,Sun,W 30-17,,6,50,6,50,12,100
5372,ARI,2010,2010-11-29,8:40,6:40,,SFO,12,11,Mon,L 6-27,,6,61,6,40,12,101
5373,ARI,2010,2010-12-05,4:15,2:15,,STL,13,12,Sun,L 6-19,,6,54,2,15,8,69
5374,ARI,2010,2010-12-25,7:30,5:30,,DAL,16,15,Sat,W 27-26,,6,43,7,49,13,92
5375,ARI,2011,2011-09-11,4:15,1:15,,CAR,1,1,Sun,W 28-21,,6,61,10,74,16,135
5376,ARI,2011,2011-10-09,1:05,12:05,@,MIN,5,5,Sun,L 10-34,,6,64,5,35,11,99
5377,ARI,2011,2011-11-06,4:15,2:15,,STL,9,8,Sun,W 19-13,OT,6,45,9,71,15,116
5378,ARI,2011,2011-11-20,4:05,1:05,@,SFO,11,10,Sun,L 7-23,,6,75,7,87,13,162
5379,ARI,2011,2011-12-04,4:15,2:15,,DAL,13,12,Sun,W 19-13,OT,6,41,7,49,13,90
5380,ARI,2011,2011-12-24,1:02,1:02,@,CIN,16,15,Sat,L 16-23,,6,87,6,47,12,134
5381,ARI,2012,2012-09-30,4:05,1:05,,MIA,4,4,Sun,W 24-21,OT,6,62,4,40,10,102
5382,ARI,2012,2012-12-16,4:05,2:05,,DET,15,14,Sun,W 38-10,,6,50,7,63,13,113
5383,ARI,2013,2013-09-08,4:23,3:23,@,STL,1,1,Sun,L 24-27,,6,68,7,59,13,127
5384,ARI,2013,2013-10-13,4:25,1:25,@,SFO,6,6,Sun,L 20-32,,6,38,4,35,10,73
5385,ARI,2013,2013-12-01,1:02,1:02,@,PHI,13,12,Sun,L 21-24,,6,55,5,48,11,103
5386,ARI,2013,2013-12-08,4:25,2:25,,STL,14,13,Sun,W 30-10,,6,31,11,90,17,121
5387,ARI,2014,2014-10-19,4:25,1:25,@,OAK,7,6,Sun,W 24-13,,6,43,8,74,14,117
5388,ARI,2014,2014-11-02,1:04,12:04,@,DAL,9,8,Sun,W 28-17,,6,62,5,33,11,95
5389,ARI,2014,2014-12-07,4:05,2:05,,KAN,14,13,Sun,W 17-14,,6,40,9,75,15,115
5390,ARI,2015,2016-01-03,4:25,2:25,,SEA,17,16,Sun,L 6-36,,6,43,6,70,12,113
5391,ARI,2016,2016-09-11,8:30,5:30,,NWE,1,1,Sun,L 21-23,,6,58,8,69,14,127
5392,ARI,2016,2016-10-02,4:25,1:25,,LAR,4,4,Sun,L 13-17,,6,45,9,84,15,129
5393,ARI,2016,2016-10-23,8:30,5:30,,SEA,7,7,Sun,T 6-6,OT,6,45,10,90,16,135
5394,ARI,2016,2016-12-04,4:25,2:25,,WAS,13,12,Sun,W 31-23,,6,51,7,35,13,86
5395,ARI,2017,2017-09-10,1:00,1:00,@,DET,1,1,Sun,L 23-35,,6,55,10,100,16,155
5396,ARI,2017,2017-09-17,1:00,1:00,@,IND,2,2,Sun,W 16-13,OT,6,41,8,70,14,111
5397,ARI,2017,2017-09-25,8:30,6:30,,DAL,3,3,Mon,L 17-28,,6,50,9,76,15,126
5398,ARI,2017,2017-12-24,4:25,2:25,,NYG,16,15,Sun,W 23-0,,6,45,10,101,16,146
5399,ARI,2018,2018-09-23,4:25,2:25,,CHI,3,3,Sun,L 14-16,,6,43,7,45,13,88
5400,ARI,2020,2020-10-25,8:20,6:20,,SEA,7,7,Sun,W 37-34,OT,6,40,8,78,14,118
5401,ARI,2020,2020-11-29,1:00,1:00,@,NWE,12,11,Sun,L 17-20,,6,50,6,42,12,92
5402,ARI,2020,2021-01-03,4:25,1:25,@,LAR,17,16,Sun,L 7-18,,6,38,5,38,11,76
5403,ARI,2021,2021-10-10,4:25,2:25,,SFO,5,5,Sun,W 17-10,,6,62,7,60,13,122
5404,ARI,2021,2022-01-09,4:25,2:25,,SEA,18,17,Sun,L 30-38,,6,46,4,30,10,76
5405,DAL,2000,2000-12-10,4:15,3:15,,WAS,15,14,Sun,W 32-13,,6,35,11,121,17,156
5406,DAL,2001,2001-09-30,8:38,8:38,@,PHI,3,3,Sun,L 18-40,,6,50,10,81,16,131
5407,DAL,2001,2001-12-09,1:02,12:02,,NYG,13,12,Sun,W 20-13,,6,45,2,15,8,60
5408,DAL,2001,2001-12-16,4:17,1:17,@,SEA,14,13,Sun,L 3-29,,6,70,0,0,6,70
5409,DAL,2002,2002-10-20,4:15,1:15,@,ARI,7,7,Sun,L 6-9,OT,6,59,2,15,8,74
5410,DAL,2002,2002-11-28,4:17,3:17,,WAS,13,12,Thu,W 27-20,,6,48,6,56,12,104
5411,DAL,2003,2003-10-19,1:03,1:03,@,DET,7,6,Sun,W 38-7,,6,65,9,96,15,161
5412,DAL,2004,2004-10-24,4:15,3:15,@,GNB,7,6,Sun,L 20-41,,6,37,6,40,12,77
5413,DAL,2004,2004-12-06,9:09,6:09,@,SEA,13,12,Mon,W 43-39,,6,49,6,44,12,93
5414,DAL,2004,2004-12-19,1:02,1:02,@,PHI,15,14,Sun,L 7-12,,6,35,5,36,11,71
5415,DAL,2004,2005-01-02,8:36,8:36,@,NYG,17,16,Sun,L 24-28,,6,93,3,25,9,118
5416,DAL,2005,2005-09-25,4:05,1:05,@,SFO,3,3,Sun,W 34-31,,6,45,8,67,14,112
5417,DAL,2005,2005-10-02,4:15,1:15,@,OAK,4,4,Sun,L 13-19,,6,35,13,85,19,120
5418,DAL,2005,2005-10-16,1:02,12:02,,NYG,6,6,Sun,W 16-13,OT,6,44,6,32,12,76
5419,DAL,2006,2006-12-10,8:21,7:21,,NOR,14,13,Sun,L 17-42,,6,43,7,54,13,97
5420,DAL,2007,2007-12-16,4:15,3:15,,PHI,15,14,Sun,L 6-10,,6,45,4,35,10,80
5421,DAL,2008,2008-10-05,4:15,3:15,,CIN,5,5,Sun,W 31-22,,6,52,7,44,13,96
5422,DAL,2009,2009-11-22,1:03,12:03,,WAS,11,10,Sun,W 7-6,,6,35,5,27,11,62
5423,DAL,2009,2009-11-26,4:15,3:15,,OAK,12,11,Thu,W 24-7,,6,48,7,70,13,118
5424,DAL,2009,2009-12-13,4:15,3:15,,SDG,14,13,Sun,L 17-20,,6,68,5,24,11,92
5425,DAL,2009,2009-12-19,8:22,7:22,@,NOR,15,14,Sat,W 24-17,,6,49,4,30,10,79
5426,DAL,2010,2010-09-19,1:05,12:05,,CHI,2,2,Sun,L 20-27,,6,50,2,10,8,60
5427,DAL,2010,2010-11-21,1:02,12:02,,DET,11,10,Sun,W 35-19,,6,39,10,76,16,115
5428,DAL,2010,2011-01-02,4:15,4:15,@,PHI,17,16,Sun,W 14-13,,6,45,4,40,10,85
5429,DAL,2011,2011-09-26,8:41,7:41,,WAS,3,3,Mon,W 18-16,,6,55,4,35,10,90
5430,DAL,2011,2011-10-23,4:15,3:15,,STL,7,6,Sun,W 34-7,,6,30,4,16,10,46
5431,DAL,2011,2011-12-24,4:15,3:15,,PHI,16,15,Sat,L 7-20,,6,47,5,47,11,94
5432,DAL,2012,2012-10-21,1:03,1:03,@,CAR,7,6,Sun,W 19-14,,6,43,9,71,15,114
5433,DAL,2012,2012-12-09,1:03,1:03,@,CIN,14,13,Sun,W 20-19,,6,49,8,70,14,119
5434,DAL,2013,2013-09-22,1:02,12:02,,STL,3,3,Sun,W 31-7,,6,72,5,41,11,113
5435,DAL,2013,2013-11-28,4:31,3:31,,OAK,13,12,Thu,W 31-24,,6,40,10,71,16,111
5436,DAL,2013,2013-12-22,1:03,1:03,@,WAS,16,15,Sun,W 24-23,,6,42,8,44,14,86
5437,DAL,2014,2014-09-28,8:31,7:31,,NOR,4,4,Sun,W 38-17,,6,50,3,20,9,70
5438,DAL,2014,2014-10-12,4:26,1:26,@,SEA,6,6,Sun,W 30-23,,6,46,9,58,15,104
5439,DAL,2014,2014-10-19,4:25,3:25,,NYG,7,7,Sun,W 31-21,,6,46,6,40,12,86
5440,DAL,2014,2014-11-27,4:36,3:36,,PHI,13,12,Thu,L 10-33,,6,42,4,20,10,62
5441,DAL,2015,2015-10-04,8:30,7:30,@,NOR,4,4,Sun,L 20-26,OT,6,30,8,64,14,94
5442,DAL,2015,2015-11-15,1:05,1:05,@,TAM,10,9,Sun,L 6-10,,6,68,7,62,13,130
5443,DAL,2015,2015-12-13,4:25,3:25,@,GNB,14,13,Sun,L 7-28,,6,30,8,69,14,99
5444,DAL,2015,2015-12-19,8:26,7:26,,NYJ,15,14,Sat,L 16-19,,6,54,8,61,14,115
5445,DAL,2016,2016-09-11,4:27,3:27,,NYG,1,1,Sun,L 19-20,,6,50,4,40,10,90
5446,DAL,2016,2016-09-18,1:03,1:03,@,WAS,2,2,Sun,W 27-23,,6,39,8,51,14,90
5447,DAL,2016,2016-10-02,4:25,1:25,@,SFO,4,4,Sun,W 24-17,,6,45,5,32,11,77
5448,DAL,2018,2018-09-16,8:20,7:20,,NYG,2,2,Sun,W 20-13,,6,47,3,24,9,71
5449,DAL,2018,2018-11-05,8:15,7:15,,TEN,9,8,Mon,L 14-28,,6,52,3,20,9,72
5450,DAL,2018,2018-12-30,1:00,1:00,@,NYG,17,16,Sun,W 36-35,,6,46,11,78,17,124
5451,DAL,2019,2019-09-08,4:25,3:25,,NYG,1,1,Sun,W 35-17,,6,47,8,70,14,117
5452,DAL,2019,2019-09-29,8:20,7:20,@,NOR,4,4,Sun,L 10-12,,6,64,9,80,15,144
5453,DAL,2019,2019-10-20,8:20,7:20,,PHI,7,7,Sun,W 37-10,,6,65,5,40,11,105
5454,DAL,2019,2019-11-17,1:00,1:00,@,DET,11,10,Sun,W 35-27,,6,45,11,89,17,134
5455,DAL,2019,2019-12-05,8:20,7:20,@,CHI,14,13,Thu,L 24-31,,6,52,4,30,10,82
5456,DAL,2020,2020-10-04,1:00,12:00,,CLE,4,4,Sun,L 38-49,,6,65,5,40,11,105
5457,DAL,2020,2020-10-19,8:15,7:15,,ARI,6,6,Mon,L 10-38,,6,36,7,43,13,79
5458,DAL,2020,2020-10-25,1:00,1:00,@,WAS,7,7,Sun,L 3-25,,6,49,4,30,10,79
5459,DAL,2020,2021-01-03,1:00,1:00,@,NYG,17,16,Sun,L 19-23,,6,58,6,45,12,103
5460,DAL,2021,2021-11-21,4:25,3:25,@,KAN,11,10,Sun,L 9-19,,6,45,6,64,12,109
5461,DAL,2021,2021-12-19,1:00,1:00,@,NYG,15,14,Sun,W 21-6,,6,45,6,34,12,79
5462,DEN,2000,2000-09-24,4:16,2:16,,KAN,4,4,Sun,L 22-23,,6,71,8,48,14,119
5463,DEN,2000,2000-10-22,1:00,1:00,@,CIN,8,8,Sun,L 21-31,,6,38,9,69,15,107
5464,DEN,2000,2000-11-05,4:15,4:15,@,NYJ,10,9,Sun,W 30-23,,6,57,2,10,8,67
5465,DEN,2001,2001-09-10,7:07,7:07,,NYG,1,1,Mon,W 31-20,,6,36,7,35,13,71
5466,DEN,2001,2001-10-28,2:15,2:15,,NWE,7,7,Sun,W 31-20,,6,66,7,53,13,119
5467,DEN,2001,2001-11-22,4:15,3:15,@,DAL,11,11,Thu,W 26-24,,6,65,5,34,11,99
5468,DEN,2001,2001-12-09,8:35,6:35,,SEA,13,13,Sun,W 20-7,,6,45,5,62,11,107
5469,DEN,2002,2002-10-06,4:05,2:05,,SDG,5,5,Sun,W 26-9,,6,50,5,41,11,91
5470,DEN,2003,2003-09-22,9:09,7:09,,OAK,3,3,Mon,W 31-10,,6,35,13,98,19,133
5471,DEN,2003,2003-09-28,4:15,2:15,,DET,4,4,Sun,W 20-16,,6,44,8,74,14,118
5472,DEN,2003,2003-10-12,4:15,2:15,,PIT,6,6,Sun,W 17-14,,6,37,9,85,15,122
5473,DEN,2003,2003-11-30,4:15,1:15,@,OAK,13,12,Sun,W 22-8,,6,45,11,89,17,134
5474,DEN,2004,2004-11-21,1:03,12:03,@,NOR,11,10,Sun,W 34-13,,6,82,10,79,16,161
5475,DEN,2005,2005-10-09,4:15,2:15,,WAS,5,5,Sun,W 21-19,,6,43,10,67,16,110
5476,DEN,2005,2005-10-23,4:15,4:15,@,NYG,7,7,Sun,L 23-24,,6,53,7,52,13,105
5477,DEN,2005,2005-10-30,4:15,2:15,,PHI,8,8,Sun,W 49-21,,6,50,10,70,16,120
5478,DEN,2006,2006-11-19,8:21,6:21,,SDG,11,10,Sun,L 27-35,,6,60,5,35,11,95
5479,DEN,2007,2007-09-16,4:15,2:15,,OAK,2,2,Sun,W 23-20,OT,6,34,10,70,16,104
5480,DEN,2007,2007-09-23,4:05,2:05,,JAX,3,3,Sun,L 14-23,,6,36,3,14,9,50
5481,DEN,2008,2008-10-05,4:05,2:05,,TAM,5,5,Sun,W 16-13,,6,55,5,30,11,85
5482,DEN,2008,2008-11-16,1:02,1:02,@,ATL,11,10,Sun,W 24-20,,6,36,5,36,11,72
5483,DEN,2008,2008-11-30,4:15,4:15,@,NYJ,13,12,Sun,W 34-17,,6,64,4,25,10,89
5484,DEN,2008,2008-12-21,4:06,2:06,,BUF,16,15,Sun,L 23-30,,6,62,4,26,10,88
5485,DEN,2009,2009-09-13,1:02,1:02,@,CIN,1,1,Sun,W 12-7,,6,39,4,27,10,66
5486,DEN,2009,2009-11-01,1:02,1:02,@,BAL,8,7,Sun,L 7-30,,6,35,8,94,14,129
5487,DEN,2010,2010-09-26,4:16,2:16,,IND,3,3,Sun,L 13-27,,6,60,4,27,10,87
5488,DEN,2010,2010-10-03,1:02,12:02,@,TEN,4,4,Sun,W 26-20,,6,74,10,111,16,185
5489,DEN,2010,2010-11-28,4:16,2:16,,STL,12,11,Sun,L 33-36,,6,60,4,30,10,90
5490,DEN,2011,2011-11-17,8:30,6:30,,NYJ,11,10,Thu,W 17-13,,6,51,2,15,8,66
5491,DEN,2011,2012-01-01,4:16,2:16,,KAN,17,16,Sun,L 3-7,,6,49,6,36,12,85
5492,DEN,2012,2012-09-09,8:31,6:31,,PIT,1,1,Sun,W 31-19,,6,49,8,52,14,101
5493,DEN,2013,2013-10-27,4:25,2:25,,WAS,8,8,Sun,W 45-21,,6,57,1,5,7,62
5494,DEN,2013,2013-12-12,8:29,6:29,,SDG,15,14,Thu,L 20-27,,6,43,4,35,10,78
5495,DEN,2013,2013-12-29,4:25,1:25,@,OAK,17,16,Sun,W 34-14,,6,56,2,10,8,66
5496,DEN,2014,2014-12-22,8:30,8:30,@,CIN,16,15,Mon,L 28-37,,6,72,7,45,13,117
5497,DEN,2015,2015-10-11,4:25,1:25,@,OAK,5,5,Sun,W 16-10,,6,103,6,41,12,144
5498,DEN,2015,2015-11-29,8:30,6:30,,NWE,12,11,Sun,W 30-24,OT,6,46,5,47,11,93
5499,DEN,2015,2016-01-03,4:25,2:25,,SDG,17,16,Sun,W 27-20,,6,35,7,45,13,80
5500,DEN,2016,2016-10-30,4:05,2:05,,SDG,8,8,Sun,W 27-19,,6,45,8,52,14,97
5501,DEN,2017,2017-10-01,4:25,2:25,,OAK,4,4,Sun,W 16-10,,6,40,7,75,13,115
5502,DEN,2018,2018-09-16,4:25,2:25,,OAK,2,2,Sun,W 20-19,,6,35,4,30,10,65
5503,DEN,2018,2018-10-07,1:00,1:00,@,NYJ,5,5,Sun,L 16-34,,6,45,4,33,10,78
5504,DEN,2018,2018-10-14,4:05,2:05,,LAR,6,6,Sun,L 20-23,,6,61,10,81,16,142
5505,DEN,2018,2018-11-25,4:25,2:25,,PIT,12,11,Sun,W 24-17,,6,50,5,34,11,84
5506,DEN,2019,2019-09-09,10:20,7:20,@,OAK,1,1,Mon,L 16-24,,6,44,9,62,15,106
5507,DEN,2019,2019-11-17,1:00,3:00,@,MIN,11,10,Sun,L 23-27,,6,35,5,49,11,84
5508,DEN,2019,2019-12-22,4:05,2:05,,DET,16,15,Sun,W 27-17,,6,50,7,68,13,118
5509,DEN,2020,2020-12-27,4:05,1:05,@,LAC,16,15,Sun,L 16-19,,6,44,6,45,12,89
5510,DEN,2021,2021-09-26,4:05,2:05,,NYJ,3,3,Sun,W 26-0,,6,50,9,90,15,140
5511,DEN,2021,2021-10-17,4:25,2:25,,LVR,6,6,Sun,L 24-34,,6,53,6,54,12,107
5512,DEN,2021,2021-12-19,4:05,2:05,,CIN,15,14,Sun,L 10-15,,6,60,6,38,12,98
5513,DEN,2021,2022-01-08,4:30,2:30,,KAN,18,17,Sat,L 24-28,,6,45,5,45,11,90
5514,DET,2000,2000-09-24,1:02,12:02,@,CHI,4,4,Sun,W 21-14,,6,39,9,78,15,117
5515,DET,2000,2000-10-08,1:01,1:01,,GNB,6,6,Sun,W 31-24,,6,50,4,29,10,79
5516,DET,2000,2000-11-19,1:03,1:03,@,NYG,12,11,Sun,W 31-21,,6,55,10,103,16,158
5517,DET,2001,2001-11-18,4:15,2:15,@,ARI,10,9,Sun,L 38-45,,6,69,5,59,11,128
5518,DET,2002,2002-09-08,1:04,1:04,@,MIA,1,1,Sun,L 21-49,,6,68,4,54,10,122
5519,DET,2002,2002-11-03,1:04,1:04,,DAL,9,8,Sun,W 9-7,,6,50,7,70,13,120
5520,DET,2002,2002-12-15,1:04,1:04,,TAM,15,14,Sun,L 20-23,,6,36,9,67,15,103
5521,DET,2002,2002-12-29,1:02,1:02,,MIN,17,16,Sun,L 36-38,,6,60,7,79,13,139
5522,DET,2003,2003-09-07,1:06,1:06,,ARI,1,1,Sun,W 42-24,,6,36,12,80,18,116
5523,DET,2003,2003-12-28,1:03,1:03,,STL,17,16,Sun,W 30-20,,6,50,7,35,13,85
5524,DET,2004,2004-09-26,1:03,1:03,,PHI,3,3,Sun,L 13-30,,6,39,7,54,13,93
5525,DET,2004,2004-12-26,1:03,1:03,,CHI,16,15,Sun,W 19-13,,6,47,8,55,14,102
5526,DET,2004,2005-01-02,1:03,12:03,@,TEN,17,16,Sun,L 19-24,,6,52,7,50,13,102
5527,DET,2005,2005-11-06,1:05,12:05,@,MIN,9,8,Sun,L 14-27,,6,31,3,18,9,49
5528,DET,2006,2006-09-24,1:02,1:02,,GNB,3,3,Sun,L 24-31,,6,46,5,30,11,76
5529,DET,2006,2006-10-15,1:03,1:03,,BUF,6,6,Sun,W 20-17,,6,40,2,20,8,60
5530,DET,2006,2006-12-10,1:03,1:03,,MIN,14,13,Sun,L 20-30,,6,50,7,50,13,100
5531,DET,2006,2006-12-17,1:02,12:02,@,GNB,15,14,Sun,L 9-17,,6,37,9,69,15,106
5532,DET,2007,2007-09-09,4:15,1:15,@,OAK,1,1,Sun,W 36-21,,6,35,8,50,14,85
5533,DET,2007,2007-12-02,1:05,12:05,@,MIN,13,12,Sun,L 10-42,,6,48,4,25,10,73
5534,DET,2007,2007-12-16,4:15,1:15,@,SDG,15,14,Sun,L 14-51,,6,38,5,25,11,63
5535,DET,2008,2008-10-05,1:02,1:02,,CHI,5,4,Sun,L 7-34,,6,41,6,45,12,86
5536,DET,2008,2008-11-09,1:02,1:02,,JAX,10,9,Sun,L 14-38,,6,46,5,33,11,79
5537,DET,2008,2008-12-14,1:02,1:02,@,IND,15,14,Sun,L 21-31,,6,48,5,31,11,79
5538,DET,2008,2008-12-21,1:03,1:03,,NOR,16,15,Sun,L 7-42,,6,35,3,12,9,47
5539,DET,2009,2009-09-20,1:03,1:03,,MIN,2,2,Sun,L 13-27,,6,45,5,43,11,88
5540,DET,2009,2009-10-11,1:02,1:02,,PIT,5,5,Sun,L 20-28,,6,66,6,59,12,125
5541,DET,2009,2009-10-18,1:02,12:02,@,GNB,6,6,Sun,L 0-26,,6,40,13,130,19,170
5542,DET,2009,2010-01-03,1:03,1:03,,CHI,17,16,Sun,L 23-37,,6,35,5,35,11,70
5543,DET,2010,2010-12-05,1:03,1:03,,CHI,13,12,Sun,L 20-24,,6,42,4,25,10,67
5544,DET,2010,2010-12-12,1:03,1:03,,GNB,14,13,Sun,W 7-3,,6,35,3,20,9,55
5545,DET,2010,2010-12-26,1:03,1:03,@,MIA,16,15,Sun,W 34-27,,6,53,8,63,14,116
5546,DET,2011,2011-10-16,1:03,1:03,,SFO,6,6,Sun,L 19-25,,6,54,15,120,21,174
5547,DET,2012,2012-11-11,1:05,12:05,@,MIN,10,9,Sun,L 24-34,,6,57,7,47,13,104
5548,DET,2013,2013-12-29,1:05,12:05,@,MIN,17,16,Sun,L 13-14,,6,52,4,25,10,77
5549,DET,2014,2014-09-21,1:02,1:02,,GNB,3,3,Sun,W 19-7,,6,40,5,30,11,70
5550,DET,2015,2015-09-20,1:03,12:03,@,MIN,2,2,Sun,L 16-26,,6,39,10,97,16,136
5551,DET,2016,2016-11-06,1:00,3:00,@,MIN,9,9,Sun,W 22-16,OT,6,57,8,54,14,111
5552,DET,2016,2016-12-04,1:00,12:00,@,NOR,13,12,Sun,W 28-13,,6,39,10,83,16,122
5553,DET,2017,2017-09-18,8:30,8:30,@,NYG,2,2,Mon,W 24-10,,6,50,7,50,13,100
5554,DET,2017,2017-10-01,1:00,3:00,@,MIN,4,4,Sun,W 14-7,,6,60,2,10,8,70
5555,DET,2017,2017-10-29,8:30,8:30,,PIT,8,7,Sun,L 15-20,,6,57,5,37,11,94
5556,DET,2017,2017-11-19,1:00,12:00,@,CHI,11,10,Sun,W 27-24,,6,49,5,64,11,113
5557,DET,2017,2017-12-03,1:00,1:00,@,BAL,13,12,Sun,L 20-44,,6,45,2,25,8,70
5558,DET,2018,2018-09-23,8:20,8:20,,NWE,3,3,Sun,W 26-10,,6,70,5,38,11,108
5559,DET,2018,2018-10-21,1:00,1:00,@,MIA,7,6,Sun,W 32-21,,6,43,4,50,10,93
5560,DET,2018,2018-11-11,1:00,12:00,@,CHI,10,9,Sun,L 22-34,,6,41,6,46,12,87
5561,DET,2019,2019-11-24,1:00,1:00,@,WAS,12,11,Sun,L 16-19,,6,65,8,63,14,128
5562,DET,2021,2021-12-12,4:05,2:05,@,DEN,14,13,Sun,L 10-38,,6,53,2,18,8,71
5563,DET,2021,2021-12-19,1:00,1:00,,ARI,15,14,Sun,W 30-12,,6,49,7,83,13,132
5564,DET,2021,2021-12-26,1:00,1:00,@,ATL,16,15,Sun,L 16-20,,6,30,2,15,8,45
5565,GNB,2000,2000-09-24,4:06,1:06,@,ARI,4,4,Sun,W 29-3,,6,53,5,45,11,98
5566,GNB,2000,2000-11-27,9:12,9:12,@,CAR,13,12,Mon,L 14-31,,6,55,2,25,8,80
5567,GNB,2000,2000-12-24,1:02,12:02,,TAM,17,16,Sun,W 17-14,OT,6,43,4,54,10,97
5568,GNB,2001,2001-09-30,1:03,1:03,@,CAR,3,3,Sun,W 28-7,,6,45,3,35,9,80
5569,GNB,2001,2001-10-14,1:02,12:02,,BAL,5,5,Sun,W 31-23,,6,29,10,85,16,114
5570,GNB,2001,2001-12-30,1:02,12:02,,MIN,16,15,Sun,W 24-13,,6,60,8,43,14,103
5571,GNB,2003,2003-09-07,1:04,12:04,,MIN,1,1,Sun,L 25-30,,6,60,7,65,13,125
5572,GNB,2003,2003-10-19,1:02,12:02,@,STL,7,7,Sun,L 24-34,,6,40,8,64,14,104
5573,GNB,2003,2003-11-27,12:37,12:37,@,DET,13,12,Thu,L 14-22,,6,49,5,40,11,89
5574,GNB,2004,2004-09-19,1:02,12:02,,CHI,2,2,Sun,L 10-21,,6,50,2,15,8,65
5575,GNB,2004,2004-10-24,4:15,3:15,,DAL,7,7,Sun,W 41-20,,6,40,6,37,12,77
5576,GNB,2005,2005-09-18,4:15,3:15,,CLE,2,2,Sun,L 24-26,,6,41,6,40,12,81
5577,GNB,2005,2005-10-09,1:02,12:02,,NOR,5,5,Sun,W 52-3,,6,36,11,107,17,143
5578,GNB,2005,2005-10-23,1:00,12:00,@,MIN,7,6,Sun,L 20-23,,6,50,4,21,10,71
5579,GNB,2007,2007-09-09,1:02,12:02,,PHI,1,1,Sun,W 16-13,,6,35,8,76,14,111
5580,GNB,2007,2007-09-30,1:05,12:05,@,MIN,4,4,Sun,W 23-16,,6,40,7,40,13,80
5581,GNB,2007,2007-11-18,1:02,12:02,,CAR,11,10,Sun,W 31-17,,6,75,4,25,10,100
5582,GNB,2007,2007-12-16,1:00,12:00,@,STL,15,14,Sun,W 33-14,,6,35,13,93,19,128
5583,GNB,2008,2008-11-16,1:02,12:02,,CHI,11,10,Sun,W 37-3,,6,55,8,65,14,120
5584,GNB,2008,2008-12-07,1:02,12:02,,HOU,14,13,Sun,L 21-24,,6,65,4,30,10,95
5585,GNB,2008,2008-12-22,8:40,7:40,@,CHI,16,15,Mon,L 17-20,OT,6,50,4,35,10,85
5586,GNB,2008,2008-12-28,1:02,12:02,,DET,17,16,Sun,W 31-21,,6,60,5,60,11,120
5587,GNB,2009,2009-09-13,8:30,7:30,,CHI,1,1,Sun,W 21-15,,6,45,3,25,9,70
5588,GNB,2009,2009-09-27,1:00,12:00,@,STL,3,3,Sun,W 36-17,,6,51,6,40,12,91
5589,GNB,2009,2009-11-01,4:15,3:15,,MIN,8,7,Sun,L 26-38,,6,45,3,29,9,74
5590,GNB,2009,2009-11-22,1:02,12:02,,SFO,11,10,Sun,W 30-24,,6,64,4,30,10,94
5591,GNB,2010,2010-09-19,1:02,12:02,,BUF,2,2,Sun,W 34-7,,6,49,4,35,10,84
5592,GNB,2011,2011-09-08,8:40,7:40,,NOR,1,1,Thu,W 42-34,,6,48,3,15,9,63
5593,GNB,2011,2011-10-09,8:30,8:30,@,ATL,5,5,Sun,W 25-14,,6,55,5,44,11,99
5594,GNB,2011,2011-10-23,4:15,3:15,@,MIN,7,7,Sun,W 33-27,,6,44,9,91,15,135
5595,GNB,2011,2012-01-01,1:02,12:02,,DET,17,16,Sun,W 45-41,,6,78,11,101,17,179
5596,GNB,2013,2013-10-27,8:30,7:30,@,MIN,8,7,Sun,W 44-31,,6,120,7,46,13,166
5597,GNB,2015,2015-09-20,8:25,7:25,,SEA,2,2,Sun,W 27-17,,6,35,6,92,12,127
5598,GNB,2015,2015-10-18,4:25,3:25,,SDG,6,6,Sun,W 27-20,,6,50,9,76,15,126
5599,GNB,2015,2015-12-20,4:05,1:05,@,OAK,15,14,Sun,W 30-20,,6,75,10,95,16,170
5600,GNB,2016,2016-09-18,8:32,7:32,@,MIN,2,2,Sun,L 14-17,,6,72,13,137,19,209
5601,GNB,2016,2016-10-09,8:30,7:30,,NYG,5,4,Sun,W 23-16,,6,57,6,51,12,108
5602,GNB,2016,2016-10-30,4:25,4:25,@,ATL,8,7,Sun,L 32-33,,6,68,7,46,13,114
5603,GNB,2016,2016-11-20,8:30,8:30,@,WAS,11,10,Sun,L 24-42,,6,59,6,40,12,99
5604,GNB,2017,2017-10-08,4:25,3:25,@,DAL,5,5,Sun,W 35-31,,6,38,7,70,13,108
5605,GNB,2017,2017-12-17,1:00,1:00,@,CAR,15,14,Sun,L 24-31,,6,28,5,40,11,68
5606,GNB,2017,2017-12-23,8:30,7:30,,MIN,16,15,Sat,L 0-16,,6,79,2,10,8,89
5607,GNB,2018,2018-10-15,8:15,7:15,,SFO,6,6,Mon,W 33-30,,6,54,2,10,8,64
5608,GNB,2018,2018-11-11,4:25,12:00,,MIA,10,9,Sun,W 31-12,,6,45,3,10,9,55
5609,GNB,2018,2018-12-09,1:00,12:00,,ATL,14,13,Sun,W 34-20,,6,37,13,101,19,138
5610,GNB,2019,2019-09-15,1:00,12:00,,MIN,2,2,Sun,W 21-16,,6,35,8,100,14,135
5611,GNB,2019,2019-10-14,8:15,7:15,,DET,6,6,Mon,W 23-22,,6,48,8,50,14,98
5612,GNB,2020,2020-09-13,1:00,3:00,@,MIN,1,1,Sun,W 43-34,,6,63,5,20,11,83
5613,GNB,2020,2020-10-18,4:25,4:25,@,TAM,6,5,Sun,L 10-38,,6,76,0,0,6,76
5614,HOU,2002,2002-10-20,4:05,4:05,@,CLE,7,6,Sun,L 17-34,,6,54,4,42,10,96
5615,HOU,2003,2003-10-12,1:03,12:03,@,TEN,6,5,Sun,L 17-38,,6,50,8,69,14,119
5616,HOU,2003,2003-11-09,1:03,1:03,@,CIN,10,9,Sun,L 27-34,,6,58,7,55,13,113
5617,HOU,2003,2003-11-23,1:02,12:02,,NWE,12,11,Sun,L 20-23,OT,6,45,5,58,11,103
5618,HOU,2003,2003-12-28,1:03,12:03,,IND,17,16,Sun,L 17-20,,6,40,6,60,12,100
5619,HOU,2004,2004-09-12,1:05,12:05,,SDG,1,1,Sun,L 20-27,,6,83,8,60,14,143
5620,HOU,2004,2004-12-12,1:02,12:02,,IND,14,13,Sun,L 14-23,,6,30,8,50,14,80
5621,HOU,2004,2004-12-26,1:03,1:03,@,JAX,16,15,Sun,W 21-0,,6,50,5,45,11,95
5622,HOU,2005,2005-09-11,1:05,1:05,@,BUF,1,1,Sun,L 7-22,,6,38,10,71,16,109
5623,HOU,2005,2005-10-09,1:02,12:02,,TEN,5,4,Sun,L 20-34,,6,39,7,65,13,104
5624,HOU,2005,2005-11-20,8:37,7:37,,KAN,11,10,Sun,L 17-45,,6,43,5,30,11,73
5625,HOU,2006,2006-11-12,1:03,1:03,@,JAX,10,9,Sun,W 13-10,,6,51,9,65,15,116
5626,HOU,2007,2007-09-09,1:05,12:05,,KAN,1,1,Sun,W 20-3,,6,45,5,40,11,85
5627,HOU,2007,2007-10-07,1:02,12:02,,MIA,5,5,Sun,W 22-19,,6,67,6,50,12,117
5628,HOU,2007,2007-12-23,1:02,1:02,@,IND,16,15,Sun,L 15-38,,6,55,5,40,11,95
5629,HOU,2009,2009-09-13,1:03,12:03,,NYJ,1,1,Sun,L 7-24,,6,37,10,80,16,117
5630,HOU,2009,2009-09-20,1:03,12:03,@,TEN,2,2,Sun,W 34-31,,6,40,8,64,14,104
5631,HOU,2009,2009-10-11,4:15,1:15,@,ARI,5,5,Sun,L 21-28,,6,53,7,40,13,93
5632,HOU,2009,2009-12-06,1:03,1:03,@,JAX,13,12,Sun,L 18-23,,6,37,4,45,10,82
5633,HOU,2010,2010-11-28,1:02,12:02,,TEN,12,11,Sun,W 20-0,,6,68,10,79,16,147
5634,HOU,2011,2011-10-09,1:02,12:02,,OAK,5,5,Sun,L 20-25,,6,50,11,89,17,139
5635,HOU,2011,2011-10-23,1:02,12:02,@,TEN,7,7,Sun,W 41-7,,6,68,8,76,14,144
5636,HOU,2011,2011-12-18,1:03,12:03,,CAR,15,14,Sun,L 13-28,,6,60,7,40,13,100
5637,HOU,2013,2013-09-29,1:03,12:03,,SEA,4,4,Sun,L 20-23,OT,6,86,9,62,15,148
5638,HOU,2014,2014-09-07,1:03,12:03,,WAS,1,1,Sun,W 17-6,,6,45,7,71,13,116
5639,HOU,2014,2014-12-28,1:03,12:03,,JAX,17,16,Sun,W 23-17,,6,55,4,25,10,80
5640,HOU,2015,2015-09-13,1:02,12:02,,KAN,1,1,Sun,L 20-27,,6,39,2,25,8,64
5641,HOU,2015,2015-09-27,1:03,12:03,,TAM,3,3,Sun,W 19-9,,6,58,10,84,16,142
5642,HOU,2015,2015-11-29,1:02,12:02,,NOR,12,11,Sun,W 24-6,,6,40,10,82,16,122
5643,HOU,2015,2015-12-20,1:02,1:02,@,IND,15,14,Sun,W 16-10,,6,48,8,94,14,142
5644,HOU,2016,2016-09-11,1:05,12:05,,CHI,1,1,Sun,W 23-14,,6,69,4,30,10,99
5645,HOU,2016,2016-09-22,8:26,8:26,@,NWE,3,3,Thu,L 0-27,,6,43,3,15,9,58
5646,HOU,2016,2016-10-02,1:02,12:02,,TEN,4,4,Sun,W 27-20,,6,59,11,93,17,152
5647,HOU,2016,2016-10-30,1:03,12:03,,DET,8,8,Sun,W 20-13,,6,49,8,75,14,124
5648,HOU,2016,2016-12-18,1:00,12:00,,JAX,15,14,Sun,W 21-20,,6,71,12,91,18,162
5649,HOU,2016,2017-01-01,1:00,12:00,@,TEN,17,16,Sun,L 17-24,,6,35,7,50,13,85
5650,HOU,2017,2017-11-19,1:00,12:00,,ARI,11,10,Sun,W 31-21,,6,42,10,90,16,132
5651,HOU,2017,2017-11-27,8:30,8:30,@,BAL,12,11,Mon,L 16-23,,6,36,7,89,13,125
5652,HOU,2018,2018-09-09,1:00,1:00,@,NWE,1,1,Sun,L 20-27,,6,44,6,36,12,80
5653,HOU,2018,2018-10-14,1:00,12:00,,BUF,6,6,Sun,W 20-13,,6,50,12,104,18,154
5654,HOU,2018,2018-10-21,1:00,1:00,@,JAX,7,7,Sun,W 20-7,,6,35,2,15,8,50
5655,HOU,2019,2019-09-22,4:25,1:25,@,LAC,3,3,Sun,W 27-20,,6,65,7,69,13,134
5656,HOU,2020,2020-10-25,1:00,12:00,,GNB,7,7,Sun,L 20-35,,6,55,5,40,11,95
5657,HOU,2020,2020-11-15,1:00,1:00,@,CLE,10,9,Sun,L 7-10,,6,49,6,63,12,112
5658,HOU,2020,2020-12-13,1:00,12:00,@,CHI,14,13,Sun,L 7-36,,6,50,7,44,13,94
5659,HOU,2020,2020-12-27,1:00,12:00,,CIN,16,15,Sun,L 31-37,,6,46,5,35,11,81
5660,HOU,2020,2021-01-03,4:25,3:25,,TEN,17,16,Sun,L 38-41,,6,44,6,50,12,94
5661,HOU,2021,2021-10-31,1:00,12:00,,LAR,8,8,Sun,L 22-38,,6,38,3,20,9,58
5662,HOU,2021,2021-12-12,1:00,12:00,,SEA,14,13,Sun,L 13-33,,6,52,8,69,14,121
5663,JAX,2000,2000-10-08,8:35,8:35,,BAL,6,6,Sun,L 10-15,,6,34,5,25,11,59
5664,JAX,2000,2000-12-17,1:02,1:02,@,CIN,16,15,Sun,L 14-17,,6,47,6,40,12,87
5665,JAX,2001,2001-11-11,1:03,1:03,,CIN,9,8,Sun,W 30-13,,6,32,10,107,16,139
5666,JAX,2002,2002-12-29,4:05,4:05,@,IND,17,16,Sun,L 13-20,,6,47,6,35,12,82
5667,JAX,2004,2004-10-24,1:00,12:00,@,IND,7,7,Sun,W 27-24,,6,48,12,62,18,110
5668,JAX,2004,2004-11-28,1:00,12:00,@,MIN,12,11,Sun,L 16-27,,6,45,4,35,10,80
5669,JAX,2005,2005-09-11,1:07,1:07,,SEA,1,1,Sun,W 26-14,,6,31,5,29,11,60
5670,JAX,2005,2005-11-06,1:01,1:01,,HOU,9,8,Sun,W 21-14,,6,45,4,30,10,75
5671,JAX,2005,2005-12-24,1:03,12:03,@,HOU,16,15,Sat,W 38-20,,6,50,7,40,13,90
5672,JAX,2007,2007-12-09,1:03,1:03,,CAR,14,13,Sun,W 37-6,,6,40,5,50,11,90
5673,JAX,2007,2007-12-23,1:02,1:02,,OAK,16,15,Sun,W 49-11,,6,42,11,88,17,130
5674,JAX,2008,2008-09-07,1:05,12:05,@,TEN,1,1,Sun,L 10-17,,6,50,5,36,11,86
5675,JAX,2008,2008-10-12,4:05,2:05,@,DEN,6,6,Sun,W 24-17,,6,45,4,52,10,97
5676,JAX,2008,2008-10-26,4:05,4:05,,CLE,8,7,Sun,L 17-23,,6,40,1,15,7,55
5677,JAX,2008,2008-12-14,1:04,1:04,,GNB,15,14,Sun,W 20-16,,6,58,3,30,9,88
5678,JAX,2009,2009-11-22,1:03,1:03,,BUF,11,10,Sun,W 18-15,,6,50,6,43,12,93
5679,JAX,2009,2009-11-29,4:05,1:05,@,SFO,12,11,Sun,L 3-20,,6,60,1,5,7,65
5680,JAX,2010,2010-10-24,1:03,12:03,@,KAN,7,7,Sun,L 20-42,,6,43,7,92,13,135
5681,JAX,2010,2010-10-31,1:05,12:05,@,DAL,8,8,Sun,W 35-17,,6,36,3,20,9,56
5682,JAX,2010,2010-12-12,1:02,1:02,,OAK,14,13,Sun,W 38-31,,6,52,4,25,10,77
5683,JAX,2010,2010-12-19,1:02,1:02,@,IND,15,14,Sun,L 24-34,,6,55,6,68,12,123
5684,JAX,2011,2011-10-24,8:40,8:40,,BAL,7,7,Mon,W 12-7,,6,90,10,85,16,175
5685,JAX,2011,2011-12-24,1:02,12:02,@,TEN,16,15,Sat,L 17-23,,6,28,0,0,6,28
5686,JAX,2012,2012-09-23,1:03,1:03,@,IND,3,3,Sun,W 22-17,,6,67,11,106,17,173
5687,JAX,2012,2012-10-07,4:05,4:05,,CHI,5,5,Sun,L 3-41,,6,49,12,80,18,129
5688,JAX,2012,2012-10-21,4:25,1:25,@,OAK,7,6,Sun,L 23-26,OT,6,92,9,58,15,150
5689,JAX,2012,2012-11-18,1:03,12:03,@,HOU,11,10,Sun,L 37-43,OT,6,54,2,20,8,74
5690,JAX,2013,2013-10-20,1:02,1:02,,SDG,7,7,Sun,L 6-24,,6,45,8,61,14,106
5691,JAX,2013,2013-10-27,1:07,5:07,,SFO,8,8,Sun,L 10-42,,6,76,4,35,10,111
5692,JAX,2013,2013-11-17,1:04,1:04,,ARI,11,10,Sun,L 14-27,,6,40,5,42,11,82
5693,JAX,2013,2013-12-15,1:02,1:02,,BUF,15,14,Sun,L 20-27,,6,80,7,67,13,147
5694,JAX,2014,2014-09-14,1:05,1:05,@,WAS,2,2,Sun,L 10-41,,6,44,11,98,17,142
5695,JAX,2014,2014-10-12,1:02,12:02,@,TEN,6,6,Sun,L 14-16,,6,35,5,48,11,83
5696,JAX,2014,2014-10-26,1:02,1:02,,MIA,8,8,Sun,L 13-27,,6,37,7,52,13,89
5697,JAX,2014,2014-11-23,1:02,1:02,@,IND,12,11,Sun,L 3-23,,6,43,6,54,12,97
5698,JAX,2014,2014-12-07,1:03,1:03,,HOU,14,13,Sun,L 13-27,,6,40,7,64,13,104
5699,JAX,2015,2015-11-29,1:03,1:03,,SDG,12,11,Sun,L 25-31,,6,35,8,70,14,105
5700,JAX,2015,2015-12-06,1:02,12:02,@,TEN,13,12,Sun,L 39-42,,6,21,4,38,10,59
5701,JAX,2016,2016-11-27,1:00,1:00,@,BUF,12,11,Sun,L 21-28,,6,60,6,31,12,91
5702,JAX,2016,2016-12-04,1:00,1:00,,DEN,13,12,Sun,L 10-20,,6,65,4,32,10,97
5703,JAX,2017,2017-10-01,1:00,1:00,@,NYJ,4,4,Sun,L 20-23,OT,6,47,10,70,16,117
5704,JAX,2017,2017-11-19,1:00,1:00,@,CLE,11,10,Sun,W 19-7,,6,40,0,0,6,40
5705,JAX,2017,2017-12-03,1:00,1:00,,IND,13,12,Sun,W 30-10,,6,55,4,31,10,86
5706,JAX,2017,2017-12-31,4:25,12:00,@,TEN,17,16,Sun,L 10-15,,6,41,2,15,8,56
5707,JAX,2019,2019-12-22,1:00,1:00,@,ATL,16,15,Sun,L 12-24,,6,36,9,64,15,100
5708,JAX,2020,2020-09-13,1:00,1:00,,IND,1,1,Sun,W 27-20,,6,61,5,80,11,141
5709,JAX,2020,2020-10-04,1:00,1:00,@,CIN,4,4,Sun,L 25-33,,6,49,7,73,13,122
5710,JAX,2020,2020-10-25,4:25,1:25,@,LAC,7,7,Sun,L 29-39,,6,55,3,35,9,90
5711,JAX,2021,2021-11-28,1:00,1:00,,ATL,12,11,Sun,L 14-21,,6,43,5,26,11,69
5712,JAX,2021,2022-01-09,1:00,1:00,,IND,18,17,Sun,W 26-11,,6,49,4,52,10,101
5713,KAN,2000,2000-09-03,1:00,12:00,,IND,1,1,Sun,L 14-27,,6,50,7,78,13,128
5714,KAN,2000,2000-09-17,4:05,3:05,,SDG,3,3,Sun,W 42-10,,6,30,8,86,14,116
5715,KAN,2000,2000-10-15,1:00,12:00,,OAK,7,6,Sun,L 17-20,,6,40,8,69,14,109
5716,KAN,2000,2000-10-22,1:00,12:00,,STL,8,7,Sun,W 54-34,,6,50,8,87,14,137
5717,KAN,2000,2000-12-17,1:00,12:00,,DEN,16,15,Sun,W 20-7,,6,51,7,51,13,102
5718,KAN,2001,2001-11-04,4:15,1:15,@,SDG,8,8,Sun,W 25-20,,6,61,4,20,10,81
5719,KAN,2001,2001-12-09,4:15,1:15,@,OAK,13,12,Sun,L 26-28,,6,50,5,34,11,84
5720,KAN,2003,2003-11-30,4:15,1:15,@,SDG,13,12,Sun,W 28-24,,6,55,5,55,11,110
5721,KAN,2003,2003-12-14,1:00,12:00,,DET,15,14,Sun,W 45-17,,6,55,5,32,11,87
5722,KAN,2003,2003-12-28,1:00,12:00,,CHI,17,16,Sun,W 31-3,,6,55,8,78,14,133
5723,KAN,2004,2004-12-19,1:00,12:00,,DEN,15,14,Sun,W 45-17,,6,58,10,100,16,158
5724,KAN,2005,2005-10-02,4:15,3:15,,PHI,4,4,Sun,L 31-37,,6,40,3,25,9,65
5725,KAN,2005,2005-12-04,4:15,3:15,,DEN,13,12,Sun,W 31-27,,6,45,8,55,14,100
5726,KAN,2006,2006-10-15,4:15,4:15,@,PIT,6,5,Sun,L 7-45,,6,50,5,41,11,91
5727,KAN,2006,2006-10-22,1:00,12:00,,SDG,7,6,Sun,W 30-27,,6,50,7,60,13,110
5728,KAN,2006,2006-10-29,1:00,12:00,,SEA,8,7,Sun,W 35-28,,6,40,4,35,10,75
5729,KAN,2006,2006-12-10,1:00,12:00,,BAL,14,13,Sun,L 10-20,,6,35,6,75,12,110
5730,KAN,2007,2007-11-04,1:00,12:00,,GNB,9,8,Sun,L 22-33,,6,55,13,112,19,167
5731,KAN,2007,2007-12-02,1:00,12:00,,SDG,13,12,Sun,L 10-24,,6,44,6,36,12,80
5732,KAN,2007,2007-12-23,1:02,1:02,@,DET,16,15,Sun,L 20-25,,6,46,4,20,10,66
5733,KAN,2008,2008-11-16,1:00,12:00,,NOR,11,10,Sun,L 20-30,,6,40,2,8,8,48
5734,KAN,2008,2008-11-30,4:15,1:15,@,OAK,13,12,Sun,W 20-13,,6,57,5,39,11,96
5735,KAN,2008,2008-12-28,1:02,1:02,@,CIN,17,16,Sun,L 6-16,,6,73,4,43,10,116
5736,KAN,2009,2009-12-27,1:03,1:03,@,CIN,16,15,Sun,L 10-17,,6,40,6,36,12,76
5737,KAN,2010,2010-11-14,4:05,2:05,@,DEN,10,9,Sun,L 29-49,,6,40,3,28,9,68
5738,KAN,2011,2011-10-02,1:02,12:02,,MIN,4,4,Sun,W 22-17,,6,57,6,45,12,102
5739,KAN,2011,2012-01-01,4:16,2:16,@,DEN,17,16,Sun,W 7-3,,6,36,6,49,12,85
5740,KAN,2012,2012-09-23,1:02,12:02,@,NOR,3,3,Sun,W 27-24,OT,6,40,4,45,10,85
5741,KAN,2012,2012-11-12,8:40,8:40,@,PIT,10,9,Mon,L 13-16,OT,6,76,2,19,8,95
5742,KAN,2012,2012-11-18,1:03,12:03,,CIN,11,10,Sun,L 6-28,,6,30,8,54,14,84
5743,KAN,2015,2015-10-25,1:03,12:03,,PIT,7,7,Sun,W 23-13,,6,66,1,5,7,71
5744,KAN,2015,2015-12-20,1:02,1:02,@,BAL,15,14,Sun,W 34-14,,6,55,7,63,13,118
5745,KAN,2016,2016-09-11,1:05,12:05,,SDG,1,1,Sun,W 33-27,OT,6,46,5,30,11,76
5746,KAN,2016,2016-10-30,1:02,1:02,@,IND,8,7,Sun,W 30-14,,6,40,5,45,11,85
5747,KAN,2017,2017-10-08,8:30,7:30,@,HOU,5,5,Sun,W 42-34,,6,64,7,59,13,123
5748,KAN,2017,2017-11-26,1:00,12:00,,BUF,12,11,Sun,L 10-16,,6,50,6,50,12,100
5749,KAN,2018,2018-09-09,4:05,1:05,@,LAC,1,1,Sun,W 38-28,,6,50,7,45,13,95
5750,KAN,2018,2018-09-23,1:00,12:00,,SFO,3,3,Sun,W 38-27,,6,48,14,147,20,195
5751,KAN,2019,2019-10-17,8:20,6:20,@,DEN,7,7,Thu,W 30-6,,6,46,4,33,10,79
5752,KAN,2020,2020-09-28,8:15,8:15,@,BAL,3,3,Mon,W 34-20,,6,38,6,45,12,83
5753,KAN,2020,2020-12-27,1:00,12:00,,ATL,16,15,Sun,W 17-14,,6,41,7,45,13,86
5754,KAN,2021,2021-09-26,1:00,12:00,,LAC,3,3,Sun,L 24-30,,6,56,8,50,14,106
5755,KAN,2021,2021-11-07,4:25,3:25,,GNB,9,9,Sun,W 13-7,,6,33,4,19,10,52
5756,KAN,2021,2021-11-21,4:25,3:25,,DAL,11,11,Sun,W 19-9,,6,64,6,45,12,109
5757,MIA,2000,2000-09-03,4:16,4:16,,SEA,1,1,Sun,W 23-0,,6,36,2,10,8,46
5758,MIA,2000,2000-09-17,8:36,8:36,,BAL,3,3,Sun,W 19-6,,6,38,4,20,10,58
5759,MIA,2000,2000-12-10,1:02,1:02,,TAM,15,14,Sun,L 13-16,,6,46,7,63,13,109
5760,MIA,2001,2001-10-14,4:15,4:15,@,NYJ,5,5,Sun,L 17-21,,6,72,3,30,9,102
5761,MIA,2002,2002-10-20,1:03,1:03,,BUF,7,7,Sun,L 10-23,,6,56,4,40,10,96
5762,MIA,2002,2002-11-04,9:08,8:08,@,GNB,9,8,Mon,L 10-24,,6,55,9,71,15,126
5763,MIA,2002,2002-11-10,8:35,8:35,@,NYJ,10,9,Sun,L 10-13,,6,30,5,36,11,66
5764,MIA,2002,2002-12-29,1:02,1:02,@,NWE,17,16,Sun,L 24-27,OT,6,83,4,20,10,103
5765,MIA,2003,2003-10-05,1:03,1:03,@,NYG,5,4,Sun,W 23-10,,6,50,5,35,11,85
5766,MIA,2003,2003-11-27,4:16,3:16,@,DAL,13,12,Thu,W 40-21,,6,69,5,50,11,119
5767,MIA,2004,2004-09-26,8:36,8:36,,PIT,3,3,Sun,L 3-13,,6,33,11,103,17,136
5768,MIA,2006,2006-09-07,8:37,8:37,@,PIT,1,1,Thu,L 17-28,,6,63,1,10,7,73
5769,MIA,2006,2006-09-17,1:03,1:03,,BUF,2,2,Sun,L 6-16,,6,75,4,30,10,105
5770,MIA,2006,2006-10-15,4:15,4:15,@,NYJ,6,6,Sun,L 17-20,,6,61,8,70,14,131
5771,MIA,2007,2007-10-07,1:02,12:02,@,HOU,5,5,Sun,L 19-22,,6,50,6,67,12,117
5772,MIA,2007,2007-12-09,1:02,1:02,@,BUF,14,13,Sun,L 17-38,,6,55,8,64,14,119
5773,MIA,2008,2008-09-14,4:15,1:15,@,ARI,2,2,Sun,L 10-31,,6,42,8,45,14,87
5774,MIA,2008,2008-10-19,1:02,1:02,,BAL,7,6,Sun,L 13-27,,6,28,7,67,13,95
5775,MIA,2008,2008-12-28,4:17,4:17,@,NYJ,17,16,Sun,W 24-17,,6,30,5,36,11,66
5776,MIA,2009,2009-11-29,1:02,1:02,@,BUF,12,11,Sun,L 14-31,,6,50,3,20,9,70
5777,MIA,2010,2010-09-26,8:30,8:30,,NYJ,3,3,Sun,L 23-31,,6,52,9,81,15,133
5778,MIA,2010,2010-10-04,8:41,8:41,,NWE,4,4,Mon,L 14-41,,6,40,3,31,9,71
5779,MIA,2011,2011-11-13,1:03,1:03,,WAS,10,9,Sun,W 20-9,,6,55,6,51,12,106
5780,MIA,2011,2011-11-24,4:16,3:16,@,DAL,12,11,Thu,L 19-20,,6,55,11,69,17,124
5781,MIA,2011,2011-12-24,1:02,1:02,@,NWE,16,15,Sat,L 24-27,,6,39,5,50,11,89
5782,MIA,2012,2012-11-15,8:29,8:29,@,BUF,11,10,Thu,L 14-19,,6,69,11,100,17,169
5783,MIA,2013,2013-11-24,1:03,1:03,,CAR,12,11,Sun,L 16-20,,6,55,8,56,14,111
5784,MIA,2013,2013-12-22,1:02,1:02,@,BUF,16,15,Sun,L 0-19,,6,37,4,31,10,68
5785,MIA,2014,2014-09-21,4:25,4:25,,KAN,3,3,Sun,L 15-34,,6,65,4,23,10,88
5786,MIA,2014,2014-11-23,4:25,2:25,@,DEN,12,11,Sun,L 36-39,,6,50,9,98,15,148
5787,MIA,2014,2014-12-07,1:02,1:02,,BAL,14,13,Sun,L 13-28,,6,30,7,36,13,66
5788,MIA,2015,2015-09-13,1:02,1:02,@,WAS,1,1,Sun,W 17-10,,6,39,11,88,17,127
5789,MIA,2015,2015-09-27,4:25,4:25,,BUF,3,3,Sun,L 14-41,,6,36,5,40,11,76
5790,MIA,2015,2015-11-29,1:02,1:02,@,NYJ,12,11,Sun,L 20-38,,6,45,6,40,12,85
5791,MIA,2017,2017-11-26,1:00,1:00,@,NWE,12,11,Sun,L 17-35,,6,52,7,70,13,122
5792,MIA,2019,2019-10-20,1:00,1:00,@,BUF,7,6,Sun,L 21-31,,6,55,9,83,15,138
5793,MIA,2019,2019-11-03,1:00,1:00,,NYJ,9,8,Sun,W 26-18,,6,51,10,105,16,156
5794,MIA,2019,2019-11-17,1:00,1:00,,BUF,11,10,Sun,L 20-37,,6,44,5,50,11,94
5795,MIA,2019,2019-12-22,1:00,1:00,,CIN,16,15,Sun,W 38-35,OT,6,47,10,77,16,124
5796,MIA,2020,2020-09-24,8:20,8:20,@,JAX,3,3,Thu,W 31-13,,6,51,8,63,14,114
5797,MIA,2021,2021-10-24,1:00,1:00,,ATL,7,7,Sun,L 28-30,,6,44,3,29,9,73
5798,MIN,2000,2000-10-29,1:01,1:01,@,TAM,9,8,Sun,L 13-41,,6,46,4,34,10,80
5799,MIN,2000,2000-11-30,8:35,7:35,,DET,14,13,Thu,W 24-17,,6,59,5,35,11,94
5800,MIN,2000,2000-12-24,4:15,4:15,@,IND,17,16,Sun,L 10-31,,6,53,3,20,9,73
5801,MIN,2001,2001-09-23,12:12,12:12,@,CHI,2,2,Sun,L 10-17,,6,50,7,78,13,128
5802,MIN,2001,2001-09-30,1:00,12:00,,TAM,3,3,Sun,W 20-16,,6,36,3,25,9,61
5803,MIN,2001,2001-12-16,1:02,1:02,@,DET,14,13,Sun,L 24-27,,6,40,13,123,19,163
5804,MIN,2002,2002-09-22,1:00,12:00,,CAR,3,3,Sun,L 14-21,,6,55,6,41,12,96
5805,MIN,2002,2002-10-20,1:02,1:02,@,NYJ,7,6,Sun,L 7-20,,6,60,4,45,10,105
5806,MIN,2002,2002-12-08,8:35,7:35,@,GNB,14,13,Sun,L 22-26,,6,62,4,25,10,87
5807,MIN,2003,2003-12-20,5:15,4:15,,KAN,16,15,Sat,W 45-20,,6,51,2,20,8,71
5808,MIN,2004,2004-11-08,9:00,9:00,@,IND,9,8,Mon,L 28-31,,6,53,8,65,14,118
5809,MIN,2004,2004-11-14,4:15,3:15,@,GNB,10,9,Sun,L 31-34,,6,37,4,25,10,62
5810,MIN,2004,2004-12-05,1:03,12:03,@,CHI,13,12,Sun,L 14-24,,6,30,7,55,13,85
5811,MIN,2005,2005-11-21,9:07,8:07,@,GNB,11,10,Mon,W 20-17,,6,77,5,31,11,108
5812,MIN,2005,2005-12-25,8:36,8:36,@,BAL,16,15,Sun,L 23-30,,6,50,7,35,13,85
5813,MIN,2006,2006-10-30,8:38,7:38,,NWE,8,7,Mon,L 7-31,,6,39,9,85,15,124
5814,MIN,2006,2006-11-05,4:05,1:05,@,SFO,9,8,Sun,L 3-9,,6,65,5,56,11,121
5815,MIN,2006,2006-11-19,1:03,1:03,@,MIA,11,10,Sun,L 20-24,,6,49,5,40,11,89
5816,MIN,2007,2007-09-23,1:00,12:00,@,KAN,3,3,Sun,L 10-13,,6,45,10,61,16,106
5817,MIN,2007,2007-10-28,1:05,12:05,,PHI,8,7,Sun,L 16-23,,6,73,8,70,14,143
5818,MIN,2007,2007-12-23,8:15,7:15,,WAS,16,15,Sun,L 21-32,,6,40,7,52,13,92
5819,MIN,2008,2008-12-07,1:03,1:03,@,DET,14,13,Sun,W 20-16,,6,35,4,32,10,67
5820,MIN,2008,2008-12-14,4:05,2:05,@,ARI,15,14,Sun,W 35-14,,6,34,5,60,11,94
5821,MIN,2009,2009-12-06,8:20,6:20,@,ARI,13,12,Sun,L 17-30,,6,50,6,50,12,100
5822,MIN,2010,2010-09-09,8:41,7:41,@,NOR,1,1,Thu,L 9-14,,6,60,3,20,9,80
5823,MIN,2010,2010-10-24,8:30,7:30,@,GNB,7,6,Sun,L 24-28,,6,40,2,20,8,60
5824,MIN,2010,2010-11-21,1:05,12:05,,GNB,11,10,Sun,L 3-31,,6,50,1,5,7,55
5825,MIN,2010,2010-12-20,8:40,7:40,,CHI,15,14,Mon,L 14-40,,6,55,5,72,11,127
5826,MIN,2011,2011-10-02,1:02,12:02,@,KAN,4,4,Sun,L 17-22,,6,45,6,57,12,102
5827,MIN,2011,2011-11-27,1:02,1:02,@,ATL,12,11,Sun,L 14-24,,6,49,4,30,10,79
5828,MIN,2011,2011-12-04,1:05,12:05,,DEN,13,12,Sun,L 32-35,,6,54,8,73,14,127
5829,MIN,2012,2012-11-04,4:06,1:06,@,SEA,9,9,Sun,L 20-30,,6,33,4,49,10,82
5830,MIN,2013,2013-12-01,1:05,12:05,,CHI,13,12,Sun,W 23-20,OT,6,60,6,51,12,111
5831,MIN,2013,2013-12-08,1:03,1:03,@,BAL,14,13,Sun,L 26-29,,6,90,5,45,11,135
5832,MIN,2014,2014-09-28,4:25,3:25,,ATL,4,4,Sun,W 41-28,,6,40,5,50,11,90
5833,MIN,2014,2014-10-26,1:03,1:03,@,TAM,8,8,Sun,W 19-13,OT,6,59,8,52,14,111
5834,MIN,2014,2014-12-07,1:02,12:02,,NYJ,14,13,Sun,W 30-24,OT,6,70,4,40,10,110
5835,MIN,2015,2015-11-08,1:02,12:02,,STL,9,8,Sun,W 21-18,OT,6,67,12,87,18,154
5836,MIN,2016,2016-09-25,1:02,1:02,@,CAR,3,3,Sun,W 22-10,,6,42,10,65,16,107
5837,MIN,2016,2016-10-03,8:35,7:35,,NYG,4,4,Mon,W 24-10,,6,37,8,69,14,106
5838,MIN,2016,2016-12-18,1:00,3:00,,IND,15,14,Sun,L 6-34,,6,27,5,55,11,82
5839,MIN,2017,2017-12-03,1:00,1:00,@,ATL,13,12,Sun,W 14-9,,6,51,7,55,13,106
5840,MIN,2018,2018-09-23,1:00,3:00,,BUF,3,3,Sun,L 6-27,,6,59,12,84,18,143
5841,MIN,2018,2018-10-21,1:00,1:00,@,NYJ,7,7,Sun,W 37-17,,6,55,8,71,14,126
5842,MIN,2018,2018-10-28,8:20,10:20,,NOR,8,8,Sun,L 20-30,,6,54,7,64,13,118
5843,MIN,2018,2018-11-25,8:20,10:20,,GNB,12,11,Sun,W 24-17,,6,55,4,20,10,75
5844,MIN,2018,2018-12-16,1:00,3:00,,MIA,15,14,Sun,W 41-17,,6,45,8,49,14,94
5845,MIN,2019,2019-09-22,1:00,3:00,,OAK,3,3,Sun,W 34-14,,6,59,7,84,13,143
5846,MIN,2019,2019-10-20,1:00,1:00,@,DET,7,7,Sun,W 42-30,,6,60,8,67,14,127
5847,MIN,2020,2020-09-20,1:00,1:00,@,IND,2,2,Sun,L 11-28,,6,45,9,93,15,138
5848,MIN,2020,2020-10-11,8:20,5:20,@,SEA,5,5,Sun,L 26-27,,6,55,3,25,9,80
5849,MIN,2020,2020-12-06,1:00,3:00,,JAX,13,12,Sun,W 27-24,OT,6,41,10,83,16,124
5850,NOR,2000,2000-09-10,4:15,1:15,@,SDG,2,2,Sun,W 28-27,,6,37,7,85,13,122
5851,NOR,2000,2000-10-22,1:05,1:05,@,ATL,8,7,Sun,W 21-19,,6,45,7,48,13,93
5852,NOR,2000,2000-12-03,1:02,12:02,,DEN,14,13,Sun,L 23-38,,6,45,4,21,10,66
5853,NOR,2001,2001-10-14,1:02,1:02,@,CAR,5,4,Sun,W 27-25,,6,55,4,19,10,74
5854,NOR,2001,2001-11-18,1:02,12:02,,IND,10,9,Sun,W 34-20,,6,51,6,77,12,128
5855,NOR,2002,2002-09-29,1:03,1:03,@,DET,4,4,Sun,L 21-26,,6,38,5,44,11,82
5856,NOR,2002,2002-10-06,1:02,12:02,,PIT,5,5,Sun,W 32-29,,6,35,7,80,13,115
5857,NOR,2002,2002-12-01,8:37,7:37,,TAM,13,12,Sun,W 23-20,,6,57,5,40,11,97
5858,NOR,2003,2003-10-12,1:03,12:03,,CHI,6,6,Sun,W 20-13,,6,35,5,86,11,121
5859,NOR,2005,2005-11-06,4:05,3:05,,CHI,9,9,Sun,L 17-20,,6,70,8,60,14,130
5860,NOR,2006,2006-09-10,1:04,1:04,@,CLE,1,1,Sun,W 19-14,,6,44,4,35,10,79
5861,NOR,2007,2007-10-21,1:03,12:03,,ATL,7,6,Sun,W 22-16,,6,49,9,52,15,101
5862,NOR,2007,2007-12-02,4:15,3:15,,TAM,13,12,Sun,L 23-27,,6,40,7,55,13,95
5863,NOR,2007,2007-12-23,1:02,12:02,,PHI,16,15,Sun,L 23-38,,6,64,4,29,10,93
5864,NOR,2008,2008-10-26,1:06,5:06,,SDG,8,8,Sun,W 37-32,,6,60,14,134,20,194
5865,NOR,2009,2009-10-18,1:03,12:03,,NYG,6,5,Sun,W 48-27,,6,55,9,110,15,165
5866,NOR,2009,2009-10-25,4:15,4:15,@,MIA,7,6,Sun,W 46-34,,6,25,8,55,14,80
5867,NOR,2009,2009-11-15,1:00,12:00,@,STL,10,9,Sun,W 28-23,,6,40,4,20,10,60
5868,NOR,2009,2009-12-13,1:02,1:02,@,ATL,14,13,Sun,W 26-23,,6,59,4,55,10,114
5869,NOR,2010,2010-10-10,4:05,1:05,@,ARI,5,5,Sun,L 20-30,,6,45,3,20,9,65
5870,NOR,2010,2010-12-19,1:03,1:03,@,BAL,15,14,Sun,L 24-30,,6,68,10,68,16,136
5871,NOR,2011,2011-10-02,1:03,1:03,@,JAX,4,4,Sun,W 23-10,,6,50,2,15,8,65
5872,NOR,2011,2011-12-18,1:05,12:05,@,MIN,15,14,Sun,W 42-20,,6,65,8,84,14,149
5873,NOR,2011,2012-01-01,1:03,12:03,,CAR,17,16,Sun,W 45-17,,6,60,1,5,7,65
5874,NOR,2012,2012-12-16,1:03,12:03,,TAM,15,14,Sun,W 41-0,,6,55,7,84,13,139
5875,NOR,2012,2012-12-23,1:02,12:02,@,DAL,16,15,Sun,W 34-31,OT,6,42,5,32,11,74
5876,NOR,2013,2013-09-08,1:03,12:03,,ATL,1,1,Sun,W 23-17,,6,57,2,19,8,76
5877,NOR,2013,2013-09-30,8:40,7:40,,MIA,4,4,Mon,W 38-17,,6,45,5,25,11,70
5878,NOR,2013,2013-11-10,8:30,7:30,,DAL,10,9,Sun,W 49-17,,6,44,11,82,17,126
5879,NOR,2014,2014-10-05,1:03,12:03,,TAM,5,5,Sun,W 37-31,OT,6,50,15,113,21,163
5880,NOR,2014,2014-11-09,1:03,12:03,,SFO,10,9,Sun,L 24-27,OT,6,43,2,15,8,58
5881,NOR,2015,2015-12-21,8:30,7:30,,DET,15,14,Mon,L 27-35,,6,28,10,92,16,120
5882,NOR,2016,2016-10-02,4:25,1:25,@,SDG,4,4,Sun,W 35-34,,6,34,5,46,11,80
5883,NOR,2016,2016-11-17,8:25,8:25,@,CAR,11,10,Thu,L 20-23,,6,48,6,45,12,93
5884,NOR,2016,2016-11-27,1:00,12:00,,LAR,12,11,Sun,W 49-21,,6,45,6,62,12,107
5885,NOR,2016,2017-01-01,4:25,4:25,@,ATL,17,16,Sun,L 32-38,,6,70,9,63,15,133
5886,NOR,2017,2017-09-11,7:10,9:10,@,MIN,1,1,Mon,L 19-29,,6,52,5,50,11,102
5887,NOR,2018,2018-10-21,4:05,4:05,@,BAL,7,6,Sun,W 24-23,,6,52,5,54,11,106
5888,NOR,2018,2018-12-09,1:00,1:00,@,TAM,14,13,Sun,W 28-14,,6,51,10,84,16,135
5889,NOR,2018,2018-12-30,1:00,12:00,,CAR,17,16,Sun,L 14-33,,6,94,2,10,8,104
5890,NOR,2019,2019-10-06,1:00,12:00,,TAM,5,5,Sun,W 31-24,,6,40,4,30,10,70
5891,NOR,2019,2019-12-16,8:15,7:15,,IND,15,14,Mon,W 34-7,,6,52,7,49,13,101
5892,NOR,2020,2020-09-13,4:25,3:25,,TAM,1,1,Sun,W 34-23,,6,119,9,103,15,222
5893,NOR,2020,2020-10-25,1:00,12:00,,CAR,7,6,Sun,W 27-24,,6,50,1,5,7,55
5894,NOR,2021,2021-09-12,4:25,4:25,,GNB,1,1,Sun,W 38-3,,6,36,5,41,11,77
5895,NOR,2021,2021-10-10,1:00,1:00,@,WAS,5,5,Sun,W 33-22,,6,45,5,37,11,82
5896,NOR,2021,2021-12-19,8:20,8:20,@,TAM,15,14,Sun,W 9-0,,6,41,3,30,9,71
5897,NWE,2000,2000-10-22,1:00,12:00,@,IND,8,8,Sun,L 23-30,,6,48,8,106,14,154
5898,NWE,2001,2001-11-25,4:05,4:05,,NOR,11,11,Sun,W 34-17,,6,64,5,86,11,150
5899,NWE,2001,2002-01-06,1:02,1:02,@,CAR,17,16,Sun,W 38-6,,6,70,4,37,10,107
5900,NWE,2002,2002-09-29,4:15,1:15,@,SDG,4,4,Sun,L 14-21,,6,45,2,20,8,65
5901,NWE,2002,2002-10-06,1:02,1:02,@,MIA,5,5,Sun,L 13-26,,6,49,5,35,11,84
5902,NWE,2002,2002-11-10,4:15,3:15,@,CHI,10,9,Sun,W 33-30,,6,65,5,30,11,95
5903,NWE,2003,2003-11-30,1:00,1:00,@,IND,13,12,Sun,W 38-34,,6,52,4,31,10,83
5904,NWE,2004,2004-10-17,1:02,1:02,,SEA,6,5,Sun,W 30-20,,6,46,6,50,12,96
5905,NWE,2004,2004-10-24,4:05,4:05,,NYJ,7,6,Sun,W 13-7,,6,53,6,37,12,90
5906,NWE,2004,2004-10-31,4:15,4:15,@,PIT,8,7,Sun,L 20-34,,6,55,9,90,15,145
5907,NWE,2005,2005-11-13,1:03,1:03,@,MIA,10,9,Sun,W 23-16,,6,38,4,69,10,107
5908,NWE,2005,2006-01-01,1:02,1:02,,MIA,17,16,Sun,L 26-28,,6,45,9,77,15,122
5909,NWE,2006,2006-09-17,4:15,4:15,@,NYJ,2,2,Sun,W 24-17,,6,64,4,48,10,112
5910,NWE,2006,2006-09-24,8:20,8:20,,DEN,3,3,Sun,L 7-17,,6,78,7,52,13,130
5911,NWE,2006,2006-11-19,1:02,12:02,@,GNB,11,10,Sun,W 35-0,,6,38,3,32,9,70
5912,NWE,2007,2007-09-16,8:24,8:24,,SDG,2,2,Sun,W 38-14,,6,67,7,75,13,142
5913,NWE,2007,2007-10-07,1:02,1:02,,CLE,5,5,Sun,W 34-17,,6,52,7,40,13,92
5914,NWE,2007,2007-10-28,4:17,4:17,,WAS,8,8,Sun,W 52-7,,6,40,5,40,11,80
5915,NWE,2007,2007-12-16,1:02,1:02,,NYJ,15,14,Sun,W 20-10,,6,48,6,42,12,90
5916,NWE,2008,2008-10-12,8:20,5:20,@,SDG,6,5,Sun,L 10-30,,6,73,3,20,9,93
5917,NWE,2008,2008-11-23,1:02,1:02,@,MIA,12,11,Sun,W 48-28,,6,38,8,60,14,98
5918,NWE,2008,2008-11-30,4:15,4:15,,PIT,13,12,Sun,L 10-33,,6,45,8,88,14,133
5919,NWE,2009,2009-09-14,7:10,7:10,,BUF,1,1,Mon,W 25-24,,6,55,9,71,15,126
5920,NWE,2009,2009-10-18,4:15,4:15,,TEN,6,6,Sun,W 59-0,,6,40,6,55,12,95
5921,NWE,2009,2009-11-22,4:15,4:15,,NYJ,11,10,Sun,W 31-14,,6,51,5,28,11,79
5922,NWE,2009,2009-12-06,1:02,1:02,@,MIA,13,12,Sun,L 21-22,,6,82,2,10,8,92
5923,NWE,2009,2009-12-20,1:02,1:02,@,BUF,15,14,Sun,W 17-10,,6,52,11,124,17,176
5924,NWE,2010,2010-09-12,1:02,1:02,,CIN,1,1,Sun,W 38-24,,6,30,2,5,8,35
5925,NWE,2010,2010-09-19,4:16,4:16,@,NYJ,2,2,Sun,L 14-28,,6,79,6,58,12,137
5926,NWE,2010,2010-10-31,4:15,4:15,,MIN,8,7,Sun,W 28-18,,6,47,5,35,11,82
5927,NWE,2010,2010-12-26,1:02,1:02,@,BUF,16,15,Sun,W 34-3,,6,40,6,40,12,80
5928,NWE,2011,2011-10-09,4:15,4:15,,NYJ,5,5,Sun,W 30-21,,6,50,8,89,14,139
5929,NWE,2011,2011-10-30,4:15,4:15,@,PIT,8,7,Sun,L 17-25,,6,37,8,50,14,87
5930,NWE,2012,2012-10-07,4:25,4:25,,DEN,5,5,Sun,W 31-21,,6,59,4,21,10,80
5931,NWE,2012,2012-10-14,4:04,1:04,@,SEA,6,6,Sun,L 23-24,,6,80,4,35,10,115
5932,NWE,2012,2012-10-21,4:25,4:25,,NYJ,7,7,Sun,W 29-26,OT,6,40,8,60,14,100
5933,NWE,2012,2012-12-02,1:02,1:02,@,MIA,13,12,Sun,W 23-16,,6,50,7,77,13,127
5934,NWE,2012,2012-12-10,8:40,8:40,,HOU,14,13,Mon,W 42-14,,6,56,7,70,13,126
5935,NWE,2012,2012-12-30,4:25,4:25,,MIA,17,16,Sun,W 28-0,,6,48,3,23,9,71
5936,NWE,2013,2013-09-22,1:02,1:02,,TAM,3,3,Sun,W 23-3,,6,50,4,48,10,98
5937,NWE,2013,2013-12-08,1:02,1:02,,CLE,14,13,Sun,W 27-26,,6,41,7,75,13,116
5938,NWE,2014,2014-09-21,1:02,1:02,,OAK,3,3,Sun,W 16-9,,6,59,6,49,12,108
5939,NWE,2014,2014-12-07,8:30,5:30,@,SDG,14,13,Sun,W 23-14,,6,70,8,61,14,131
5940,NWE,2015,2015-11-08,1:02,1:02,,WAS,9,8,Sun,W 27-10,,6,43,4,27,10,70
5941,NWE,2015,2015-12-13,8:31,7:31,@,HOU,14,13,Sun,W 27-6,,6,46,4,36,10,82
5942,NWE,2016,2016-10-16,1:02,1:02,,CIN,6,6,Sun,W 35-17,,6,55,7,46,13,101
5943,NWE,2017,2017-09-07,8:30,8:30,,KAN,1,1,Thu,L 27-42,,6,55,15,139,21,194
5944,NWE,2017,2017-10-15,1:00,1:00,@,NYJ,6,6,Sun,W 24-17,,6,45,6,69,12,114
5945,NWE,2017,2017-10-29,1:00,1:00,,LAC,8,8,Sun,W 21-13,,6,80,10,77,16,157
5946,NWE,2018,2018-09-09,1:00,1:00,,HOU,1,1,Sun,W 27-20,,6,36,6,44,12,80
5947,NWE,2018,2018-09-30,1:00,1:00,,MIA,4,4,Sun,W 38-7,,6,57,10,89,16,146
5948,NWE,2019,2019-11-17,4:25,4:25,@,PHI,11,10,Sun,W 17-10,,6,89,7,39,13,128
5949,NWE,2019,2019-11-24,4:25,4:25,,DAL,12,11,Sun,W 13-9,,6,56,7,50,13,106
5950,NWE,2019,2019-12-29,1:00,1:00,,MIA,17,16,Sun,L 24-27,,6,54,4,35,10,89
5951,NWE,2020,2020-11-09,8:15,8:15,@,NYJ,9,8,Mon,W 30-27,,6,81,4,32,10,113
5952,NWE,2020,2020-11-29,1:00,1:00,,ARI,12,11,Sun,W 20-17,,6,42,6,50,12,92
5953,NWE,2020,2021-01-03,1:00,1:00,,NYJ,17,16,Sun,W 28-14,,6,47,3,30,9,77
5954,NWE,2021,2021-09-19,1:00,1:00,@,NYJ,2,2,Sun,W 25-6,,6,54,8,77,14,131
5955,NWE,2021,2021-10-24,1:00,1:00,,NYJ,7,7,Sun,W 54-13,,6,95,5,29,11,124
5956,NWE,2021,2021-11-07,1:00,1:00,@,CAR,9,9,Sun,W 24-6,,6,35,10,83,16,118
5957,NWE,2021,2021-11-14,1:00,1:00,,CLE,10,10,Sun,W 45-7,,6,46,6,42,12,88
5958,NWE,2021,2021-12-06,8:15,8:15,@,BUF,13,13,Mon,W 14-10,,6,47,3,20,9,67
5959,NYG,2000,2000-09-24,8:37,8:37,,WAS,4,4,Sun,L 6-16,,6,59,4,25,10,84
5960,NYG,2000,2000-12-10,1:03,1:03,,PIT,15,14,Sun,W 30-10,,6,91,5,42,11,133
5961,NYG,2001,2001-12-23,1:03,1:03,,SEA,15,14,Sun,W 27-24,,6,61,2,10,8,71
5962,NYG,2001,2001-12-30,4:06,4:06,@,PHI,16,15,Sun,L 21-24,,6,73,3,25,9,98
5963,NYG,2001,2002-01-06,1:04,1:04,,GNB,17,16,Sun,L 25-34,,6,64,3,15,9,79
5964,NYG,2002,2002-10-06,1:03,12:03,@,DAL,5,5,Sun,W 21-17,,6,48,5,37,11,85
5965,NYG,2002,2002-10-13,1:03,1:03,,ATL,6,6,Sun,L 10-17,,6,35,3,20,9,55
5966,NYG,2002,2002-12-01,1:03,1:03,,TEN,13,12,Sun,L 29-32,OT,6,55,12,121,18,176
5967,NYG,2002,2002-12-15,4:16,4:16,,DAL,15,14,Sun,W 37-7,,6,57,7,55,13,112
5968,NYG,2003,2003-10-19,1:03,1:03,,PHI,7,6,Sun,L 10-14,,6,66,6,35,12,101
5969,NYG,2003,2003-11-02,1:03,1:03,@,NYJ,9,8,Sun,W 31-28,OT,6,62,3,30,9,92
5970,NYG,2004,2004-11-21,4:15,4:15,,ATL,11,10,Sun,L 10-14,,6,50,12,94,18,144
5971,NYG,2004,2004-11-28,1:03,1:03,,PHI,12,11,Sun,L 6-27,,6,64,12,75,18,139
5972,NYG,2005,2005-10-16,1:02,12:02,@,DAL,6,5,Sun,L 13-16,OT,6,32,6,44,12,76
5973,NYG,2005,2005-11-20,1:04,1:04,,PHI,11,10,Sun,W 27-17,,6,58,7,105,13,163
5974,NYG,2005,2005-12-04,1:03,1:03,,DAL,13,12,Sun,W 17-10,,6,44,7,46,13,90
5975,NYG,2006,2006-11-05,1:02,1:02,,HOU,9,8,Sun,W 14-10,,6,53,8,65,14,118
5976,NYG,2007,2007-09-16,1:04,1:04,,GNB,2,2,Sun,L 13-35,,6,71,8,63,14,134
5977,NYG,2007,2007-10-15,8:40,8:40,@,ATL,6,6,Mon,W 31-10,,6,45,3,31,9,76
5978,NYG,2007,2007-11-18,1:03,1:03,@,DET,11,10,Sun,W 16-10,,6,47,7,40,13,87
5979,NYG,2008,2008-09-21,1:02,1:02,,CIN,3,3,Sun,W 26-23,OT,6,40,8,57,14,97
5980,NYG,2008,2008-12-07,1:04,1:04,,PHI,14,13,Sun,L 14-20,,6,43,9,73,15,116
5981,NYG,2010,2010-10-03,8:31,8:31,,CHI,4,4,Sun,W 17-3,,6,44,8,40,14,84
5982,NYG,2010,2010-10-25,8:41,7:41,@,DAL,7,7,Mon,W 41-35,,6,46,5,42,11,88
5983,NYG,2010,2010-11-21,8:30,8:30,@,PHI,11,10,Sun,L 17-27,,6,54,10,119,16,173
5984,NYG,2011,2011-11-06,4:15,4:15,@,NWE,9,8,Sun,W 24-20,,6,50,7,81,13,131
5985,NYG,2011,2011-11-13,4:15,1:15,@,SFO,10,9,Sun,L 20-27,,6,45,5,35,11,80
5986,NYG,2011,2011-12-04,4:15,4:15,,GNB,13,12,Sun,L 35-38,,6,55,4,30,10,85
5987,NYG,2011,2011-12-11,8:30,7:30,@,DAL,14,13,Sun,W 37-34,,6,55,10,51,16,106
5988,NYG,2012,2012-12-09,4:26,4:26,,NOR,14,13,Sun,W 52-27,,6,55,10,81,16,136
5989,NYG,2012,2012-12-23,4:25,4:25,@,BAL,16,15,Sun,L 14-33,,6,52,9,92,15,144
5990,NYG,2013,2013-09-08,8:30,7:30,@,DAL,1,1,Sun,L 31-36,,6,52,5,40,11,92
5991,NYG,2013,2013-09-22,1:03,1:03,@,CAR,3,3,Sun,L 0-38,,6,45,4,32,10,77
5992,NYG,2014,2014-10-19,4:25,3:25,@,DAL,7,7,Sun,L 21-31,,6,40,6,46,12,86
5993,NYG,2014,2014-11-30,1:03,1:03,@,JAX,13,12,Sun,L 24-25,,6,40,7,49,13,89
5994,NYG,2015,2015-09-20,1:02,1:02,,ATL,2,2,Sun,L 20-24,,6,35,6,65,12,100
5995,NYG,2015,2015-10-11,8:31,8:31,,SFO,5,5,Sun,W 30-27,,6,65,4,28,10,93
5996,NYG,2015,2015-11-01,1:02,12:02,@,NOR,8,8,Sun,L 49-52,,6,53,12,93,18,146
5997,NYG,2015,2015-11-08,4:05,4:05,@,TAM,9,9,Sun,W 32-18,,6,49,9,79,15,128
5998,NYG,2016,2016-10-09,8:30,7:30,@,GNB,5,5,Sun,L 16-23,,6,51,6,57,12,108
5999,NYG,2017,2017-09-10,8:30,7:30,@,DAL,1,1,Sun,L 3-19,,6,55,5,50,11,105
6000,NYG,2017,2017-11-23,8:30,8:30,@,WAS,12,11,Thu,L 10-20,,6,79,8,55,14,134
6001,NYG,2018,2018-09-09,1:00,1:00,,JAX,1,1,Sun,L 15-20,,6,43,11,119,17,162
6002,NYG,2018,2018-09-30,4:25,4:25,,NOR,4,4,Sun,L 18-33,,6,67,5,51,11,118
6003,NYG,2018,2018-12-23,1:00,1:00,@,IND,16,15,Sun,L 27-28,,6,24,6,29,12,53
6004,NYG,2019,2019-09-22,4:05,4:05,@,TAM,3,3,Sun,W 32-31,,6,59,4,30,10,89
6005,NYG,2019,2019-10-20,1:00,1:00,,ARI,7,7,Sun,L 21-27,,6,75,10,85,16,160
6006,NYG,2019,2019-11-10,1:00,1:00,@,NYJ,10,10,Sun,L 27-34,,6,62,7,54,13,116
6007,NYG,2019,2019-11-24,1:00,12:00,@,CHI,12,11,Sun,L 14-19,,6,35,6,40,12,75
6008,NYG,2020,2020-12-06,4:05,1:05,@,SEA,13,12,Sun,W 17-12,,6,35,6,41,12,76
6009,NYG,2020,2021-01-03,1:00,1:00,,DAL,17,16,Sun,W 23-19,,6,45,6,58,12,103
6010,NYG,2021,2021-12-19,1:00,1:00,,DAL,15,14,Sun,L 6-21,,6,34,6,45,12,79
6011,NYG,2021,2021-12-26,1:00,1:00,@,PHI,16,15,Sun,L 10-34,,6,40,11,79,17,119
6012,NYJ,2000,2000-09-11,9:09,9:09,,NWE,2,2,Mon,W 20-19,,6,69,3,8,9,77
6013,NYJ,2000,2000-10-08,1:01,1:01,,PIT,6,5,Sun,L 3-20,,6,45,7,57,13,102
6014,NYJ,2000,2000-11-12,8:35,8:35,@,IND,11,10,Sun,L 15-23,,6,65,4,64,10,129
6015,NYJ,2000,2000-12-10,8:35,5:35,@,OAK,15,14,Sun,L 7-31,,6,27,7,60,13,87
6016,NYJ,2001,2001-09-23,4:15,4:15,@,NWE,2,2,Sun,W 10-3,,6,49,9,85,15,134
6017,NYJ,2001,2001-10-07,4:05,4:05,@,BUF,4,4,Sun,W 42-36,,6,56,7,55,13,111
6018,NYJ,2001,2001-11-04,8:37,7:37,@,NOR,8,8,Sun,W 16-9,,6,56,8,65,14,121
6019,NYJ,2002,2002-10-27,1:02,1:02,,CLE,8,7,Sun,L 21-24,,6,40,7,45,13,85
6020,NYJ,2002,2002-11-03,4:05,1:05,@,SDG,9,8,Sun,W 44-13,,6,65,8,55,14,120
6021,NYJ,2003,2003-09-21,1:02,1:02,@,NWE,3,3,Sun,L 16-23,,6,52,9,87,15,139
6022,NYJ,2003,2003-11-23,1:03,1:03,,JAX,12,11,Sun,W 13-10,,6,45,3,37,9,82
6023,NYJ,2003,2003-12-07,4:15,4:15,@,BUF,14,13,Sun,L 6-17,,6,54,3,23,9,77
6024,NYJ,2004,2004-10-24,4:05,4:05,@,NWE,7,6,Sun,L 7-13,,6,37,6,53,12,90
6025,NYJ,2004,2004-11-01,9:08,9:08,,MIA,8,7,Mon,W 41-14,,6,45,3,20,9,65
6026,NYJ,2004,2004-11-14,1:02,1:02,,BAL,10,9,Sun,L 17-20,OT,6,55,5,39,11,94
6027,NYJ,2004,2004-12-05,1:03,1:03,,HOU,13,12,Sun,W 29-7,,6,49,5,48,11,97
6028,NYJ,2005,2005-09-25,1:03,1:03,,JAX,3,3,Sun,L 20-26,OT,6,44,9,85,15,129
6029,NYJ,2005,2005-10-09,1:03,1:03,,TAM,5,5,Sun,W 14-12,,6,46,12,87,18,133
6030,NYJ,2005,2006-01-01,1:01,1:01,,BUF,17,16,Sun,W 30-26,,6,40,3,30,9,70
6031,NYJ,2006,2006-10-08,4:05,4:05,@,JAX,5,5,Sun,L 0-41,,6,59,9,62,15,121
6032,NYJ,2006,2006-11-19,1:04,1:04,,CHI,11,10,Sun,L 0-10,,6,40,10,65,16,105
6033,NYJ,2007,2007-10-07,1:02,1:02,@,NYG,5,5,Sun,L 24-35,,6,40,3,37,9,77
6034,NYJ,2007,2007-12-16,1:02,1:02,@,NWE,15,14,Sun,L 10-20,,6,42,6,48,12,90
6035,NYJ,2008,2008-09-14,4:15,4:15,,NWE,2,2,Sun,L 10-19,,6,60,2,10,8,70
6036,NYJ,2008,2008-12-21,4:06,1:06,@,SEA,16,15,Sun,L 3-13,,6,45,5,28,11,73
6037,NYJ,2009,2009-10-12,8:38,8:38,@,MIA,5,5,Mon,L 27-31,,6,56,8,112,14,168
6038,NYJ,2009,2009-11-01,1:02,1:02,,MIA,8,8,Sun,L 25-30,,6,40,4,25,10,65
6039,NYJ,2009,2009-12-13,1:00,1:00,@,TAM,14,13,Sun,W 26-3,,6,63,6,34,12,97
6040,NYJ,2009,2009-12-20,1:03,1:03,,ATL,15,14,Sun,L 7-10,,6,65,4,25,10,90
6041,NYJ,2010,2010-09-19,4:16,4:16,,NWE,2,2,Sun,W 28-14,,6,58,6,79,12,137
6042,NYJ,2010,2010-10-11,9:15,9:15,,MIN,5,5,Mon,W 29-20,,6,55,8,51,14,106
6043,NYJ,2010,2010-10-17,4:05,2:05,@,DEN,6,6,Sun,W 24-20,,6,74,5,81,11,155
6044,NYJ,2010,2010-12-12,4:15,4:15,,MIA,14,13,Sun,L 6-10,,6,50,5,36,11,86
6045,NYJ,2011,2011-10-17,8:40,8:40,,MIA,6,6,Mon,W 24-6,,6,49,2,10,8,59
6046,NYJ,2011,2011-12-04,1:03,1:03,@,WAS,13,12,Sun,W 34-19,,6,40,6,50,12,90
6047,NYJ,2011,2012-01-01,1:02,1:02,@,MIA,17,16,Sun,L 17-19,,6,40,5,35,11,75
6048,NYJ,2012,2012-11-11,4:06,1:06,@,SEA,10,9,Sun,L 7-28,,6,35,7,45,13,80
6049,NYJ,2012,2012-12-23,1:03,1:03,,SDG,16,15,Sun,L 17-27,,6,40,5,53,11,93
6050,NYJ,2013,2013-09-08,1:03,1:03,,TAM,1,1,Sun,W 18-17,,6,45,13,102,19,147
6051,NYJ,2013,2013-10-07,8:40,8:40,@,ATL,5,5,Mon,W 30-28,,6,24,4,46,10,70
6052,NYJ,2013,2013-11-24,1:02,1:02,@,BAL,12,11,Sun,L 3-19,,6,56,5,41,11,97
6053,NYJ,2013,2013-12-22,1:02,1:02,,CLE,16,15,Sun,W 24-13,,6,35,3,24,9,59
6054,NYJ,2014,2014-09-22,8:30,8:30,,CHI,3,3,Mon,L 19-27,,6,78,9,95,15,173
6055,NYJ,2014,2014-09-28,1:02,1:02,,DET,4,4,Sun,L 17-24,,6,32,5,33,11,65
6056,NYJ,2015,2015-09-27,1:03,1:03,,PHI,3,3,Sun,L 17-24,,6,53,5,21,11,74
6057,NYJ,2015,2015-11-01,4:05,1:05,@,OAK,8,7,Sun,L 20-34,,6,40,6,61,12,101
6058,NYJ,2015,2015-11-08,1:02,1:02,,JAX,9,8,Sun,W 28-23,,6,41,4,30,10,71
6059,NYJ,2015,2015-11-29,1:02,1:02,,MIA,12,11,Sun,W 38-20,,6,40,6,45,12,85
6060,NYJ,2015,2015-12-27,1:02,1:02,,NWE,16,15,Sun,W 26-20,OT,6,39,1,7,7,46
6061,NYJ,2015,2016-01-03,1:02,1:02,@,BUF,17,16,Sun,L 17-22,,6,41,4,45,10,86
6062,NYJ,2016,2016-11-27,4:25,4:25,,NWE,12,11,Sun,L 17-22,,6,66,2,15,8,81
6063,NYJ,2016,2016-12-05,8:30,8:30,,IND,13,12,Mon,L 10-41,,6,90,3,28,9,118
6064,NYJ,2016,2016-12-24,1:00,1:00,@,NWE,16,15,Sat,L 3-41,,6,77,3,20,9,97
6065,NYJ,2017,2017-10-15,1:00,1:00,,NWE,6,6,Sun,L 17-24,,6,69,6,45,12,114
6066,NYJ,2017,2017-10-29,1:00,1:00,,ATL,8,8,Sun,L 20-25,,6,50,6,68,12,118
6067,NYJ,2018,2018-09-20,8:20,8:20,@,CLE,3,3,Thu,L 17-21,,6,55,5,41,11,96
6068,NYJ,2018,2018-09-30,1:00,1:00,@,JAX,4,4,Sun,L 12-31,,6,43,9,89,15,132
6069,NYJ,2019,2019-11-17,1:00,1:00,@,WAS,11,10,Sun,W 34-17,,6,55,11,66,17,121
6070,NYJ,2020,2020-10-11,1:00,1:00,,ARI,5,5,Sun,L 10-30,,6,30,10,59,16,89
6071,NYJ,2020,2020-10-25,1:00,1:00,,BUF,7,7,Sun,L 10-18,,6,49,11,106,17,155
6072,NYJ,2020,2020-11-29,1:00,1:00,,MIA,12,11,Sun,L 3-20,,6,74,3,20,9,94
6073,NYJ,2020,2020-12-06,1:00,1:00,,LVR,13,12,Sun,L 28-31,,6,40,3,21,9,61
6074,NYJ,2020,2020-12-20,4:05,1:05,@,LAR,15,14,Sun,W 23-20,,6,61,5,43,11,104
6075,NYJ,2021,2021-10-03,1:00,1:00,,TEN,4,4,Sun,W 27-24,OT,6,65,8,98,14,163
6076,NYJ,2021,2021-12-05,1:00,1:00,,PHI,13,12,Sun,L 18-33,,6,66,3,20,9,86
6077,TEN,2000,2000-10-01,1:03,12:03,,NYG,5,4,Sun,W 28-14,,6,64,7,48,13,112
6078,TEN,2000,2000-10-08,1:00,1:00,@,CIN,6,5,Sun,W 23-14,,6,50,2,10,8,60
6079,TEN,2001,2001-09-23,1:10,1:10,@,JAX,2,2,Sun,L 6-13,,6,65,3,20,9,85
6080,TEN,2001,2001-11-25,1:05,12:05,,PIT,11,10,Sun,L 24-34,,6,45,6,62,12,107
6081,TEN,2001,2001-12-30,1:03,12:03,,CLE,16,15,Sun,L 38-41,,6,50,3,25,9,75
6082,TEN,2002,2002-09-08,1:06,12:06,,PHI,1,1,Sun,W 27-24,,6,50,10,113,16,163
6083,TEN,2002,2002-09-15,1:02,12:02,@,DAL,2,2,Sun,L 13-21,,6,55,2,15,8,70
6084,TEN,2002,2002-12-29,1:03,12:03,@,HOU,17,16,Sun,W 13-3,,6,52,7,53,13,105
6085,TEN,2003,2003-12-14,1:03,12:03,,BUF,15,14,Sun,W 28-26,,6,68,3,15,9,83
6086,TEN,2003,2003-12-21,1:03,12:03,@,HOU,16,15,Sun,W 27-24,,6,42,7,75,13,117
6087,TEN,2004,2004-09-26,1:02,12:02,,JAX,3,3,Sun,L 12-15,,6,56,9,87,15,143
6088,TEN,2006,2006-09-17,4:15,1:15,@,SDG,2,2,Sun,L 7-40,,6,55,7,53,13,108
6089,TEN,2006,2006-09-24,1:02,1:02,@,MIA,3,3,Sun,L 10-13,,6,47,5,29,11,76
6090,TEN,2006,2006-10-08,1:02,1:02,@,IND,5,5,Sun,L 13-14,,6,36,5,45,11,81
6091,TEN,2007,2007-10-07,1:04,12:04,,ATL,5,4,Sun,W 20-13,,6,40,8,66,14,106
6092,TEN,2007,2007-10-21,1:02,12:02,@,HOU,7,6,Sun,W 38-36,,6,45,4,37,10,82
6093,TEN,2007,2007-11-19,8:40,6:40,@,DEN,11,10,Mon,L 20-34,,6,80,5,35,11,115
6094,TEN,2007,2007-11-25,1:02,1:02,@,CIN,12,11,Sun,L 6-35,,6,55,4,35,10,90
6095,TEN,2007,2007-12-30,8:24,8:24,@,IND,17,16,Sun,W 16-10,,6,40,5,54,11,94
6096,TEN,2009,2009-10-04,1:05,1:05,@,JAX,4,4,Sun,L 17-37,,6,68,4,30,10,98
6097,TEN,2009,2009-10-18,4:15,4:15,@,NWE,6,6,Sun,L 0-59,,6,55,6,40,12,95
6098,TEN,2009,2009-11-29,4:15,3:15,,ARI,12,11,Sun,W 20-17,,6,38,4,25,10,63
6099,TEN,2010,2010-10-24,1:02,12:02,,PHI,7,7,Sun,W 37-19,,6,37,10,100,16,137
6100,TEN,2011,2011-09-18,1:02,12:02,,BAL,2,2,Sun,W 26-13,,6,70,7,44,13,114
6101,TEN,2011,2012-01-01,1:02,12:02,@,HOU,17,16,Sun,W 23-22,,6,47,7,55,13,102
6102,TEN,2012,2012-09-23,1:03,12:03,,DET,3,3,Sun,W 44-41,OT,6,32,10,91,16,123
6103,TEN,2012,2012-11-25,1:03,1:03,@,JAX,12,11,Sun,L 19-24,,6,42,5,30,11,72
6104,TEN,2013,2013-09-08,1:02,1:02,@,PIT,1,1,Sun,W 16-9,,6,60,4,47,10,107
6105,TEN,2013,2013-10-06,1:03,12:03,,KAN,5,5,Sun,L 17-26,,6,35,9,61,15,96
6106,TEN,2013,2013-11-10,1:02,12:02,,JAX,10,9,Sun,L 27-29,,6,45,4,19,10,64
6107,TEN,2013,2013-12-01,1:02,1:02,@,IND,13,12,Sun,L 14-22,,6,74,7,50,13,124
6108,TEN,2014,2014-09-28,1:03,1:03,@,IND,4,4,Sun,L 17-41,,6,68,11,88,17,156
6109,TEN,2014,2014-10-26,1:03,12:03,,HOU,8,8,Sun,L 16-30,,6,61,4,35,10,96
6110,TEN,2014,2014-11-30,1:02,12:02,@,HOU,13,12,Sun,L 21-45,,6,66,5,40,11,106
6111,TEN,2015,2015-09-27,1:03,12:03,,IND,3,3,Sun,L 33-35,,6,55,11,71,17,126
6112,TEN,2015,2015-11-01,1:02,12:02,@,HOU,8,7,Sun,L 6-20,,6,45,7,85,13,130
6113,TEN,2015,2015-11-19,8:26,8:26,@,JAX,11,10,Thu,L 13-19,,6,59,8,88,14,147
6114,TEN,2015,2016-01-03,1:02,1:02,@,IND,17,16,Sun,L 24-30,,6,60,6,71,12,131
6115,TEN,2016,2016-10-23,1:02,12:02,,IND,7,7,Sun,L 26-34,,6,38,12,131,18,169
6116,TEN,2016,2016-11-27,1:00,12:00,@,CHI,12,12,Sun,W 27-21,,6,118,7,48,13,166
6117,TEN,2016,2016-12-24,1:00,1:00,@,JAX,16,15,Sat,L 17-38,,6,49,4,45,10,94
6118,TEN,2017,2017-10-01,1:00,12:00,@,HOU,4,4,Sun,L 14-57,,6,88,3,20,9,108
6119,TEN,2017,2017-12-10,4:05,2:05,@,ARI,14,13,Sun,L 7-12,,6,48,5,30,11,78
6120,TEN,2019,2019-09-08,1:00,1:00,@,CLE,1,1,Sun,W 43-13,,6,54,18,182,24,236
6121,TEN,2019,2019-10-13,4:25,2:25,@,DEN,6,6,Sun,L 0-16,,6,40,8,51,14,91
6122,TEN,2019,2019-10-27,1:00,12:00,,TAM,8,8,Sun,W 27-23,,6,77,9,87,15,164
6123,TEN,2019,2019-11-24,4:05,3:05,,JAX,12,11,Sun,W 42-20,,6,54,11,104,17,158
6124,TEN,2019,2019-12-22,1:00,12:00,,NOR,16,15,Sun,L 28-38,,6,56,11,70,17,126
6125,TEN,2020,2020-10-13,7:00,6:00,,BUF,5,4,Tue,W 42-16,,6,46,10,56,16,102
6126,TEN,2020,2020-11-08,1:00,12:00,,CHI,9,8,Sun,W 24-17,,6,57,5,35,11,92
6127,TEN,2020,2021-01-03,4:25,3:25,@,HOU,17,16,Sun,W 41-38,,6,50,6,44,12,94
6128,TEN,2021,2021-10-24,1:00,12:00,,KAN,7,7,Sun,W 27-3,,6,31,9,77,15,108
6129,TEN,2021,2021-12-23,8:20,7:20,,SFO,16,15,Thu,W 20-17,,6,57,5,41,11,98
6130,TEN,2021,2022-01-02,1:00,12:00,,MIA,17,16,Sun,W 34-3,,6,70,5,55,11,125
6131,PHI,2000,2000-12-03,1:03,1:03,,TEN,14,14,Sun,L 13-15,,6,34,1,5,7,39
6132,PHI,2001,2001-12-16,4:15,4:15,@,WAS,14,13,Sun,W 20-6,,6,45,7,58,13,103
6133,PHI,2002,2002-11-03,1:05,12:05,@,CHI,9,8,Sun,W 19-13,,6,54,12,121,18,175
6134,PHI,2003,2003-10-19,1:03,1:03,@,NYG,7,6,Sun,W 14-10,,6,35,6,66,12,101
6135,PHI,2003,2003-11-10,9:08,8:08,@,GNB,10,9,Mon,W 17-14,,6,40,4,33,10,73
6136,PHI,2003,2003-12-15,9:09,9:09,@,MIA,15,14,Mon,W 34-27,,6,60,7,76,13,136
6137,PHI,2005,2005-09-18,1:03,1:03,,SFO,2,2,Sun,W 42-3,,6,50,2,15,8,65
6138,PHI,2006,2006-12-25,5:07,4:07,@,DAL,16,15,Mon,W 23-7,,6,45,2,10,8,55
6139,PHI,2007,2007-12-30,1:01,1:01,,BUF,17,16,Sun,W 17-9,,6,39,3,23,9,62
6140,PHI,2009,2009-12-13,8:30,8:30,@,NYG,14,13,Sun,W 45-38,,6,45,7,54,13,99
6141,PHI,2009,2010-01-03,4:15,3:15,@,DAL,17,16,Sun,L 0-24,,6,58,11,80,17,138
6142,PHI,2010,2010-11-15,8:40,8:40,@,WAS,10,9,Mon,W 59-28,,6,35,6,41,12,76
6143,PHI,2010,2010-12-12,8:30,7:30,@,DAL,14,13,Sun,W 30-27,,6,59,5,40,11,99
6144,PHI,2011,2011-10-30,8:28,8:28,,DAL,8,7,Sun,W 34-7,,6,33,3,20,9,53
6145,PHI,2011,2011-11-07,8:41,8:41,,CHI,9,8,Mon,L 24-30,,6,44,6,53,12,97
6146,PHI,2012,2012-10-28,1:03,1:03,,ATL,8,7,Sun,L 17-30,,6,57,6,40,12,97
6147,PHI,2012,2012-11-11,4:25,4:25,,DAL,10,9,Sun,L 23-38,,6,50,13,75,19,125
6148,PHI,2012,2012-12-30,1:04,1:04,@,NYG,17,16,Sun,L 7-42,,6,52,1,5,7,57
6149,PHI,2013,2013-09-19,8:29,8:29,,KAN,3,3,Thu,L 16-26,,6,45,9,65,15,110
6150,PHI,2013,2013-12-29,8:30,7:30,@,DAL,17,16,Sun,W 24-22,,6,50,1,5,7,55
6151,PHI,2014,2014-09-07,1:02,1:02,,JAX,1,1,Sun,W 34-17,,6,50,7,55,13,105
6152,PHI,2014,2014-11-16,4:25,3:25,@,GNB,11,10,Sun,L 20-53,,6,53,4,52,10,105
6153,PHI,2018,2018-09-16,1:00,1:00,@,TAM,2,2,Sun,L 21-27,,6,55,4,44,10,99
6154,PHI,2018,2018-11-18,4:25,12:00,@,NOR,11,10,Sun,L 7-48,,6,49,8,69,14,118
6155,PHI,2018,2018-12-16,8:20,5:20,@,LAR,15,14,Sun,W 30-23,,6,49,5,50,11,99
6156,PHI,2019,2019-09-08,1:00,1:00,,WAS,1,1,Sun,W 32-27,,6,55,12,96,18,151
6157,PHI,2020,2020-12-13,4:25,4:25,,NOR,14,13,Sun,W 24-21,,6,27,8,52,14,79
6158,PHI,2020,2021-01-03,8:20,8:20,,WAS,17,16,Sun,L 14-20,,6,41,5,56,11,97
6159,PHI,2021,2021-10-10,1:00,1:00,@,CAR,5,5,Sun,W 21-18,,6,60,9,69,15,129
6160,PHI,2021,2021-11-21,1:00,1:00,,NOR,11,11,Sun,W 40-29,,6,49,3,25,9,74
6161,PHI,2021,2022-01-02,1:00,1:00,@,WAS,17,16,Sun,W 20-16,,6,42,1,4,7,46
6162,PIT,2000,2000-12-16,12:37,12:37,,WAS,16,15,Sat,W 24-3,,6,40,7,70,13,110
6163,PIT,2001,2001-11-25,1:05,12:05,@,TEN,11,10,Sun,W 34-24,,6,62,6,45,12,107
6164,PIT,2001,2001-12-23,1:01,1:01,,DET,15,14,Sun,W 47-14,,6,60,2,15,8,75
6165,PIT,2002,2002-09-15,8:35,8:35,,OAK,2,2,Sun,L 17-30,,6,57,7,69,13,126
6166,PIT,2003,2003-09-21,1:02,1:02,@,CIN,3,3,Sun,W 17-10,,6,53,7,49,13,102
6167,PIT,2003,2003-11-09,1:02,1:02,,ARI,10,9,Sun,W 28-15,,6,69,8,81,14,150
6168,PIT,2004,2004-10-10,1:02,1:02,,CLE,5,5,Sun,W 34-23,,6,63,8,54,14,117
6169,PIT,2004,2004-10-17,4:15,3:15,@,DAL,6,6,Sun,W 24-20,,6,45,5,30,11,75
6170,PIT,2004,2004-11-28,1:02,1:02,,WAS,12,11,Sun,W 16-7,,6,59,6,68,12,127
6171,PIT,2006,2006-10-29,4:15,1:15,@,OAK,8,7,Sun,L 13-20,,6,70,5,45,11,115
6172,PIT,2007,2007-09-09,1:03,1:03,@,CLE,1,1,Sun,W 34-7,,6,45,6,51,12,96
6173,PIT,2007,2007-10-07,1:02,1:02,,SEA,5,5,Sun,W 21-0,,6,64,4,25,10,89
6174,PIT,2007,2007-12-09,4:15,4:15,@,NWE,14,13,Sun,L 13-34,,6,49,3,20,9,69
6175,PIT,2007,2007-12-30,4:17,4:17,@,BAL,17,16,Sun,L 21-27,,6,40,6,86,12,126
6176,PIT,2008,2008-12-14,4:15,4:15,@,BAL,15,14,Sun,W 13-9,,6,48,6,40,12,88
6177,PIT,2009,2009-09-10,8:41,8:41,,TEN,1,1,Thu,W 13-10,OT,6,60,5,28,11,88
6178,PIT,2009,2009-09-20,4:15,3:15,@,CHI,2,2,Sun,L 14-17,,6,52,10,80,16,132
6179,PIT,2009,2009-10-04,8:30,8:30,,SDG,4,4,Sun,W 38-28,,6,59,3,20,9,79
6180,PIT,2009,2009-10-11,1:02,1:02,@,DET,5,5,Sun,W 28-20,,6,59,6,66,12,125
6181,PIT,2010,2010-11-14,8:30,8:30,,NWE,10,9,Sun,L 26-39,,6,45,10,113,16,158
6182,PIT,2011,2011-09-11,1:05,1:05,@,BAL,1,1,Sun,L 7-35,,6,53,7,75,13,128
6183,PIT,2011,2011-11-06,8:30,8:30,,BAL,9,9,Sun,L 20-23,,6,69,3,20,9,89
6184,PIT,2011,2011-11-27,8:31,7:31,@,KAN,12,11,Sun,W 13-9,,6,50,4,20,10,70
6185,PIT,2012,2012-11-04,4:26,4:26,@,NYG,9,8,Sun,W 24-20,,6,119,7,40,13,159
6186,PIT,2012,2012-11-18,8:30,8:30,,BAL,11,10,Sun,L 10-13,,6,43,4,68,10,111
6187,PIT,2013,2013-09-22,8:30,8:30,,CHI,3,3,Sun,L 23-40,,6,59,3,25,9,84
6188,PIT,2013,2013-11-10,1:02,1:02,,BUF,10,9,Sun,W 23-10,,6,42,4,30,10,72
6189,PIT,2014,2014-10-12,1:02,1:02,@,CLE,6,6,Sun,L 10-31,,6,42,6,60,12,102
6190,PIT,2014,2014-10-20,8:30,8:30,,HOU,7,7,Mon,W 30-23,,6,38,4,20,10,58
6191,PIT,2015,2015-10-18,1:04,1:04,,ARI,6,6,Sun,W 25-13,,6,48,9,111,15,159
6192,PIT,2015,2015-11-29,4:26,1:26,@,SEA,12,11,Sun,L 30-39,,6,65,8,76,14,141
6193,PIT,2016,2016-10-16,1:02,1:02,@,MIA,6,6,Sun,L 15-30,,6,65,8,95,14,160
6194,PIT,2016,2016-12-11,1:00,1:00,@,BUF,14,13,Sun,W 27-20,,6,45,7,46,13,91
6195,PIT,2017,2017-09-24,1:00,12:00,@,CHI,3,3,Sun,L 17-23,OT,6,40,10,73,16,113
6196,PIT,2017,2017-10-15,4:25,3:25,@,KAN,6,6,Sun,W 19-13,,6,57,7,48,13,105
6197,PIT,2017,2017-12-10,8:30,8:30,,BAL,14,13,Sun,W 39-38,,6,101,5,35,11,136
6198,PIT,2017,2017-12-17,4:25,4:25,,NWE,15,14,Sun,L 24-27,,6,63,2,4,8,67
6199,PIT,2018,2018-12-23,4:25,3:25,@,NOR,16,15,Sun,L 28-31,,6,79,9,91,15,170
6200,PIT,2019,2019-09-08,8:20,8:20,@,NWE,1,1,Sun,L 3-33,,6,54,7,55,13,109
6201,PIT,2019,2019-09-22,4:25,1:25,@,SFO,3,3,Sun,L 20-24,,6,42,5,71,11,113
6202,PIT,2019,2019-10-13,8:20,5:20,@,LAC,6,6,Sun,W 24-17,,6,45,8,74,14,119
6203,PIT,2019,2019-11-14,8:20,8:20,@,CLE,11,10,Thu,L 7-21,,6,41,8,121,14,162
6204,PIT,2019,2019-12-15,8:20,8:20,,BUF,15,14,Sun,L 10-17,,6,30,8,70,14,100
6205,PIT,2019,2019-12-29,4:25,4:25,@,BAL,17,16,Sun,L 10-28,,6,47,6,35,12,82
6206,PIT,2020,2020-10-18,1:00,1:00,,CLE,6,5,Sun,W 38-7,,6,45,7,55,13,100
6207,PIT,2020,2020-11-15,4:25,4:25,,CIN,10,9,Sun,W 36-10,,6,45,6,65,12,110
6208,PIT,2020,2020-11-22,1:00,1:00,@,JAX,11,10,Sun,W 27-3,,6,42,8,105,14,147
6209,PIT,2020,2020-12-07,5:00,5:00,,WAS,13,12,Mon,L 17-23,,6,45,9,62,15,107
6210,PIT,2020,2020-12-27,1:00,1:00,,IND,16,15,Sun,W 28-24,,6,49,9,83,15,132
6211,PIT,2021,2022-01-09,1:00,1:00,@,BAL,18,17,Sun,W 16-13,OT,6,43,1,5,7,48
6212,OAK,2002,2002-10-27,1:00,12:00,@,KAN,8,7,Sun,L 10-20,,6,27,4,33,10,60
6213,OAK,2002,2002-11-03,4:15,1:15,,SFO,9,8,Sun,L 20-23,OT,6,44,3,40,9,84
6214,OAK,2003,2003-09-14,4:15,1:15,,CIN,2,2,Sun,W 23-20,,6,59,7,65,13,124
6215,OAK,2003,2003-10-20,9:05,6:05,,KAN,7,7,Mon,L 10-17,,6,50,7,67,13,117
6216,OAK,2003,2003-11-09,4:15,1:15,,NYJ,10,9,Sun,L 24-27,OT,6,37,3,25,9,62
6217,OAK,2004,2004-10-24,4:15,1:15,,NOR,7,7,Sun,L 26-31,,6,46,5,30,11,76
6218,OAK,2004,2004-12-05,4:05,1:05,,KAN,13,12,Sun,L 27-34,,6,49,7,45,13,94
6219,OAK,2005,2005-12-24,4:15,2:15,@,DEN,16,15,Sat,L 3-22,,6,41,5,25,11,66
6220,OAK,2006,2006-09-17,1:02,1:02,@,BAL,2,2,Sun,L 6-28,,6,45,10,72,16,117
6221,OAK,2006,2006-10-01,4:15,1:15,,CLE,4,3,Sun,L 21-24,,6,47,4,37,10,84
6222,OAK,2006,2006-12-10,1:03,1:03,@,CIN,14,13,Sun,L 10-27,,6,38,5,40,11,78
6223,OAK,2006,2006-12-23,8:00,5:00,,KAN,16,15,Sat,L 9-20,,6,45,4,40,10,85
6224,OAK,2006,2006-12-31,1:02,1:02,@,NYJ,17,16,Sun,L 3-23,,6,32,3,31,9,63
6225,OAK,2007,2007-11-04,4:15,1:15,,HOU,9,8,Sun,L 17-24,,6,40,9,56,15,96
6226,OAK,2007,2007-11-11,4:15,1:15,,CHI,10,9,Sun,L 6-17,,6,46,7,50,13,96
6227,OAK,2007,2007-12-16,4:05,1:05,,IND,15,14,Sun,L 14-21,,6,47,3,30,9,77
6228,OAK,2008,2008-12-04,8:15,5:15,@,SDG,14,13,Thu,L 7-34,,6,70,9,51,15,121
6229,OAK,2009,2009-09-14,10:16,7:16,,SDG,1,1,Mon,L 20-24,,6,40,9,60,15,100
6230,OAK,2009,2009-09-27,4:15,1:15,,DEN,3,3,Sun,L 3-23,,6,53,5,30,11,83
6231,OAK,2009,2009-11-01,4:05,1:05,@,SDG,8,8,Sun,L 16-24,,6,31,5,40,11,71
6232,OAK,2011,2011-11-27,4:05,1:05,,CHI,12,11,Sun,W 25-20,,6,44,7,61,13,105
6233,OAK,2012,2012-09-10,10:25,7:25,,SDG,1,1,Mon,L 14-22,,6,35,9,78,15,113
6234,OAK,2012,2012-12-23,1:04,1:04,@,CAR,16,15,Sun,L 6-17,,6,70,10,97,16,167
6235,OAK,2013,2013-10-27,4:05,1:05,,PIT,8,7,Sun,W 21-18,,6,39,3,12,9,51
6236,OAK,2014,2014-09-21,1:02,1:02,@,NWE,3,3,Sun,L 9-16,,6,49,6,59,12,108
6237,OAK,2015,2015-10-11,4:25,1:25,,DEN,5,5,Sun,L 10-16,,6,41,6,103,12,144
6238,OAK,2015,2015-11-01,4:05,1:05,,NYJ,8,7,Sun,W 34-20,,6,61,6,40,12,101
6239,OAK,2015,2015-11-22,1:02,1:02,@,DET,11,10,Sun,L 13-18,,6,31,7,55,13,86
6240,OAK,2016,2016-10-09,4:25,1:25,,SDG,5,5,Sun,W 34-31,,6,36,4,38,10,74
6241,OAK,2017,2017-10-29,1:00,1:00,@,BUF,8,8,Sun,L 14-34,,6,50,11,95,17,145
6242,OAK,2017,2017-12-03,4:25,1:25,,NYG,13,12,Sun,W 24-17,,6,42,1,5,7,47
6243,OAK,2017,2017-12-31,4:25,1:25,@,LAC,17,16,Sun,L 10-30,,6,85,7,65,13,150
6244,OAK,2018,2018-09-30,4:05,1:05,,CLE,4,4,Sun,W 45-42,OT,6,65,8,55,14,120
6245,OAK,2018,2018-11-01,8:20,5:20,@,SFO,9,8,Thu,L 3-34,,6,40,3,23,9,63
6246,OAK,2018,2018-11-11,4:05,1:05,,LAC,10,9,Sun,L 6-20,,6,55,6,70,12,125
6247,OAK,2018,2018-12-24,8:15,5:15,,DEN,16,15,Mon,W 27-14,,6,50,11,91,17,141
6248,OAK,2019,2019-10-06,1:00,6:00,,CHI,5,5,Sun,W 24-21,,6,69,10,75,16,144
6249,OAK,2019,2019-12-15,4:05,1:05,,JAX,15,14,Sun,L 16-20,,6,51,8,87,14,138
6250,LVR,2020,2020-09-27,1:00,1:00,@,NWE,3,3,Sun,L 20-36,,6,40,2,33,8,73
6251,LVR,2020,2020-12-13,4:05,1:05,,IND,14,13,Sun,L 27-44,,6,33,6,50,12,83
6252,LVR,2020,2020-12-17,8:20,5:20,,LAC,15,14,Thu,L 27-30,OT,6,69,3,20,9,89
6253,LVR,2021,2021-10-17,4:25,2:25,@,DEN,6,6,Sun,W 34-24,,6,54,6,53,12,107
6254,LVR,2021,2021-11-07,1:00,1:00,@,NYG,9,8,Sun,L 16-23,,6,65,4,35,10,100
6255,LVR,2021,2021-12-05,4:05,1:05,,WAS,13,12,Sun,L 15-17,,6,54,6,47,12,101
6256,LVR,2021,2022-01-02,1:00,1:00,@,IND,17,16,Sun,W 23-20,,6,41,3,25,9,66
6257,STL,2000,2000-12-24,1:02,12:02,@,NOR,17,16,Sun,W 26-21,,6,65,7,48,13,113
6258,STL,2002,2002-09-08,4:17,2:17,@,DEN,1,1,Sun,L 16-23,,6,44,3,31,9,75
6259,STL,2002,2002-10-20,1:02,12:02,,SEA,7,7,Sun,W 37-20,,6,35,2,15,8,50
6260,STL,2003,2003-10-13,9:00,8:00,,ATL,6,5,Mon,W 36-0,,6,45,3,30,9,75
6261,STL,2003,2003-12-21,1:02,12:02,,CIN,16,15,Sun,W 27-10,,6,40,5,38,11,78
6262,STL,2006,2006-09-17,4:06,1:06,@,SFO,2,2,Sun,L 13-20,,6,40,2,20,8,60
6263,STL,2006,2006-10-15,1:02,12:02,,SEA,6,6,Sun,L 28-30,,6,72,10,65,16,137
6264,STL,2006,2006-11-19,1:02,1:02,@,CAR,11,10,Sun,L 0-15,,6,40,9,80,15,120
6265,STL,2006,2006-12-24,1:02,12:02,,WAS,16,15,Sun,W 37-31,OT,6,30,2,58,8,88
6266,STL,2008,2008-11-16,4:05,1:05,@,SFO,11,10,Sun,L 16-35,,6,52,7,33,13,85
6267,STL,2008,2008-12-14,1:00,12:00,,SEA,15,14,Sun,L 20-23,,6,40,5,35,11,75
6268,STL,2009,2009-09-20,1:02,1:02,@,WAS,2,2,Sun,L 7-9,,6,45,5,35,11,80
6269,STL,2009,2009-09-27,1:00,12:00,,GNB,3,3,Sun,L 17-36,,6,40,6,51,12,91
6270,STL,2009,2009-10-18,1:03,1:03,@,JAX,6,6,Sun,L 20-23,OT,6,52,3,15,9,67
6271,STL,2009,2009-12-06,1:02,12:02,@,CHI,13,12,Sun,L 9-17,,6,85,4,35,10,120
6272,STL,2010,2010-10-17,1:00,12:00,,SDG,6,6,Sun,W 20-17,,6,35,6,31,12,66
6273,STL,2010,2010-10-24,1:02,1:02,@,TAM,7,7,Sun,L 17-18,,6,45,12,92,18,137
6274,STL,2010,2011-01-02,8:31,5:31,@,SEA,17,16,Sun,L 6-16,,6,46,7,70,13,116
6275,STL,2011,2012-01-01,1:00,12:00,,SFO,17,16,Sun,L 27-34,,6,50,5,80,11,130
6276,STL,2012,2012-09-30,1:00,12:00,,SEA,4,4,Sun,W 19-13,,6,37,5,55,11,92
6277,STL,2012,2012-10-21,1:00,12:00,,GNB,7,7,Sun,L 20-30,,6,30,3,30,9,60
6278,STL,2013,2013-10-06,1:00,12:00,,JAX,5,5,Sun,W 34-20,,6,53,4,45,10,98
6279,STL,2013,2013-11-03,1:00,12:00,,TEN,9,9,Sun,L 21-28,,6,44,3,30,9,74
6280,STL,2013,2013-11-24,1:00,12:00,,CHI,12,11,Sun,W 42-21,,6,39,10,84,16,123
6281,STL,2014,2014-12-11,8:25,7:25,,ARI,15,14,Thu,L 6-12,,6,69,8,59,14,128
6282,STL,2014,2014-12-28,4:27,1:27,@,SEA,17,16,Sun,L 6-20,,6,45,2,20,8,65
6283,STL,2015,2015-11-22,1:02,1:02,@,BAL,11,10,Sun,L 13-16,,6,35,10,137,16,172
6284,LAR,2016,2016-10-09,4:25,1:25,,BUF,5,5,Sun,L 19-30,,6,40,7,60,13,100
6285,LAR,2016,2016-11-27,1:00,12:00,@,NOR,12,11,Sun,L 21-49,,6,62,6,45,12,107
6286,LAR,2017,2017-10-22,1:00,6:00,,ARI,7,7,Sun,W 33-0,,6,45,10,65,16,110
6287,LAR,2017,2017-11-05,1:00,1:00,@,NYG,9,8,Sun,W 51-17,,6,55,4,52,10,107
6288,LAR,2017,2017-12-31,4:25,1:25,,SFO,17,16,Sun,L 13-34,,6,46,4,23,10,69
6289,LAR,2018,2018-09-23,4:05,1:05,,LAC,3,3,Sun,W 35-23,,6,64,4,30,10,94
6290,LAR,2018,2018-12-23,4:05,2:05,@,ARI,16,15,Sun,W 31-9,,6,66,7,54,13,120
6291,LAR,2018,2018-12-30,4:25,1:25,,SFO,17,16,Sun,W 48-32,,6,57,5,41,11,98
6292,LAR,2019,2019-10-03,8:20,5:20,@,SEA,5,5,Thu,L 29-30,,6,45,5,45,11,90
6293,LAR,2019,2019-11-17,8:20,5:20,,CHI,11,10,Sun,W 17-7,,6,34,2,25,8,59
6294,LAR,2020,2020-10-18,8:20,5:20,@,SFO,6,6,Sun,L 16-24,,6,34,7,63,13,97
6295,LAR,2020,2020-12-06,4:05,2:05,@,ARI,13,12,Sun,W 38-28,,6,75,5,21,11,96
6296,BAL,2000,2000-09-03,1:02,1:02,@,PIT,1,1,Sun,W 16-0,,6,42,2,15,8,57
6297,BAL,2000,2000-10-01,1:03,1:03,@,CLE,5,5,Sun,W 12-0,,6,62,8,60,14,122
6298,BAL,2000,2000-11-05,1:03,1:03,@,CIN,10,10,Sun,W 27-7,,6,50,6,40,12,90
6299,BAL,2000,2000-11-19,4:15,4:15,,DAL,12,12,Sun,W 27-0,,6,55,3,15,9,70
6300,BAL,2000,2000-12-17,4:15,2:15,@,ARI,16,15,Sun,W 13-7,,6,64,3,15,9,79
6301,BAL,2001,2001-09-09,1:02,1:02,,CHI,1,1,Sun,W 17-6,,6,55,5,56,11,111
6302,BAL,2001,2001-10-21,1:02,1:02,@,CLE,6,6,Sun,L 14-24,,6,49,12,78,18,127
6303,BAL,2001,2001-11-12,9:08,8:08,@,TEN,9,9,Mon,W 16-10,,6,60,7,72,13,132
6304,BAL,2001,2001-11-25,4:15,4:15,@,JAX,11,11,Sun,W 24-21,,6,39,9,58,15,97
6305,BAL,2002,2002-09-08,1:04,1:04,@,CAR,1,1,Sun,L 7-10,,6,45,6,35,12,80
6306,BAL,2002,2002-11-24,1:02,1:02,,TEN,12,11,Sun,W 13-12,,6,65,9,69,15,134
6307,BAL,2002,2002-12-22,4:15,4:15,,CLE,16,15,Sun,L 13-14,,6,40,7,70,13,110
6308,BAL,2003,2003-10-12,4:16,1:16,@,ARI,6,5,Sun,W 26-18,,6,55,5,35,11,90
6309,BAL,2004,2004-09-12,1:08,1:08,@,CLE,1,1,Sun,L 3-20,,6,46,6,50,12,96
6310,BAL,2004,2004-10-04,9:08,9:08,,KAN,4,4,Mon,L 24-27,,6,54,10,72,16,126
6311,BAL,2004,2004-10-31,1:03,1:03,@,PHI,8,7,Sun,L 10-15,,6,91,8,72,14,163
6312,BAL,2004,2004-12-12,1:01,1:01,,NYG,14,13,Sun,W 37-14,,6,86,9,65,15,151
6313,BAL,2004,2005-01-02,1:02,1:02,,MIA,17,16,Sun,W 30-23,,6,50,5,50,11,100
6314,BAL,2005,2005-10-31,9:07,9:07,@,PIT,8,7,Mon,L 19-20,,6,38,4,19,10,57
6315,BAL,2006,2006-12-10,1:00,12:00,@,KAN,14,13,Sun,W 20-10,,6,75,6,35,12,110
6316,BAL,2007,2007-10-14,1:02,1:02,,STL,6,6,Sun,W 22-3,,6,40,7,63,13,103
6317,BAL,2007,2007-11-11,4:05,4:05,,CIN,10,9,Sun,L 7-21,,6,30,7,45,13,75
6318,BAL,2007,2007-12-23,4:16,1:16,@,SEA,16,15,Sun,L 6-27,,6,69,0,0,6,69
6319,BAL,2007,2007-12-30,4:17,4:17,,PIT,17,16,Sun,W 27-21,,6,86,6,40,12,126
6320,BAL,2008,2008-12-14,4:15,4:15,,PIT,15,14,Sun,L 9-13,,6,40,6,48,12,88
6321,BAL,2009,2009-10-18,1:05,12:05,@,MIN,6,6,Sun,L 31-33,,6,74,3,15,9,89
6322,BAL,2010,2010-11-11,8:31,8:31,@,ATL,10,9,Thu,L 21-26,,6,51,1,5,7,56
6323,BAL,2011,2011-11-20,1:02,1:02,,CIN,11,10,Sun,W 31-24,,6,69,6,43,12,112
6324,BAL,2012,2012-09-10,7:10,7:10,,CIN,1,1,Mon,W 44-13,,6,50,3,41,9,91
6325,BAL,2012,2012-09-16,1:03,1:03,@,PHI,2,2,Sun,L 23-24,,6,45,7,58,13,103
6326,BAL,2012,2012-11-25,4:05,1:05,@,SDG,12,11,Sun,W 16-13,OT,6,60,5,37,11,97
6327,BAL,2012,2012-12-16,1:02,1:02,,DEN,15,14,Sun,L 17-34,,6,61,7,51,13,112
6328,BAL,2013,2013-10-06,1:02,1:02,@,MIA,5,5,Sun,W 26-23,,6,64,4,65,10,129
6329,BAL,2013,2013-10-13,1:02,1:02,,GNB,6,6,Sun,L 17-19,,6,40,8,55,14,95
6330,BAL,2013,2013-12-29,1:02,1:02,@,CIN,17,16,Sun,L 17-34,,6,56,10,76,16,132
6331,BAL,2014,2014-11-24,8:30,7:30,@,NOR,12,11,Mon,W 34-27,,6,42,5,50,11,92
6332,BAL,2016,2016-09-11,1:04,1:04,,BUF,1,1,Sun,W 13-7,,6,35,8,89,14,124
6333,BAL,2016,2016-11-10,8:25,8:25,,CLE,10,9,Thu,W 28-7,,6,61,3,35,9,96
6334,BAL,2017,2017-10-01,1:00,1:00,,PIT,4,4,Sun,L 9-26,,6,55,8,60,14,115
6335,BAL,2017,2017-11-05,1:00,12:00,@,TEN,9,9,Sun,L 20-23,,6,39,3,39,9,78
6336,BAL,2018,2018-11-25,1:00,1:00,,OAK,12,11,Sun,W 34-17,,6,45,4,24,10,69
6337,BAL,2019,2019-12-12,8:20,8:20,,NYJ,15,14,Thu,W 42-21,,6,35,8,94,14,129
6338,BAL,2019,2019-12-29,4:25,4:25,,PIT,17,16,Sun,W 28-10,,6,35,6,47,12,82
6339,BAL,2020,2020-09-28,8:15,8:15,,KAN,3,3,Mon,L 20-34,,6,45,6,38,12,83
6340,BAL,2020,2020-11-22,1:00,1:00,,TEN,11,10,Sun,L 24-30,OT,6,81,4,44,10,125
6341,BAL,2020,2021-01-03,1:00,1:00,@,CIN,17,16,Sun,W 38-3,,6,49,3,29,9,78
6342,BAL,2021,2021-09-26,1:00,1:00,@,DET,3,3,Sun,W 19-17,,6,69,7,35,13,104
6343,BAL,2021,2021-10-03,4:25,2:25,@,DEN,4,4,Sun,W 23-7,,6,55,4,25,10,80
6344,BAL,2021,2021-11-21,1:00,12:00,@,CHI,11,10,Sun,W 16-13,,6,36,6,58,12,94
6345,BAL,2021,2021-12-26,1:00,1:00,@,CIN,16,15,Sun,L 21-41,,6,27,5,45,11,72
6346,SDG,2000,2000-10-08,4:15,1:15,,DEN,6,6,Sun,L 7-21,,6,57,9,113,15,170
6347,SDG,2001,2001-09-30,4:15,1:15,,CIN,3,3,Sun,W 28-14,,6,65,7,61,13,126
6348,SDG,2001,2001-10-07,1:02,1:02,@,CLE,4,4,Sun,L 16-20,,6,30,6,40,12,70
6349,SDG,2001,2001-11-25,4:05,1:05,,ARI,11,11,Sun,L 17-20,,6,55,3,26,9,81
6350,SDG,2002,2002-11-24,1:02,1:02,@,MIA,12,11,Sun,L 3-30,,6,41,7,70,13,111
6351,SDG,2003,2003-10-27,9:09,7:09,,MIA,8,7,Mon,L 10-26,,6,35,8,47,14,82
6352,SDG,2003,2003-11-09,4:05,1:05,,MIN,10,9,Sun,W 42-28,,6,49,10,107,16,156
6353,SDG,2004,2004-09-26,4:05,2:05,@,DEN,3,3,Sun,L 13-23,,6,61,3,25,9,86
6354,SDG,2005,2005-11-27,1:02,1:02,@,WAS,12,11,Sun,W 23-17,OT,6,40,7,60,13,100
6355,SDG,2006,2006-10-15,4:15,1:15,@,SFO,6,5,Sun,W 48-19,,6,51,9,116,15,167
6356,SDG,2007,2007-10-07,4:15,2:15,@,DEN,5,5,Sun,W 41-3,,6,45,3,18,9,63
6357,SDG,2007,2007-10-14,4:15,1:15,,OAK,6,6,Sun,W 28-14,,6,40,8,68,14,108
6358,SDG,2007,2007-11-25,4:15,1:15,,BAL,12,11,Sun,W 32-14,,6,60,3,30,9,90
6359,SDG,2007,2007-12-02,1:00,12:00,@,KAN,13,12,Sun,W 24-10,,6,36,6,44,12,80
6360,SDG,2007,2007-12-24,8:10,5:10,,DEN,16,15,Mon,W 23-3,,6,42,4,40,10,82
6361,SDG,2007,2007-12-30,4:15,1:15,@,OAK,17,16,Sun,W 30-17,,6,75,8,60,14,135
6362,SDG,2008,2008-09-22,8:40,5:40,,NYJ,3,3,Mon,W 48-29,,6,37,2,5,8,42
6363,SDG,2008,2008-12-28,8:23,5:23,,DEN,17,16,Sun,W 52-21,,6,67,4,79,10,146
6364,SDG,2009,2009-12-25,7:34,6:34,@,TEN,16,15,Fri,W 42-17,,6,45,9,74,15,119
6365,SDG,2010,2010-10-17,1:00,12:00,@,STL,6,6,Sun,L 17-20,,6,31,6,35,12,66
6366,SDG,2010,2010-10-24,4:15,1:15,,NWE,7,7,Sun,L 20-23,,6,69,7,51,13,120
6367,SDG,2010,2010-11-07,1:02,12:02,@,HOU,9,9,Sun,W 29-23,,6,62,4,31,10,93
6368,SDG,2010,2010-12-12,4:15,1:15,,KAN,14,13,Sun,W 31-0,,6,47,2,15,8,62
6369,SDG,2011,2011-09-18,4:15,4:15,@,NWE,2,2,Sun,L 21-35,,6,44,8,80,14,124
6370,SDG,2011,2011-11-10,8:29,5:29,,OAK,10,9,Thu,L 17-24,,6,31,7,45,13,76
6371,SDG,2011,2011-12-05,8:41,8:41,@,JAX,13,12,Mon,W 38-14,,6,55,3,26,9,81
6372,SDG,2012,2012-12-09,1:02,1:02,@,PIT,14,13,Sun,W 34-24,,6,51,8,52,14,103
6373,SDG,2013,2013-11-10,4:25,1:25,,DEN,10,9,Sun,L 20-28,,6,40,3,28,9,68
6374,SDG,2013,2013-12-08,4:25,1:25,,NYG,14,13,Sun,W 37-14,,6,30,7,72,13,102
6375,SDG,2014,2014-09-08,9:20,7:20,@,ARI,1,1,Mon,L 17-18,,6,47,5,23,11,70
6376,SDG,2014,2014-09-14,4:05,1:05,,SEA,2,2,Sun,W 30-21,,6,53,8,53,14,106
6377,SDG,2014,2014-09-21,1:02,1:02,@,BUF,3,3,Sun,W 22-10,,6,44,11,110,17,154
6378,SDG,2014,2014-11-16,4:05,1:05,,OAK,11,10,Sun,W 13-6,,6,40,8,41,14,81
6379,SDG,2015,2015-10-04,4:05,1:05,,CLE,4,4,Sun,W 30-27,,6,31,12,91,18,122
6380,SDG,2015,2015-11-01,1:02,1:02,@,BAL,8,8,Sun,L 26-29,,6,66,5,46,11,112
6381,SDG,2015,2015-11-22,4:05,1:05,,KAN,11,10,Sun,L 3-33,,6,39,5,35,11,74
6382,SDG,2016,2016-12-04,4:25,1:25,,TAM,13,12,Sun,L 21-28,,6,45,6,35,12,80
6383,SDG,2016,2016-12-18,4:25,1:25,,OAK,15,14,Sun,L 16-19,,6,44,2,15,8,59
6384,LAC,2017,2017-09-17,4:05,1:05,,MIA,2,2,Sun,L 17-19,,6,56,5,23,11,79
6385,LAC,2018,2018-09-16,1:00,1:00,@,BUF,2,2,Sun,W 31-20,,6,45,6,31,12,76
6386,LAC,2018,2018-11-11,4:05,1:05,@,OAK,10,9,Sun,W 20-6,,6,70,6,55,12,125
6387,LAC,2018,2018-12-09,4:05,1:05,,CIN,14,13,Sun,W 26-21,,6,38,6,34,12,72
6388,LAC,2018,2018-12-30,4:25,2:25,@,DEN,17,16,Sun,W 23-9,,6,51,11,99,17,150
6389,LAC,2019,2019-12-08,4:05,4:05,@,JAX,14,13,Sun,W 45-10,,6,65,10,101,16,166
6390,LAC,2020,2020-09-13,4:05,4:05,@,CIN,1,1,Sun,W 16-13,,6,35,7,44,13,79
6391,LAC,2020,2020-09-20,4:25,1:25,,KAN,2,2,Sun,L 20-23,OT,6,40,11,90,17,130
6392,LAC,2020,2020-11-01,4:05,2:05,@,DEN,8,7,Sun,L 30-31,,6,67,8,70,14,137
6393,LAC,2020,2020-12-13,4:25,1:25,,ATL,14,13,Sun,W 20-17,,6,40,4,35,10,75
6394,LAC,2020,2020-12-27,4:05,1:05,,DEN,16,15,Sun,W 19-16,,6,45,6,44,12,89
6395,LAC,2021,2021-09-12,1:00,1:00,@,WAS,1,1,Sun,W 20-16,,6,94,8,57,14,151
6396,LAC,2021,2021-10-04,8:15,5:15,,LVR,4,4,Mon,W 28-14,,6,90,8,73,14,163
6397,LAC,2021,2021-10-10,4:05,1:05,,CLE,5,5,Sun,W 47-42,,6,49,7,77,13,126
6398,LAC,2021,2021-12-12,4:05,1:05,,NYG,14,13,Sun,W 37-21,,6,39,3,20,9,59
6399,SEA,2002,2002-09-22,4:14,4:14,@,NYG,3,3,Sun,L 6-9,,6,37,3,24,9,61
6400,SEA,2002,2002-10-27,1:04,12:04,@,DAL,8,7,Sun,W 17-14,,6,57,5,55,11,112
6401,SEA,2002,2002-11-17,4:16,1:16,,DEN,11,10,Sun,L 9-31,,6,56,11,104,17,160
6402,SEA,2002,2002-12-01,4:15,1:15,@,SFO,13,12,Sun,L 24-31,,6,55,2,10,8,65
6403,SEA,2003,2003-11-16,4:16,1:16,,DET,11,10,Sun,W 35-14,,6,49,8,56,14,105
6404,SEA,2003,2003-11-23,1:02,1:02,@,BAL,12,11,Sun,L 41-44,OT,6,89,14,112,20,201
6405,SEA,2003,2003-12-27,5:15,2:15,@,SFO,17,16,Sat,W 24-17,,6,43,6,45,12,88
6406,SEA,2004,2004-10-17,1:02,1:02,@,NWE,6,5,Sun,L 20-30,,6,50,6,46,12,96
6407,SEA,2004,2004-12-06,9:09,6:09,,DAL,13,12,Mon,L 39-43,,6,44,6,49,12,93
6408,SEA,2004,2004-12-26,4:16,1:16,,ARI,16,15,Sun,W 24-21,,6,51,4,25,10,76
6409,SEA,2005,2005-10-16,8:38,5:38,,HOU,6,6,Sun,W 42-10,,6,45,13,95,19,140
6410,SEA,2005,2005-11-06,4:05,2:05,@,ARI,9,8,Sun,W 33-19,,6,52,9,78,15,130
6411,SEA,2006,2006-12-10,4:05,2:05,@,ARI,14,13,Sun,L 21-27,,6,40,9,77,15,117
6412,SEA,2006,2006-12-24,4:16,1:16,,SDG,16,15,Sun,L 17-20,,6,50,10,85,16,135
6413,SEA,2007,2007-11-25,1:00,12:00,@,STL,12,11,Sun,W 24-19,,6,45,4,20,10,65
6414,SEA,2008,2008-10-12,4:16,1:16,,GNB,6,5,Sun,L 17-27,,6,50,5,45,11,95
6415,SEA,2008,2008-11-23,4:16,1:16,,WAS,12,11,Sun,L 17-20,,6,51,2,20,8,71
6416,SEA,2009,2009-09-20,4:05,1:05,@,SFO,2,2,Sun,L 10-23,,6,45,6,54,12,99
6417,SEA,2009,2009-10-04,1:03,1:03,@,IND,4,4,Sun,L 17-34,,6,45,7,48,13,93
6418,SEA,2009,2009-10-18,4:05,1:05,,ARI,6,6,Sun,L 3-27,,6,56,7,76,13,132
6419,SEA,2009,2009-11-01,1:03,12:03,@,DAL,8,7,Sun,L 17-38,,6,53,5,43,11,96
6420,SEA,2009,2009-11-08,4:06,1:06,,DET,9,8,Sun,W 32-20,,6,45,9,77,15,122
6421,SEA,2009,2009-12-20,4:16,1:16,,TAM,15,14,Sun,L 7-24,,6,50,6,35,12,85
6422,SEA,2010,2010-10-03,1:00,12:00,@,STL,4,4,Sun,L 3-20,,6,49,5,41,11,90
6423,SEA,2010,2010-11-14,4:15,2:15,@,ARI,10,9,Sun,W 36-18,,6,51,10,50,16,101
6424,SEA,2011,2011-09-18,1:02,1:02,@,PIT,2,2,Sun,L 0-24,,6,66,4,48,10,114
6425,SEA,2011,2011-10-02,4:05,1:05,,ATL,4,4,Sun,L 28-30,,6,40,4,35,10,75
6426,SEA,2011,2011-12-18,1:03,12:03,@,CHI,15,14,Sun,W 38-14,,6,36,5,45,11,81
6427,SEA,2011,2011-12-24,4:16,1:16,,SFO,16,15,Sat,L 17-19,,6,51,6,77,12,128
6428,SEA,2013,2013-10-13,4:06,1:06,,TEN,6,6,Sun,W 20-13,,6,65,7,44,13,109
6429,SEA,2013,2013-11-03,4:05,1:05,,TAM,9,9,Sun,W 27-24,OT,6,67,8,99,14,166
6430,SEA,2014,2014-11-09,4:26,1:26,,NYG,10,9,Sun,W 38-17,,6,50,4,35,10,85
6431,SEA,2015,2015-09-20,8:25,7:25,@,GNB,2,2,Sun,L 17-27,,6,92,6,35,12,127
6432,SEA,2015,2015-10-22,8:26,5:26,@,SFO,7,7,Thu,W 20-3,,6,50,4,33,10,83
6433,SEA,2015,2015-12-13,1:02,1:02,@,BAL,14,13,Sun,W 35-6,,6,42,9,94,15,136
6434,SEA,2015,2016-01-03,4:25,2:25,@,ARI,17,16,Sun,W 36-6,,6,70,6,43,12,113
6435,SEA,2016,2016-09-25,4:05,1:05,,SFO,3,3,Sun,W 37-18,,6,50,4,35,10,85
6436,SEA,2016,2016-12-04,8:30,5:30,,CAR,13,12,Sun,W 40-7,,6,37,6,63,12,100
6437,SEA,2017,2017-10-01,8:30,5:30,,IND,4,4,Sun,W 46-18,,6,45,5,31,11,76
6438,SEA,2017,2017-11-26,4:05,1:05,@,SFO,12,11,Sun,W 24-13,,6,35,7,74,13,109
6439,SEA,2017,2017-12-10,4:25,1:00,@,JAX,14,13,Sun,L 24-30,,6,73,7,48,13,121
6440,SEA,2018,2018-11-15,8:20,5:20,,GNB,11,10,Thu,W 27-24,,6,30,5,80,11,110
6441,SEA,2020,2020-09-13,1:00,1:00,@,ATL,1,1,Sun,W 38-25,,6,46,6,72,12,118
6442,SEA,2020,2020-11-01,4:25,1:25,,SFO,8,7,Sun,W 37-27,,6,30,6,36,12,66
6443,SEA,2020,2020-12-06,4:05,1:05,,NYG,13,12,Sun,L 12-17,,6,41,6,35,12,76
6444,SEA,2021,2021-10-17,8:20,8:20,@,PIT,6,6,Sun,L 20-23,OT,6,45,5,38,11,83
6445,SEA,2021,2021-10-25,8:15,5:15,,NOR,7,7,Mon,L 10-13,,6,53,7,90,13,143
6446,SEA,2021,2021-11-29,8:15,8:15,@,WAS,12,11,Mon,L 15-17,,6,51,4,38,10,89
6447,SEA,2021,2021-12-05,4:00,1:00,,SFO,13,12,Sun,W 30-23,,6,40,10,86,16,126
6448,SFO,2000,2000-10-01,4:15,1:15,,ARI,5,5,Sun,W 27-20,,6,40,4,40,10,80
6449,SFO,2000,2000-11-12,4:00,1:00,,KAN,11,11,Sun,W 21-7,,6,53,7,50,13,103
6450,SFO,2001,2001-09-09,1:15,1:15,,ATL,1,1,Sun,W 16-13,OT,6,60,3,25,9,85
6451,SFO,2001,2001-11-04,4:05,1:05,,DET,8,7,Sun,W 21-13,,6,83,8,62,14,145
6452,SFO,2002,2002-12-30,9:07,8:07,@,STL,17,16,Mon,L 20-31,,6,48,5,33,11,81
6453,SFO,2003,2003-10-12,8:37,5:37,@,SEA,6,6,Sun,L 19-20,,6,33,8,105,14,138
6454,SFO,2003,2003-10-26,4:06,2:06,@,ARI,8,8,Sun,L 13-16,OT,6,36,6,55,12,91
6455,SFO,2003,2003-11-23,1:02,12:02,@,GNB,12,11,Sun,L 10-20,,6,45,4,40,10,85
6456,SFO,2003,2003-11-30,1:02,1:02,@,BAL,13,12,Sun,L 6-44,,6,46,4,25,10,71
6457,SFO,2003,2003-12-27,5:15,2:15,,SEA,17,16,Sat,L 17-24,,6,45,6,43,12,88
6458,SFO,2004,2004-09-26,4:16,1:16,@,SEA,3,3,Sun,L 0-34,,6,50,3,19,9,69
6459,SFO,2004,2004-11-28,4:15,1:15,,MIA,12,11,Sun,L 17-24,,6,58,7,50,13,108
6460,SFO,2004,2004-12-05,1:02,12:02,@,STL,13,12,Sun,L 6-16,,6,35,8,59,14,94
6461,SFO,2005,2005-11-20,4:05,1:05,,SEA,11,10,Sun,L 25-27,,6,34,5,75,11,109
6462,SFO,2005,2005-12-04,4:05,1:05,,ARI,13,12,Sun,L 10-17,,6,44,11,80,17,124
6463,SFO,2005,2005-12-24,1:02,12:02,@,STL,16,15,Sat,W 24-20,,6,39,4,24,10,63
6464,SFO,2006,2006-10-01,1:00,12:00,@,KAN,4,4,Sun,L 0-41,,6,73,3,30,9,103
6465,SFO,2007,2007-09-10,10:25,7:25,,ARI,1,1,Mon,W 20-17,,6,40,10,71,16,111
6466,SFO,2008,2008-10-05,4:15,1:15,,NWE,5,5,Sun,L 21-30,,6,37,4,56,10,93
6467,SFO,2009,2009-09-20,4:05,1:05,,SEA,2,2,Sun,W 23-10,,6,54,6,45,12,99
6468,SFO,2009,2010-01-03,1:00,12:00,@,STL,17,16,Sun,W 28-6,,6,40,7,50,13,90
6469,SFO,2010,2010-09-26,1:04,12:04,@,KAN,3,3,Sun,L 10-31,,6,55,7,40,13,95
6470,SFO,2010,2010-10-03,1:03,1:03,@,ATL,4,4,Sun,L 14-16,,6,41,4,60,10,101
6471,SFO,2010,2010-10-31,1:07,5:07,,DEN,8,8,Sun,W 24-16,,6,67,8,60,14,127
6472,SFO,2010,2010-11-29,8:40,6:40,@,ARI,12,11,Mon,W 27-6,,6,40,6,61,12,101
6473,SFO,2010,2010-12-05,1:02,12:02,@,GNB,13,12,Sun,L 16-34,,6,32,5,40,11,72
6474,SFO,2011,2011-12-24,4:16,1:16,@,SEA,16,15,Sat,W 19-17,,6,77,6,51,12,128
6475,SFO,2012,2012-09-23,1:05,12:05,@,MIN,3,3,Sun,L 13-24,,6,60,1,10,7,70
6476,SFO,2012,2012-10-14,4:23,1:23,,NYG,6,6,Sun,L 3-26,,6,35,2,20,8,55
6477,SFO,2012,2012-12-09,4:05,1:05,,MIA,14,13,Sun,W 27-13,,6,45,5,43,11,88
6478,SFO,2012,2012-12-16,8:30,8:30,@,NWE,15,14,Sun,W 41-34,,6,88,8,73,14,161
6479,SFO,2012,2012-12-23,8:31,5:31,@,SEA,16,15,Sun,L 13-42,,6,58,4,45,10,103
6480,SFO,2013,2013-09-22,4:25,1:25,,IND,3,3,Sun,L 7-27,,6,48,1,10,7,58
6481,SFO,2014,2014-10-19,8:30,6:30,@,DEN,7,7,Sun,L 17-42,,6,62,8,75,14,137
6482,SFO,2015,2015-09-27,4:05,1:05,@,ARI,3,3,Sun,L 7-47,,6,45,4,24,10,69
6483,SFO,2015,2015-12-06,1:02,12:02,@,CHI,13,12,Sun,W 26-20,OT,6,50,8,72,14,122
6484,SFO,2016,2016-09-18,1:03,1:03,@,CAR,2,2,Sun,L 27-46,,6,50,8,50,14,100
6485,SFO,2016,2016-10-16,1:02,1:02,@,BUF,6,6,Sun,L 16-45,,6,52,7,71,13,123
6486,SFO,2017,2017-09-17,4:25,1:25,@,SEA,2,2,Sun,L 9-12,,6,66,9,71,15,137
6487,SFO,2017,2017-10-29,1:00,1:00,@,PHI,8,8,Sun,L 10-33,,6,69,4,35,10,104
6488,SFO,2017,2017-11-12,4:25,1:25,,NYG,10,10,Sun,W 31-21,,6,44,4,35,10,79
6489,SFO,2018,2018-12-23,4:05,1:05,,CHI,16,15,Sun,L 9-14,,6,45,4,30,10,75
6490,SFO,2019,2019-12-01,1:00,1:00,@,BAL,13,12,Sun,L 17-20,,6,54,3,23,9,77
6491,SFO,2020,2020-09-27,1:00,1:00,@,NYG,3,3,Sun,W 36-9,,6,45,5,28,11,73
6492,SFO,2020,2020-10-04,8:20,5:20,,PHI,4,4,Sun,L 20-25,,6,42,3,25,9,67
6493,SFO,2020,2020-10-25,4:25,4:25,@,NWE,7,7,Sun,W 33-6,,6,65,3,30,9,95
6494,SFO,2020,2020-11-01,4:25,1:25,@,SEA,8,8,Sun,L 27-37,,6,36,6,30,12,66
6495,SFO,2020,2020-11-15,4:25,3:25,@,NOR,10,10,Sun,L 13-27,,6,51,5,61,11,112
6496,SFO,2021,2021-12-12,1:00,1:00,@,CIN,14,13,Sun,W 26-23,OT,6,40,2,19,8,59
6497,SFO,2021,2022-01-09,4:25,1:25,@,LAR,18,17,Sun,W 27-24,OT,6,56,3,15,9,71
6498,TAM,2000,2000-11-12,4:15,4:15,,GNB,11,10,Sun,W 20-15,,6,37,4,35,10,72
6499,TAM,2000,2000-12-03,1:01,1:01,,DAL,14,13,Sun,W 27-7,,6,35,7,58,13,93
6500,TAM,2001,2001-09-09,12:03,12:03,@,DAL,1,1,Sun,W 10-6,,6,61,4,32,10,93
6501,TAM,2002,2002-10-06,1:03,1:03,@,ATL,5,5,Sun,W 20-6,,6,35,6,41,12,76
6502,TAM,2002,2002-11-24,4:15,4:15,,GNB,12,11,Sun,W 21-7,,6,54,7,62,13,116
6503,TAM,2002,2002-12-29,8:36,7:36,@,CHI,17,16,Sun,W 15-0,,6,26,5,45,11,71
6504,TAM,2003,2003-10-12,1:03,1:03,@,WAS,6,5,Sun,W 35-13,,6,59,9,72,15,131
6505,TAM,2003,2003-10-19,4:15,1:15,@,SFO,7,6,Sun,L 7-24,,6,74,5,35,11,109
6506,TAM,2004,2004-09-12,1:06,1:06,@,WAS,1,1,Sun,L 10-16,,6,44,3,23,9,67
6507,TAM,2004,2004-10-24,1:02,1:02,,CHI,7,7,Sun,W 19-7,,6,41,10,78,16,119
6508,TAM,2006,2006-09-24,1:03,1:03,,CAR,3,3,Sun,L 24-26,,6,56,7,40,13,96
6509,TAM,2007,2007-11-18,1:05,1:05,@,ATL,11,10,Sun,W 31-7,,6,45,11,105,17,150
6510,TAM,2008,2008-09-21,1:02,12:02,@,CHI,3,3,Sun,W 27-24,OT,6,61,8,64,14,125
6511,TAM,2008,2008-12-28,1:02,1:02,,OAK,17,16,Sun,L 24-31,,6,83,4,25,10,108
6512,TAM,2009,2009-10-25,1:06,5:06,,NWE,7,7,Sun,L 7-35,,6,55,10,66,16,121
6513,TAM,2009,2009-12-13,1:00,1:00,,NYJ,14,13,Sun,L 3-26,,6,34,6,63,12,97
6514,TAM,2009,2009-12-20,4:16,1:16,@,SEA,15,14,Sun,W 24-7,,6,35,6,50,12,85
6515,TAM,2010,2010-09-12,1:02,1:02,,CLE,1,1,Sun,W 17-14,,6,55,5,47,11,102
6516,TAM,2011,2011-09-11,1:06,1:06,,DET,1,1,Sun,L 20-27,,6,39,8,68,14,107
6517,TAM,2011,2011-09-18,1:05,12:05,@,MIN,2,2,Sun,W 24-20,,6,53,8,65,14,118
6518,TAM,2011,2011-11-13,1:02,1:02,,HOU,10,9,Sun,L 9-37,,6,49,8,54,14,103
6519,TAM,2011,2011-12-17,8:29,8:29,,DAL,15,14,Sat,L 15-31,,6,46,2,15,8,61
6520,TAM,2012,2012-10-14,1:00,1:00,,KAN,6,5,Sun,W 38-10,,6,33,7,55,13,88
6521,TAM,2012,2012-11-18,1:04,1:04,@,CAR,11,10,Sun,W 27-21,OT,6,50,11,91,17,141
6522,TAM,2016,2016-09-11,1:05,1:05,@,ATL,1,1,Sun,W 31-24,,6,48,7,74,13,122
6523,TAM,2016,2016-10-30,1:02,1:02,,OAK,8,7,Sun,L 24-30,OT,6,64,23,200,29,264
6524,TAM,2016,2016-12-04,4:25,1:25,@,SDG,13,12,Sun,W 28-21,,6,35,6,45,12,80
6525,TAM,2017,2017-10-29,1:00,1:00,,CAR,8,7,Sun,L 3-17,,6,55,5,51,11,106
6526,TAM,2017,2017-11-12,1:00,1:00,,NYJ,10,9,Sun,W 15-10,,6,50,8,77,14,127
6527,TAM,2018,2018-12-16,1:00,1:00,@,BAL,15,14,Sun,L 12-20,,6,58,8,70,14,128
6528,TAM,2019,2019-12-08,1:00,1:00,,IND,14,13,Sun,W 38-35,,6,104,3,35,9,139
6529,TAM,2019,2019-12-21,1:00,1:00,,HOU,16,15,Sat,L 20-23,,6,45,4,35,10,80
6530,TAM,2021,2021-10-10,1:00,1:00,,MIA,5,5,Sun,W 45-17,,6,47,5,37,11,84
6531,TAM,2021,2021-11-14,1:00,1:00,@,WAS,10,9,Sun,L 19-29,,6,43,3,33,9,76
6532,TAM,2021,2021-11-22,8:15,8:15,,NYG,11,10,Mon,W 30-10,,6,39,4,30,10,69
6533,TAM,2021,2021-12-26,1:00,1:00,@,CAR,16,15,Sun,W 32-6,,6,50,6,32,12,82
6534,WAS,2000,2000-09-10,4:16,4:16,@,DET,2,2,Sun,L 10-15,,6,55,7,50,13,105
6535,WAS,2000,2000-09-18,9:01,9:01,,DAL,3,3,Mon,L 21-27,,6,82,4,20,10,102
6536,WAS,2000,2000-10-15,1:01,1:01,,BAL,7,7,Sun,W 10-3,,6,51,7,41,13,92
6537,WAS,2000,2000-10-22,4:15,4:15,@,JAX,8,8,Sun,W 35-16,,6,59,5,42,11,101
6538,WAS,2000,2000-11-26,1:01,1:01,,PHI,13,12,Sun,L 20-23,,6,46,11,98,17,144
6539,WAS,2001,2001-09-09,4:15,1:15,@,SDG,1,1,Sun,L 3-30,,6,69,5,49,11,118
6540,WAS,2001,2001-11-04,4:15,4:15,,SEA,8,8,Sun,W 27-14,,6,45,1,16,7,61
6541,WAS,2001,2001-12-23,1:01,1:01,,CHI,15,14,Sun,L 15-20,,6,38,1,6,7,44
6542,WAS,2002,2002-11-03,4:15,1:15,@,SEA,9,8,Sun,W 14-3,,6,68,5,52,11,120
6543,WAS,2002,2002-11-10,4:05,4:05,@,JAX,10,9,Sun,L 7-26,,6,49,8,55,14,104
6544,WAS,2002,2002-11-28,4:17,3:17,@,DAL,13,12,Thu,L 20-27,,6,56,6,48,12,104
6545,WAS,2002,2002-12-22,1:02,1:02,,HOU,16,15,Sun,W 26-10,,6,60,10,83,16,143
6546,WAS,2003,2003-09-04,9:09,9:09,,NYJ,1,1,Thu,W 16-13,,6,55,1,5,7,60
6547,WAS,2003,2003-12-07,1:02,1:02,@,NYG,14,13,Sun,W 20-7,,6,35,7,70,13,105
6548,WAS,2004,2004-11-28,1:02,1:02,@,PIT,12,11,Sun,L 7-16,,6,68,6,59,12,127
6549,WAS,2005,2005-11-13,4:15,4:15,@,TAM,10,9,Sun,L 35-36,,6,41,2,15,8,56
6550,WAS,2005,2005-11-20,1:02,1:02,,OAK,11,10,Sun,L 13-16,,6,50,10,101,16,151
6551,WAS,2005,2005-12-24,1:03,1:03,,NYG,16,15,Sat,W 35-20,,6,81,9,64,15,145
6552,WAS,2006,2006-10-15,1:02,1:02,,TEN,6,6,Sun,L 22-25,,6,46,5,51,11,97
6553,WAS,2006,2006-11-26,1:03,1:03,,CAR,12,11,Sun,W 17-13,,6,40,4,40,10,80
6554,WAS,2007,2007-09-23,4:15,4:15,,NYG,3,3,Sun,L 17-24,,6,37,3,15,9,52
6555,WAS,2007,2007-10-21,1:02,1:02,,ARI,7,6,Sun,W 21-19,,6,53,9,75,15,128
6556,WAS,2009,2009-10-26,8:41,8:41,,PHI,7,7,Mon,L 17-27,,6,60,12,66,18,126
6557,WAS,2009,2009-12-21,8:40,8:40,,NYG,15,14,Mon,L 12-45,,6,52,3,15,9,67
6558,WAS,2010,2010-11-15,8:40,8:40,,PHI,10,9,Mon,L 28-59,,6,41,6,35,12,76
6559,WAS,2010,2010-11-28,1:02,1:02,,MIN,12,11,Sun,L 13-17,,6,35,3,15,9,50
6560,WAS,2011,2011-11-13,1:03,1:03,@,MIA,10,9,Sun,L 9-20,,6,51,6,55,12,106
6561,WAS,2011,2011-11-20,1:03,1:03,,DAL,11,10,Sun,L 24-27,OT,6,59,9,48,15,107
6562,WAS,2011,2011-12-04,1:03,1:03,,NYJ,13,12,Sun,L 19-34,,6,50,6,40,12,90
6563,WAS,2011,2012-01-01,1:02,1:02,@,PHI,17,16,Sun,L 10-34,,6,71,8,75,14,146
6564,WAS,2012,2012-09-23,1:03,1:03,,CIN,3,3,Sun,L 31-38,,6,60,8,80,14,140
6565,WAS,2012,2012-12-16,1:03,1:03,@,CLE,15,14,Sun,W 38-21,,6,45,5,30,11,75
6566,WAS,2013,2013-09-22,1:03,1:03,,DET,3,3,Sun,L 20-27,,6,45,8,71,14,116
6567,WAS,2014,2014-10-12,4:25,1:25,@,ARI,6,6,Sun,L 20-30,,6,62,14,108,20,170
6568,WAS,2014,2014-10-27,8:30,7:30,@,DAL,8,8,Mon,W 20-17,OT,6,45,3,35,9,80
6569,WAS,2014,2014-11-02,1:03,12:03,@,MIN,9,9,Sun,L 26-29,,6,55,9,60,15,115
6570,WAS,2016,2016-11-20,8:30,8:30,,GNB,11,10,Sun,W 42-24,,6,40,6,59,12,99
6571,WAS,2017,2017-12-24,1:00,1:00,,DEN,16,15,Sun,W 27-11,,6,35,3,30,9,65
6572,WAS,2018,2018-09-23,1:00,1:00,,GNB,3,3,Sun,W 31-17,,6,66,11,115,17,181
6573,WAS,2018,2018-10-08,8:15,7:15,@,NOR,5,4,Mon,L 19-43,,6,38,4,45,10,83
6574,WAS,2018,2018-11-18,1:00,1:00,,HOU,11,10,Sun,L 21-23,,6,43,7,40,13,83
6575,WAS,2018,2018-12-16,1:00,1:00,@,JAX,15,14,Sun,W 16-13,,6,48,8,55,14,103
6576,WAS,2019,2019-09-15,1:00,1:00,,DAL,2,2,Sun,L 21-31,,6,44,8,67,14,111
6577,WAS,2019,2019-10-06,1:00,1:00,,NWE,5,5,Sun,L 7-33,,6,72,7,55,13,127
6578,WAS,2019,2019-10-13,1:00,1:00,@,MIA,6,6,Sun,W 17-16,,6,56,5,45,11,101
6579,WAS,2019,2019-12-01,1:00,1:00,@,CAR,13,12,Sun,W 29-21,,6,65,5,43,11,108
6580,WAS,2019,2019-12-22,1:00,1:00,,NYG,16,15,Sun,L 35-41,OT,6,51,4,33,10,84
6581,WAS,2020,2020-09-20,4:05,2:05,@,ARI,2,2,Sun,L 15-30,,6,42,11,97,17,139
6582,WAS,2020,2020-11-08,1:00,1:00,,NYG,9,8,Sun,L 20-23,,6,45,4,40,10,85
6583,WAS,2020,2020-11-15,1:00,1:00,@,DET,10,9,Sun,L 27-30,,6,58,9,55,15,113
6584,WAS,2020,2020-11-22,1:00,1:00,,CIN,11,10,Sun,W 20-9,,6,49,3,31,9,80
6585,WAS,2020,2020-12-20,1:00,1:00,,SEA,15,14,Sun,L 15-20,,6,41,4,45,10,86
6586,WAS,2021,2021-10-03,1:00,1:00,@,ATL,4,4,Sun,W 34-30,,6,85,7,36,13,121
6587,WAS,2021,2021-10-17,1:00,1:00,,KAN,6,6,Sun,L 13-31,,6,44,5,47,11,91
6588,WAS,2021,2021-12-05,4:05,1:05,@,LVR,13,12,Sun,W 17-15,,6,47,6,54,12,101
6589,ATL,2000,2000-09-24,1:02,1:02,,STL,4,4,Sun,L 20-41,,5,42,10,90,15,132
6590,ATL,2000,2000-11-05,1:02,1:02,,TAM,10,10,Sun,L 14-27,,5,25,4,43,9,68
6591,ATL,2000,2000-12-17,1:03,12:03,@,NOR,16,15,Sun,L 7-23,,5,33,7,50,12,83
6592,ATL,2001,2001-10-21,12:03,12:03,@,NOR,6,6,Sun,W 20-13,,5,34,3,25,8,59
6593,ATL,2001,2001-12-23,1:05,1:05,,BUF,15,14,Sun,W 33-30,,5,43,12,95,17,138
6594,ATL,2001,2001-12-30,1:02,1:02,@,MIA,16,15,Sun,L 14-21,,5,37,5,48,10,85
6595,ATL,2002,2002-09-15,1:04,1:04,,CHI,2,2,Sun,L 13-14,,5,40,7,79,12,119
6596,ATL,2002,2002-12-01,12:00,12:00,@,MIN,13,12,Sun,W 30-24,OT,5,34,10,95,15,129
6597,ATL,2003,2003-09-14,1:03,1:03,,WAS,2,2,Sun,L 31-33,,5,35,12,79,17,114
6598,ATL,2003,2003-09-21,1:03,1:03,,TAM,3,3,Sun,L 10-31,,5,35,10,123,15,158
6599,ATL,2003,2003-10-19,1:03,1:03,,NOR,7,7,Sun,L 17-45,,5,78,7,54,12,132
6600,ATL,2003,2003-11-16,1:04,12:04,@,NOR,11,10,Sun,L 20-23,OT,5,44,7,46,12,90
6601,ATL,2003,2003-11-23,4:15,4:15,,TEN,12,11,Sun,L 31-38,,5,40,9,62,14,102
6602,ATL,2006,2006-09-25,8:48,7:48,@,NOR,3,3,Mon,L 3-23,,5,43,4,40,9,83
6603,ATL,2006,2006-10-01,1:03,1:03,,ARI,4,4,Sun,W 32-10,,5,40,4,19,9,59
6604,ATL,2007,2007-09-16,1:04,1:04,@,JAX,2,2,Sun,L 7-13,,5,44,11,91,16,135
6605,ATL,2007,2007-11-04,1:02,1:02,,SFO,9,8,Sun,W 20-16,,5,31,4,30,9,61
6606,ATL,2007,2007-11-22,8:16,8:16,,IND,12,11,Thu,L 13-31,,5,41,6,55,11,96
6607,ATL,2007,2007-12-16,1:03,1:03,@,TAM,15,14,Sun,L 3-37,,5,48,5,44,10,92
6608,ATL,2007,2007-12-30,1:04,1:04,,SEA,17,16,Sun,W 44-41,,5,41,9,85,14,126
6609,ATL,2008,2008-09-28,1:04,1:04,@,CAR,4,4,Sun,L 9-24,,5,45,11,90,16,135
6610,ATL,2008,2008-11-16,1:02,1:02,,DEN,11,10,Sun,L 20-24,,5,36,6,36,11,72
6611,ATL,2008,2008-12-07,1:02,12:02,@,NOR,14,13,Sun,L 25-29,,5,34,3,30,8,64
6612,ATL,2011,2011-10-09,8:30,8:30,,GNB,5,5,Sun,L 14-25,,5,44,6,55,11,99
6613,ATL,2011,2011-11-20,4:15,4:15,,TEN,11,10,Sun,W 23-17,,5,55,10,86,15,141
6614,ATL,2011,2011-12-11,1:04,1:04,@,CAR,14,13,Sun,W 31-23,,5,50,5,50,10,100
6615,ATL,2012,2012-11-18,1:03,1:03,,ARI,11,10,Sun,W 23-19,,5,35,5,43,10,78
6616,ATL,2012,2012-11-29,8:29,8:29,,NOR,13,12,Thu,W 23-13,,5,25,5,30,10,55
6617,ATL,2013,2013-12-23,8:40,5:40,@,SFO,16,15,Mon,L 24-34,,5,37,7,45,12,82
6618,ATL,2013,2013-12-29,1:05,1:05,,CAR,17,16,Sun,L 20-21,,5,56,4,38,9,94
6619,ATL,2014,2014-09-18,8:26,8:26,,TAM,3,3,Thu,W 56-14,,5,50,11,110,16,160
6620,ATL,2014,2014-09-28,4:25,3:25,@,MIN,4,4,Sun,L 28-41,,5,50,6,40,11,90
6621,ATL,2014,2014-10-26,9:37,1:37,,DET,8,8,Sun,L 21-22,,5,39,8,85,13,124
6622,ATL,2014,2014-11-09,1:04,1:04,@,TAM,10,9,Sun,W 27-17,,5,30,10,79,15,109
6623,ATL,2014,2014-11-16,1:03,1:03,@,CAR,11,10,Sun,W 19-17,,5,58,1,15,6,73
6624,ATL,2015,2015-12-20,1:02,1:02,@,JAX,15,14,Sun,W 23-17,,5,43,5,62,10,105
6625,ATL,2016,2016-12-04,1:00,1:00,,KAN,13,12,Sun,L 28-29,,5,30,13,128,18,158
6626,ATL,2016,2016-12-11,4:25,1:25,@,LAR,14,13,Sun,W 42-14,,5,40,11,105,16,145
6627,ATL,2017,2017-11-12,4:25,4:25,,DAL,10,9,Sun,W 27-7,,5,35,5,54,10,89
6628,ATL,2018,2018-09-23,1:00,1:00,,NOR,3,3,Sun,L 37-43,OT,5,54,11,120,16,174
6629,ATL,2018,2018-10-14,1:00,1:00,,TAM,6,6,Sun,W 34-29,,5,30,4,20,9,50
6630,ATL,2018,2018-10-22,8:15,8:15,,NYG,7,7,Mon,W 23-20,,5,29,4,58,9,87
6631,ATL,2019,2019-10-20,1:00,1:00,,LAR,7,7,Sun,L 10-37,,5,48,5,24,10,72
6632,ATL,2019,2019-10-27,1:00,1:00,,SEA,8,8,Sun,L 20-27,,5,40,9,60,14,100
6633,ATL,2019,2019-12-29,1:00,1:00,@,TAM,17,16,Sun,W 28-22,OT,5,53,12,97,17,150
6634,ATL,2020,2020-10-18,1:00,3:00,@,MIN,6,6,Sun,W 40-23,,5,25,3,30,8,55
6635,ATL,2020,2020-11-08,1:00,1:00,,DEN,9,9,Sun,W 34-27,,5,61,5,65,10,126
6636,ATL,2021,2021-11-28,1:00,1:00,@,JAX,12,11,Sun,W 21-14,,5,26,6,43,11,69
6637,ATL,2021,2022-01-09,1:00,1:00,,NOR,18,17,Sun,L 20-30,,5,46,4,40,9,86
6638,BUF,2000,2000-09-10,1:01,1:01,,GNB,2,2,Sun,W 27-18,,5,33,2,12,7,45
6639,BUF,2000,2000-10-29,1:01,1:01,,NYJ,9,8,Sun,W 23-20,,5,45,2,20,7,65
6640,BUF,2001,2001-10-18,8:35,8:35,@,JAX,6,5,Thu,W 13-10,,5,31,3,35,8,66
6641,BUF,2001,2002-01-06,4:17,4:17,@,MIA,17,16,Sun,L 7-34,,5,36,7,56,12,92
6642,BUF,2002,2002-11-03,1:02,1:02,,NWE,9,9,Sun,L 7-38,,5,59,8,59,13,118
6643,BUF,2002,2002-11-24,1:02,1:02,@,NYJ,12,11,Sun,L 13-31,,5,34,1,5,6,39
6644,BUF,2003,2003-10-12,4:15,4:15,@,NYJ,6,6,Sun,L 3-30,,5,45,3,25,8,70
6645,BUF,2003,2003-10-26,8:30,7:30,@,KAN,8,8,Sun,L 5-38,,5,31,5,60,10,91
6646,BUF,2004,2004-10-24,1:02,1:02,@,BAL,7,6,Sun,L 6-20,,5,40,4,25,9,65
6647,BUF,2004,2004-12-26,4:06,1:06,@,SFO,16,15,Sun,W 41-7,,5,46,4,30,9,76
6648,BUF,2005,2005-11-13,1:02,1:02,,KAN,10,9,Sun,W 14-3,,5,37,8,65,13,102
6649,BUF,2006,2006-11-12,1:02,1:02,@,IND,10,9,Sun,L 16-17,,5,40,6,54,11,94
6650,BUF,2006,2006-12-17,1:02,1:02,,MIA,15,14,Sun,W 21-0,,5,17,2,25,7,42
6651,BUF,2006,2006-12-24,1:02,1:02,,TEN,16,15,Sun,L 29-30,,5,50,11,81,16,131
6652,BUF,2007,2007-09-09,1:02,1:02,,DEN,1,1,Sun,L 14-15,,5,40,3,31,8,71
6653,BUF,2007,2007-09-16,1:02,1:02,@,PIT,2,2,Sun,L 3-26,,5,55,2,9,7,64
6654,BUF,2007,2007-09-23,1:02,1:02,@,NWE,3,3,Sun,L 7-38,,5,30,2,20,7,50
6655,BUF,2007,2007-10-08,8:40,8:40,,DAL,5,5,Mon,L 24-25,,5,49,5,31,10,80
6656,BUF,2007,2007-11-18,8:24,8:24,,NWE,11,10,Sun,L 10-56,,5,34,4,37,9,71
6657,BUF,2007,2007-11-25,1:03,1:03,@,JAX,12,11,Sun,L 14-36,,5,29,1,5,6,34
6658,BUF,2008,2008-09-28,4:05,3:05,@,STL,4,4,Sun,W 31-14,,5,35,5,50,10,85
6659,BUF,2008,2008-10-19,1:02,1:02,,SDG,7,6,Sun,W 23-14,,5,35,5,35,10,70
6660,BUF,2010,2010-09-12,1:02,1:02,,MIA,1,1,Sun,L 10-15,,5,35,3,15,8,50
6661,BUF,2010,2010-10-10,1:02,1:02,,JAX,5,5,Sun,L 26-36,,5,35,5,38,10,73
6662,BUF,2010,2010-10-31,1:08,12:08,@,KAN,8,7,Sun,L 10-13,OT,5,35,5,50,10,85
6663,BUF,2010,2010-12-19,1:02,1:02,@,MIA,15,14,Sun,W 17-14,,5,44,4,35,9,79
6664,BUF,2011,2011-09-11,1:06,12:06,@,KAN,1,1,Sun,W 41-7,,5,30,1,3,6,33
6665,BUF,2011,2012-01-01,1:02,1:02,@,NWE,17,16,Sun,L 21-49,,5,45,4,77,9,122
6666,BUF,2012,2012-09-16,1:02,1:02,,KAN,2,2,Sun,W 35-17,,5,50,4,33,9,83
6667,BUF,2012,2012-10-07,4:25,1:25,@,SFO,5,5,Sun,L 3-45,,5,30,7,53,12,83
6668,BUF,2012,2012-10-14,4:05,1:05,@,ARI,6,6,Sun,W 19-16,OT,5,39,7,67,12,106
6669,BUF,2014,2014-12-28,1:02,1:02,@,NWE,17,16,Sun,W 17-9,,5,44,5,55,10,99
6670,BUF,2015,2015-09-27,4:25,4:25,@,MIA,3,3,Sun,W 41-14,,5,40,6,36,11,76
6671,BUF,2015,2015-11-12,8:26,8:26,@,NYJ,10,9,Thu,W 22-17,,5,44,3,20,8,64
6672,BUF,2015,2015-11-23,8:30,8:30,@,NWE,11,10,Mon,L 13-20,,5,44,5,61,10,105
6673,BUF,2015,2015-12-06,1:02,1:02,,HOU,13,12,Sun,W 30-21,,5,42,10,89,15,131
6674,BUF,2016,2016-12-18,1:00,1:00,,CLE,15,14,Sun,W 33-13,,5,42,4,51,9,93
6675,BUF,2016,2016-12-24,1:00,1:00,,MIA,16,15,Sat,L 31-34,OT,5,35,2,15,7,50
6676,BUF,2017,2017-09-17,1:00,1:00,@,CAR,2,2,Sun,L 3-9,,5,44,6,40,11,84
6677,BUF,2019,2019-11-17,1:00,1:00,@,MIA,11,10,Sun,W 37-20,,5,50,6,44,11,94
6678,BUF,2019,2019-12-08,1:00,1:00,,BAL,14,13,Sun,L 17-24,,5,49,9,99,14,148
6679,BUF,2019,2019-12-29,1:00,1:00,,NYJ,17,16,Sun,L 6-13,,5,40,2,13,7,53
6680,BUF,2020,2020-09-27,1:00,1:00,,LAR,3,3,Sun,W 35-32,,5,55,3,30,8,85
6681,BUF,2020,2020-10-04,4:25,1:25,@,LVR,4,4,Sun,W 30-23,,5,81,7,65,12,146
6682,BUF,2020,2020-11-01,1:00,1:00,,NWE,8,8,Sun,W 24-21,,5,30,5,35,10,65
6683,BUF,2021,2021-09-26,1:00,1:00,,WAS,3,3,Sun,W 43-21,,5,30,5,38,10,68
6684,BUF,2021,2021-12-26,1:00,1:00,@,NWE,16,15,Sun,W 33-21,,5,45,3,30,8,75
6685,CAR,2000,2000-10-01,1:02,1:02,,DAL,5,4,Sun,L 13-16,OT,5,55,4,45,9,100
6686,CAR,2000,2000-10-08,4:15,4:15,,SEA,6,5,Sun,W 26-3,,5,30,12,80,17,110
6687,CAR,2000,2000-11-05,8:35,7:35,@,STL,10,9,Sun,W 27-24,,5,40,7,52,12,92
6688,CAR,2000,2000-11-19,1:00,12:00,@,MIN,12,11,Sun,L 17-31,,5,30,8,53,13,83
6689,CAR,2000,2000-12-10,1:00,12:00,@,KAN,15,14,Sun,L 14-15,,5,47,5,35,10,82
6690,CAR,2000,2000-12-24,4:15,1:15,@,OAK,17,16,Sun,L 9-52,,5,70,7,60,12,130
6691,CAR,2001,2001-10-28,1:02,1:02,,NYJ,7,7,Sun,L 12-13,,5,55,3,15,8,70
6692,CAR,2001,2001-11-04,1:01,1:01,@,MIA,8,8,Sun,L 6-23,,5,44,5,45,10,89
6693,CAR,2001,2001-12-09,1:02,1:02,@,BUF,13,13,Sun,L 24-25,,5,40,9,125,14,165
6694,CAR,2002,2002-11-24,1:02,1:02,,ATL,12,11,Sun,L 0-41,,5,39,6,65,11,104
6695,CAR,2003,2003-10-19,1:02,1:02,,TEN,7,6,Sun,L 17-37,,5,45,5,40,10,85
6696,CAR,2004,2004-11-28,1:04,1:04,,TAM,12,11,Sun,W 21-14,,5,50,7,40,12,90
6697,CAR,2004,2004-12-26,4:15,4:15,@,TAM,16,15,Sun,W 37-20,,5,52,10,77,15,129
6698,CAR,2005,2005-11-06,1:02,1:02,@,TAM,9,8,Sun,W 34-14,,5,24,8,42,13,66
6699,CAR,2005,2005-12-11,1:03,1:03,,TAM,14,13,Sun,L 10-20,,5,35,7,50,12,85
6700,CAR,2006,2006-10-29,8:20,8:20,,DAL,8,8,Sun,L 14-35,,5,44,9,86,14,130
6701,CAR,2007,2007-09-16,1:02,1:02,,HOU,2,2,Sun,L 21-34,,5,35,5,40,10,75
6702,CAR,2007,2007-11-25,1:03,1:03,,NOR,12,11,Sun,L 6-31,,5,35,5,76,10,111
6703,CAR,2007,2007-12-09,1:03,1:03,@,JAX,14,13,Sun,L 6-37,,5,50,6,40,11,90
6704,CAR,2007,2007-12-16,1:02,1:02,,SEA,15,14,Sun,W 13-10,,5,54,3,15,8,69
6705,CAR,2008,2008-12-14,4:15,4:15,,DEN,15,14,Sun,W 30-10,,5,35,3,25,8,60
6706,CAR,2008,2008-12-28,1:03,12:03,@,NOR,17,16,Sun,W 33-31,,5,30,7,48,12,78
6707,CAR,2009,2009-09-13,1:04,1:04,,PHI,1,1,Sun,L 10-38,,5,30,9,76,14,106
6708,CAR,2009,2009-10-11,1:04,1:04,,WAS,5,4,Sun,W 20-17,,5,27,4,20,9,47
6709,CAR,2009,2009-11-15,1:03,1:03,,ATL,10,9,Sun,W 28-19,,5,48,4,26,9,74
6710,CAR,2009,2009-11-29,1:02,1:02,@,NYJ,12,11,Sun,L 6-17,,5,30,3,24,8,54
6711,CAR,2009,2009-12-06,1:03,1:03,,TAM,13,12,Sun,W 16-6,,5,37,5,50,10,87
6712,CAR,2011,2011-12-11,1:04,1:04,,ATL,14,13,Sun,L 23-31,,5,50,5,50,10,100
6713,CAR,2013,2013-12-08,8:30,7:30,@,NOR,14,13,Sun,L 13-31,,5,35,5,45,10,80
6714,CAR,2014,2014-12-21,1:04,1:04,,CLE,16,15,Sun,W 17-13,,5,49,6,49,11,98
6715,CAR,2014,2014-12-28,4:25,4:25,@,ATL,17,16,Sun,W 34-3,,5,36,6,36,11,72
6716,CAR,2015,2015-10-04,1:03,1:03,@,TAM,4,4,Sun,W 37-23,,5,45,5,48,10,93
6717,CAR,2015,2015-10-18,4:06,1:06,@,SEA,6,5,Sun,W 27-23,,5,25,7,48,12,73
6718,CAR,2015,2015-10-25,8:31,8:31,,PHI,7,6,Sun,W 27-16,,5,43,7,46,12,89
6719,CAR,2015,2015-11-15,1:03,12:03,@,TEN,10,9,Sun,W 27-10,,5,45,4,30,9,75
6720,CAR,2016,2016-10-16,1:03,12:03,@,NOR,6,6,Sun,L 38-41,,5,51,10,126,15,177
6721,CAR,2016,2016-10-30,12:47,12:47,,ARI,8,7,Sun,W 30-20,,5,40,10,88,15,128
6722,CAR,2016,2016-11-06,4:05,1:05,@,LAR,9,8,Sun,W 13-10,,5,35,10,109,15,144
6723,CAR,2016,2016-12-11,1:00,1:00,,SDG,14,13,Sun,W 28-16,,5,35,7,32,12,67
6724,CAR,2017,2017-09-10,4:25,1:25,@,SFO,1,1,Sun,W 23-3,,5,40,10,74,15,114
6725,CAR,2017,2017-10-29,1:00,1:00,@,TAM,8,8,Sun,W 17-3,,5,51,6,55,11,106
6726,CAR,2017,2017-11-05,1:00,1:00,,ATL,9,9,Sun,W 20-17,,5,29,8,70,13,99
6727,CAR,2017,2017-12-17,1:00,1:00,,GNB,15,14,Sun,W 31-24,,5,40,6,28,11,68
6728,CAR,2017,2017-12-31,4:25,1:00,@,ATL,17,16,Sun,L 10-22,,5,35,7,60,12,95
6729,CAR,2018,2018-10-21,1:00,1:00,@,PHI,7,6,Sun,W 21-17,,5,78,4,35,9,113
6730,CAR,2018,2018-11-08,8:20,8:20,@,PIT,10,9,Thu,L 21-52,,5,42,1,24,6,66
6731,CAR,2019,2019-09-12,8:20,8:20,,TAM,2,2,Thu,L 14-20,,5,50,12,66,17,116
6732,CAR,2019,2019-11-10,4:25,3:25,@,GNB,10,9,Sun,L 16-24,,5,46,10,64,15,110
6733,CAR,2019,2019-12-01,1:00,1:00,,WAS,13,12,Sun,L 21-29,,5,43,6,65,11,108
6734,CAR,2019,2019-12-29,1:00,1:00,,NOR,17,16,Sun,L 10-42,,5,54,3,44,8,98
6735,CAR,2020,2020-09-13,1:00,1:00,,LVR,1,1,Sun,L 30-34,,5,65,3,40,8,105
6736,CAR,2020,2020-11-15,1:00,1:00,,TAM,10,10,Sun,L 23-46,,5,40,3,30,8,70
6737,CAR,2021,2021-09-19,1:00,1:00,,NOR,2,2,Sun,W 26-7,,5,49,11,115,16,164
6738,CAR,2021,2021-12-19,1:00,1:00,@,BUF,15,14,Sun,L 14-31,,5,55,8,67,13,122
6739,CHI,2000,2000-09-03,1:00,12:00,@,MIN,1,1,Sun,L 27-30,,5,45,4,20,9,65
6740,CHI,2000,2000-10-08,1:03,12:03,,NOR,6,6,Sun,L 10-31,,5,45,10,149,15,194
6741,CHI,2000,2000-11-26,1:02,1:02,@,NYJ,13,12,Sun,L 10-17,,5,29,4,35,9,64
6742,CHI,2000,2000-12-03,8:35,7:35,,GNB,14,13,Sun,L 6-28,,5,41,5,42,10,83
6743,CHI,2000,2000-12-24,1:02,1:02,@,DET,17,16,Sun,W 23-20,,5,28,2,20,7,48
6744,CHI,2001,2001-09-09,1:02,1:02,@,BAL,1,1,Sun,L 6-17,,5,56,6,55,11,111
6745,CHI,2001,2001-10-07,1:05,1:05,@,ATL,4,3,Sun,W 31-3,,5,67,6,55,11,122
6746,CHI,2001,2001-10-14,12:03,12:03,,ARI,5,4,Sun,W 20-13,,5,45,6,50,11,95
6747,CHI,2001,2001-12-02,1:03,12:03,,DET,12,11,Sun,W 13-10,,5,56,10,79,15,135
6748,CHI,2002,2002-09-29,1:04,1:04,@,BUF,4,4,Sun,L 27-33,OT,5,55,9,82,14,137
6749,CHI,2002,2002-10-20,1:03,1:03,@,DET,7,6,Sun,L 20-23,OT,5,40,10,79,15,119
6750,CHI,2002,2002-11-10,4:15,3:15,,NWE,10,9,Sun,L 30-33,,5,30,6,65,11,95
6751,CHI,2002,2002-11-18,9:07,8:07,@,STL,11,10,Mon,L 16-21,,5,50,11,97,16,147
6752,CHI,2002,2002-12-01,1:02,12:02,@,GNB,13,12,Sun,L 20-30,,5,39,2,33,7,72
6753,CHI,2002,2002-12-09,9:09,9:09,@,MIA,14,13,Mon,L 9-27,,5,55,8,58,13,113
6754,CHI,2002,2002-12-29,8:36,7:36,,TAM,17,16,Sun,L 0-15,,5,45,6,26,11,71
6755,CHI,2003,2003-10-12,1:03,12:03,@,NOR,6,5,Sun,L 13-20,,5,86,6,35,11,121
6756,CHI,2003,2003-11-02,1:05,12:05,,SDG,9,8,Sun,W 20-7,,5,35,4,24,9,59
6757,CHI,2003,2003-11-09,1:03,1:03,@,DET,10,9,Sun,L 10-12,,5,35,7,41,12,76
6758,CHI,2003,2003-12-07,1:02,12:02,@,GNB,14,13,Sun,L 21-34,,5,45,8,57,13,102
6759,CHI,2003,2003-12-21,1:03,12:03,,WAS,16,15,Sun,W 27-24,,5,33,7,50,12,83
6760,CHI,2004,2004-12-19,1:02,12:02,,HOU,15,14,Sun,L 5-24,,5,50,10,89,15,139
6761,CHI,2005,2005-11-13,1:03,12:03,,SFO,10,9,Sun,W 17-9,,5,34,10,80,15,114
6762,CHI,2006,2006-10-01,8:21,7:21,,SEA,4,4,Sun,W 37-6,,5,60,7,59,12,119
6763,CHI,2006,2006-10-29,1:03,12:03,,SFO,8,7,Sun,W 41-10,,5,49,5,38,10,87
6764,CHI,2006,2006-11-26,4:15,4:15,@,NWE,12,11,Sun,L 13-17,,5,31,4,81,9,112
6765,CHI,2007,2007-09-16,4:15,3:15,,KAN,2,2,Sun,W 20-10,,5,55,9,60,14,115
6766,CHI,2007,2007-09-23,8:24,7:24,,DAL,3,3,Sun,L 10-34,,5,28,12,100,17,128
6767,CHI,2007,2007-11-25,4:16,3:16,,DEN,12,11,Sun,W 37-34,OT,5,50,5,28,10,78
6768,CHI,2007,2007-12-30,1:00,12:00,,NOR,17,16,Sun,W 33-25,,5,34,8,72,13,106
6769,CHI,2008,2008-10-19,1:02,12:02,,MIN,7,7,Sun,W 48-41,,5,45,8,50,13,95
6770,CHI,2008,2008-11-30,8:15,7:15,@,MIN,13,12,Sun,L 14-34,,5,50,4,30,9,80
6771,CHI,2009,2009-11-01,1:00,12:00,,CLE,8,7,Sun,W 30-6,,5,35,3,30,8,65
6772,CHI,2009,2010-01-03,1:03,1:03,@,DET,17,16,Sun,W 37-23,,5,35,6,35,11,70
6773,CHI,2010,2010-09-27,8:40,7:40,,GNB,3,3,Mon,W 20-17,,5,38,18,152,23,190
6774,CHI,2010,2010-10-10,1:03,1:03,@,CAR,5,5,Sun,W 23-6,,5,45,7,53,12,98
6775,CHI,2010,2010-11-18,8:29,8:29,@,MIA,11,10,Thu,W 16-0,,5,45,5,45,10,90
6776,CHI,2010,2010-12-20,8:40,7:40,@,MIN,15,14,Mon,W 40-14,,5,72,6,55,11,127
6777,CHI,2011,2011-10-02,1:04,12:04,,CAR,4,4,Sun,W 34-29,,5,45,8,52,13,97
6778,CHI,2011,2011-12-04,1:03,12:03,,KAN,13,12,Sun,L 3-10,,5,35,8,60,13,95
6779,CHI,2011,2011-12-18,1:03,12:03,,SEA,15,14,Sun,L 14-38,,5,45,6,36,11,81
6780,CHI,2012,2012-10-28,1:03,12:03,,CAR,8,7,Sun,W 23-22,,5,40,3,21,8,61
6781,CHI,2012,2012-11-04,1:04,12:04,@,TEN,9,8,Sun,W 51-20,,5,37,9,68,14,105
6782,CHI,2012,2012-11-11,8:31,7:31,,HOU,10,9,Sun,L 6-13,,5,49,3,35,8,84
6783,CHI,2012,2012-11-25,1:00,12:00,,MIN,12,11,Sun,W 28-10,,5,55,3,44,8,99
6784,CHI,2012,2012-12-02,1:03,12:03,,SEA,13,12,Sun,L 17-23,OT,5,45,8,55,13,100
6785,CHI,2013,2013-10-10,8:29,7:29,,NYG,6,6,Thu,W 27-21,,5,51,4,31,9,82
6786,CHI,2013,2013-10-20,1:05,1:05,@,WAS,7,7,Sun,L 41-45,,5,30,5,47,10,77
6787,CHI,2013,2013-11-10,1:03,12:03,,DET,10,9,Sun,L 19-21,,5,39,5,51,10,90
6788,CHI,2013,2013-12-29,4:25,3:25,,GNB,17,16,Sun,L 28-33,,5,40,1,15,6,55
6789,CHI,2014,2014-10-26,1:02,1:02,@,NWE,8,8,Sun,L 23-51,,5,41,7,38,12,79
6790,CHI,2014,2014-11-27,12:39,12:39,@,DET,13,12,Thu,L 17-34,,5,41,5,38,10,79
6791,CHI,2014,2014-12-21,1:03,12:03,,DET,16,15,Sun,L 14-20,,5,86,7,60,12,146
6792,CHI,2016,2016-11-20,1:00,1:00,@,NYG,11,10,Sun,L 16-22,,5,40,4,35,9,75
6793,CHI,2016,2016-12-04,1:00,12:00,,SFO,13,12,Sun,W 26-6,,5,40,11,106,16,146
6794,CHI,2017,2017-10-15,1:00,1:00,@,BAL,6,6,Sun,W 27-24,OT,5,44,8,69,13,113
6795,CHI,2017,2017-10-22,1:00,12:00,,CAR,7,7,Sun,W 17-3,,5,40,4,35,9,75
6796,CHI,2017,2017-11-19,1:00,12:00,,DET,11,10,Sun,L 24-27,,5,64,6,49,11,113
6797,CHI,2018,2018-09-09,8:20,7:20,@,GNB,1,1,Sun,L 23-24,,5,35,8,72,13,107
6798,CHI,2018,2018-10-21,1:00,12:00,,NWE,7,6,Sun,L 31-38,,5,40,7,64,12,104
6799,CHI,2018,2018-11-18,8:20,12:00,,MIN,11,10,Sun,W 25-20,,5,46,4,50,9,96
6800,CHI,2019,2019-10-27,1:00,12:00,,LAC,8,7,Sun,L 16-17,,5,42,8,53,13,95
6801,CHI,2020,2020-09-20,1:00,12:00,,NYG,2,2,Sun,W 17-13,,5,48,3,10,8,58
6802,CHI,2020,2020-11-08,1:00,12:00,@,TEN,9,9,Sun,L 17-24,,5,35,6,57,11,92
6803,CHI,2020,2020-11-29,8:20,7:20,@,GNB,12,11,Sun,L 25-41,,5,45,3,17,8,62
6804,CHI,2021,2021-09-26,1:00,1:00,@,CLE,3,3,Sun,L 6-26,,5,49,7,98,12,147
6805,CHI,2021,2021-11-25,12:30,12:30,@,DET,12,11,Thu,W 16-14,,5,50,10,67,15,117
6806,CHI,2021,2022-01-02,1:00,12:00,,NYG,17,16,Sun,W 29-3,,5,35,3,26,8,61
6807,CIN,2000,2000-12-03,1:02,1:02,,ARI,14,13,Sun,W 24-13,,5,47,6,39,11,86
6808,CIN,2001,2001-10-28,1:00,1:00,@,DET,7,7,Sun,W 31-27,,5,50,9,96,14,146
6809,CIN,2001,2001-11-25,1:03,1:03,@,CLE,11,10,Sun,L 0-18,,5,26,2,25,7,51
6810,CIN,2001,2002-01-06,1:03,12:03,@,TEN,17,16,Sun,W 23-21,,5,90,11,95,16,185
6811,CIN,2002,2002-11-10,1:02,1:02,@,BAL,10,9,Sun,L 27-38,,5,36,1,5,6,41
6812,CIN,2002,2002-12-08,1:02,1:02,@,CAR,14,13,Sun,L 31-52,,5,39,10,91,15,130
6813,CIN,2002,2002-12-15,1:02,1:02,,JAX,15,14,Sun,L 15-29,,5,29,5,54,10,83
6814,CIN,2003,2003-11-02,4:05,2:05,@,ARI,9,8,Sun,L 14-17,,5,43,8,57,13,100
6815,CIN,2003,2003-11-16,1:03,1:03,,KAN,11,10,Sun,W 24-19,,5,33,4,25,9,58
6816,CIN,2003,2003-12-21,1:02,12:02,@,STL,16,15,Sun,L 10-27,,5,38,6,40,11,78
6817,CIN,2004,2004-09-26,1:02,1:02,,BAL,3,3,Sun,L 9-23,,5,25,9,71,14,96
6818,CIN,2004,2004-10-03,1:01,1:01,@,PIT,4,4,Sun,L 17-28,,5,46,7,90,12,136
6819,CIN,2004,2004-11-14,4:06,4:06,@,WAS,10,9,Sun,W 17-10,,5,50,7,50,12,100
6820,CIN,2004,2004-12-05,1:02,1:02,@,BAL,13,12,Sun,W 27-26,,5,45,4,30,9,75
6821,CIN,2005,2005-09-11,1:07,1:07,@,CLE,1,1,Sun,W 27-13,,5,40,7,56,12,96
6822,CIN,2005,2005-11-06,1:02,1:02,@,BAL,9,9,Sun,W 21-9,,5,54,7,40,12,94
6823,CIN,2005,2005-11-27,1:03,1:03,,BAL,12,11,Sun,W 42-29,,5,45,9,91,14,136
6824,CIN,2006,2006-09-10,1:00,12:00,@,KAN,1,1,Sun,W 23-10,,5,40,5,40,10,80
6825,CIN,2006,2006-09-24,1:02,1:02,@,PIT,3,3,Sun,W 28-20,,5,45,2,25,7,70
6826,CIN,2006,2006-10-22,1:03,1:03,,CAR,7,6,Sun,W 17-14,,5,55,8,41,13,96
6827,CIN,2006,2006-11-12,1:03,1:03,,SDG,10,9,Sun,L 41-49,,5,44,4,45,9,89
6828,CIN,2006,2006-11-30,8:04,8:04,,BAL,13,12,Thu,W 13-7,,5,35,9,64,14,99
6829,CIN,2006,2006-12-10,1:03,1:03,,OAK,14,13,Sun,W 27-10,,5,40,6,38,11,78
6830,CIN,2007,2007-09-10,7:10,7:10,,BAL,1,1,Mon,W 27-20,,5,41,10,86,15,127
6831,CIN,2007,2007-11-04,1:02,1:02,@,BUF,9,8,Sun,L 21-33,,5,45,3,25,8,70
6832,CIN,2008,2008-09-07,1:06,1:06,@,BAL,1,1,Sun,L 10-17,,5,40,9,64,14,104
6833,CIN,2008,2008-09-14,1:02,1:02,,TEN,2,2,Sun,L 7-24,,5,35,5,25,10,60
6834,CIN,2008,2008-11-02,1:02,1:02,,JAX,9,9,Sun,W 21-19,,5,39,12,86,17,125
6835,CIN,2011,2011-11-27,1:02,1:02,,CLE,12,11,Sun,W 23-20,,5,35,3,15,8,50
6836,CIN,2012,2012-10-07,1:03,1:03,,MIA,5,5,Sun,L 13-17,,5,46,2,10,7,56
6837,CIN,2012,2012-11-11,1:03,1:03,,NYG,10,9,Sun,W 31-13,,5,40,1,5,6,45
6838,CIN,2013,2013-09-22,1:03,1:03,,GNB,3,3,Sun,W 34-30,,5,43,4,55,9,98
6839,CIN,2014,2014-12-14,1:02,1:02,@,CLE,15,14,Sun,W 30-0,,5,41,9,68,14,109
6840,CIN,2014,2014-12-28,8:30,8:30,@,PIT,17,16,Sun,L 17-27,,5,45,1,10,6,55
6841,CIN,2015,2015-12-06,1:03,1:03,@,CLE,13,12,Sun,W 37-3,,5,55,7,84,12,139
6842,CIN,2016,2016-09-11,1:05,1:05,@,NYJ,1,1,Sun,W 23-22,,5,44,7,95,12,139
6843,CIN,2016,2016-09-18,1:02,1:02,@,PIT,2,2,Sun,L 16-24,,5,31,5,54,10,85
6844,CIN,2017,2017-10-22,4:25,1:00,@,PIT,7,6,Sun,L 14-29,,5,54,1,5,6,59
6845,CIN,2017,2017-10-29,1:00,1:00,,IND,8,7,Sun,W 24-23,,5,54,7,45,12,99
6846,CIN,2017,2017-12-17,1:00,3:00,@,MIN,15,14,Sun,L 7-34,,5,44,11,93,16,137
6847,CIN,2017,2017-12-24,1:00,1:00,,DET,16,15,Sun,W 26-17,,5,60,9,74,14,134
6848,CIN,2019,2019-12-15,1:00,1:00,,NWE,15,14,Sun,L 13-34,,5,25,4,30,9,55
6849,CIN,2020,2020-10-11,1:00,1:00,@,BAL,5,5,Sun,L 3-27,,5,40,4,25,9,65
6850,CIN,2020,2020-12-27,1:00,12:00,@,HOU,16,15,Sun,W 37-31,,5,35,6,46,11,81
6851,CIN,2021,2021-10-31,1:00,1:00,@,NYJ,8,8,Sun,L 31-34,,5,51,8,46,13,97
6852,CIN,2021,2021-12-26,1:00,1:00,,BAL,16,15,Sun,W 41-21,,5,45,6,27,11,72
6853,CIN,2021,2022-01-02,1:00,1:00,,KAN,17,16,Sun,W 34-31,,5,62,10,83,15,145
6854,CLE,2001,2001-09-30,4:15,4:15,@,JAX,3,3,Sun,W 23-14,,5,47,8,63,13,110
6855,CLE,2001,2001-11-11,1:03,1:03,,PIT,9,8,Sun,L 12-15,OT,5,45,2,30,7,75
6856,CLE,2001,2001-12-16,1:03,1:03,,JAX,14,13,Sun,L 10-15,,5,72,9,85,14,157
6857,CLE,2003,2003-10-26,1:02,1:02,@,NWE,8,8,Sun,L 3-9,,5,25,3,30,8,55
6858,CLE,2003,2003-11-23,1:02,1:02,,PIT,12,11,Sun,L 6-13,,5,32,10,55,15,87
6859,CLE,2003,2003-12-21,1:03,1:03,,BAL,16,15,Sun,L 0-35,,5,26,5,41,10,67
6860,CLE,2004,2004-12-26,8:37,8:37,@,MIA,16,15,Sun,L 7-10,,5,25,7,35,12,60
6861,CLE,2005,2005-10-09,1:03,1:03,,CHI,5,4,Sun,W 20-10,,5,55,7,57,12,112
6862,CLE,2005,2005-11-20,1:03,1:03,,MIA,11,10,Sun,W 22-0,,5,35,7,43,12,78
6863,CLE,2006,2006-12-07,8:04,8:04,@,PIT,14,13,Thu,L 7-27,,5,60,4,25,9,85
6864,CLE,2006,2006-12-31,1:02,12:02,@,HOU,17,16,Sun,L 6-14,,5,57,4,31,9,88
6865,CLE,2007,2007-10-14,1:03,1:03,,MIA,6,6,Sun,W 41-31,,5,32,8,90,13,122
6866,CLE,2008,2008-11-23,1:03,1:03,,HOU,12,11,Sun,L 6-16,,5,40,11,84,16,124
6867,CLE,2009,2009-09-27,1:02,1:02,@,BAL,3,3,Sun,L 3-34,,5,46,8,84,13,130
6868,CLE,2009,2009-10-04,1:03,1:03,,CIN,4,4,Sun,L 20-23,OT,5,44,6,46,11,90
6869,CLE,2009,2009-10-25,1:02,1:02,,GNB,7,7,Sun,L 3-31,,5,40,8,70,13,110
6870,CLE,2010,2010-09-12,1:02,1:02,@,TAM,1,1,Sun,L 14-17,,5,47,6,55,11,102
6871,CLE,2010,2010-11-21,1:03,1:03,@,JAX,11,10,Sun,L 20-24,,5,45,2,10,7,55
6872,CLE,2010,2010-11-28,1:03,1:03,,CAR,12,11,Sun,W 24-23,,5,46,8,68,13,114
6873,CLE,2011,2011-10-02,1:03,1:03,,TEN,4,4,Sun,L 13-31,,5,40,5,45,10,85
6874,CLE,2011,2011-10-16,4:05,1:05,@,OAK,6,5,Sun,L 17-24,,5,34,5,35,10,69
6875,CLE,2011,2011-10-30,4:15,1:15,@,SFO,8,7,Sun,L 10-20,,5,39,5,40,10,79
6876,CLE,2011,2012-01-01,4:16,4:16,,PIT,17,16,Sun,L 9-13,,5,40,4,37,9,77
6877,CLE,2012,2012-10-14,1:02,1:02,,CIN,6,6,Sun,W 34-24,,5,35,7,50,12,85
6878,CLE,2012,2012-12-16,1:03,1:03,,WAS,15,14,Sun,L 21-38,,5,30,6,45,11,75
6879,CLE,2013,2013-09-15,1:02,1:02,@,BAL,2,2,Sun,L 6-14,,5,33,3,41,8,74
6880,CLE,2013,2013-09-22,1:05,12:05,@,MIN,3,3,Sun,W 31-27,,5,47,4,35,9,82
6881,CLE,2013,2013-09-29,1:06,1:06,,CIN,4,4,Sun,W 17-6,,5,80,3,25,8,105
6882,CLE,2013,2013-11-17,1:02,1:02,@,CIN,11,10,Sun,L 20-41,,5,40,8,64,13,104
6883,CLE,2014,2014-11-23,1:02,1:02,@,ATL,12,11,Sun,W 26-24,,5,30,7,40,12,70
6884,CLE,2016,2016-10-09,1:02,1:02,,NWE,5,5,Sun,L 13-33,,5,35,5,61,10,96
6885,CLE,2016,2016-10-23,1:02,1:02,@,CIN,7,7,Sun,L 17-31,,5,35,3,30,8,65
6886,CLE,2016,2016-11-06,1:00,1:00,,DAL,9,9,Sun,L 10-35,,5,33,4,38,9,71
6887,CLE,2016,2016-11-27,1:00,1:00,,NYG,12,12,Sun,L 13-27,,5,35,9,100,14,135
6888,CLE,2016,2016-12-11,1:00,1:00,,CIN,14,13,Sun,L 10-23,,5,34,6,43,11,77
6889,CLE,2016,2017-01-01,1:00,1:00,@,PIT,17,16,Sun,L 24-27,OT,5,37,9,43,14,80
6890,CLE,2017,2017-10-29,9:30,2:30,,MIN,8,8,Sun,L 16-33,,5,74,5,58,10,132
6891,CLE,2018,2018-09-20,8:20,8:20,,NYJ,3,3,Thu,W 21-17,,5,41,6,55,11,96
6892,CLE,2019,2019-11-03,4:25,2:25,@,DEN,9,8,Sun,L 19-24,,5,40,7,55,12,95
6893,CLE,2019,2019-12-01,1:00,1:00,@,PIT,13,12,Sun,L 13-20,,5,34,10,65,15,99
6894,CLE,2020,2020-10-04,1:00,12:00,@,DAL,4,4,Sun,W 49-38,,5,40,6,65,11,105
6895,CLE,2020,2020-10-25,1:00,1:00,@,CIN,7,7,Sun,W 37-34,,5,40,7,45,12,85
6896,CLE,2021,2021-09-12,4:25,3:25,@,KAN,1,1,Sun,L 29-33,,5,30,5,36,10,66
6897,CLE,2021,2021-09-19,1:00,1:00,,HOU,2,2,Sun,W 31-21,,5,62,9,78,14,140
6898,CLE,2021,2021-10-31,1:00,1:00,,PIT,8,8,Sun,L 10-15,,5,30,8,65,13,95
6899,CLE,2021,2021-11-28,8:20,8:20,@,BAL,12,12,Sun,L 10-16,,5,45,5,54,10,99
6900,IND,2000,2000-10-08,1:02,1:02,@,NWE,6,5,Sun,L 16-24,,5,52,7,34,12,86
6901,IND,2000,2000-11-19,1:02,12:02,@,GNB,12,11,Sun,L 24-26,,5,69,7,46,12,115
6902,IND,2001,2001-09-30,1:03,1:03,@,NWE,3,3,Sun,L 13-44,,5,60,7,65,12,125
6903,IND,2001,2001-11-11,1:00,1:00,,MIA,9,8,Sun,L 24-27,,5,25,9,65,14,90
6904,IND,2001,2001-12-16,1:00,1:00,,ATL,14,13,Sun,W 41-27,,5,63,7,83,12,146
6905,IND,2002,2002-09-15,1:00,12:00,,MIA,2,2,Sun,L 13-21,,5,35,11,68,16,103
6906,IND,2002,2002-10-06,12:00,12:00,,CIN,5,4,Sun,W 28-21,,5,71,6,63,11,134
6907,IND,2002,2002-12-15,1:02,1:02,@,CLE,15,14,Sun,W 28-23,,5,44,7,39,12,83
6908,IND,2003,2003-11-02,1:04,1:04,@,MIA,9,8,Sun,W 23-17,,5,35,5,44,10,79
6909,IND,2004,2004-11-25,12:38,12:38,@,DET,12,11,Thu,W 41-9,,5,40,10,60,15,100
6910,IND,2004,2004-12-19,8:36,8:36,,BAL,15,14,Sun,W 20-10,,5,28,7,35,12,63
6911,IND,2005,2005-12-04,1:02,1:02,,TEN,13,12,Sun,W 35-3,,5,33,7,35,12,68
6912,IND,2005,2005-12-11,1:01,1:01,@,JAX,14,13,Sun,W 26-18,,5,47,7,65,12,112
6913,IND,2006,2006-10-08,1:02,1:02,,TEN,5,5,Sun,W 14-13,,5,45,6,36,11,81
6914,IND,2006,2006-10-29,4:15,2:15,@,DEN,8,7,Sun,W 34-31,,5,55,3,24,8,79
6915,IND,2006,2006-11-19,4:15,3:15,@,DAL,11,10,Sun,L 14-21,,5,35,7,53,12,88
6916,IND,2006,2006-12-18,8:40,8:40,,CIN,15,14,Mon,W 34-16,,5,35,2,10,7,45
6917,IND,2006,2006-12-31,4:15,4:15,,MIA,17,16,Sun,W 27-22,,5,45,3,20,8,65
6918,IND,2007,2007-09-16,1:02,12:02,@,TEN,2,2,Sun,W 22-20,,5,44,4,40,9,84
6919,IND,2007,2007-09-23,1:03,12:03,@,HOU,3,3,Sun,W 30-24,,5,30,2,15,7,45
6920,IND,2007,2007-10-28,1:02,1:02,@,CAR,8,7,Sun,W 31-7,,5,27,8,55,13,82
6921,IND,2007,2007-12-23,1:02,1:02,,HOU,16,15,Sun,W 38-15,,5,40,6,55,11,95
6922,IND,2007,2007-12-30,8:24,8:24,,TEN,17,16,Sun,L 10-16,,5,54,6,40,11,94
6923,IND,2008,2008-09-14,1:05,12:05,@,MIN,2,2,Sun,W 18-15,,5,45,2,5,7,50
6924,IND,2008,2008-10-27,8:39,7:39,@,TEN,8,7,Mon,L 21-31,,5,35,4,40,9,75
6925,IND,2008,2008-12-14,1:02,1:02,,DET,15,14,Sun,W 31-21,,5,31,6,48,11,79
6926,IND,2009,2009-11-01,1:03,1:03,,SFO,8,7,Sun,W 18-14,,5,38,7,50,12,88
6927,IND,2009,2009-11-22,1:02,1:02,@,BAL,11,10,Sun,W 17-15,,5,40,2,20,7,60
6928,IND,2009,2009-12-06,1:03,1:03,,TEN,13,12,Sun,W 27-17,,5,40,4,50,9,90
6929,IND,2009,2009-12-17,8:21,8:21,@,JAX,15,14,Thu,W 35-31,,5,40,4,22,9,62
6930,IND,2010,2010-09-12,1:02,12:02,@,HOU,1,1,Sun,L 24-34,,5,73,7,50,12,123
6931,IND,2010,2010-10-10,1:03,1:03,,KAN,5,5,Sun,W 19-9,,5,45,4,38,9,83
6932,IND,2010,2010-11-14,1:02,1:02,,CIN,10,9,Sun,W 23-17,,5,45,4,38,9,83
6933,IND,2010,2011-01-02,4:16,4:16,,TEN,17,16,Sun,W 23-20,,5,25,7,58,12,83
6934,IND,2011,2011-12-04,1:02,1:02,@,NWE,13,12,Sun,L 24-31,,5,29,3,20,8,49
6935,IND,2012,2012-10-28,1:06,12:06,@,TEN,8,7,Sun,W 19-13,OT,5,45,8,65,13,110
6936,IND,2013,2013-10-14,8:40,5:40,@,SDG,6,6,Mon,L 9-19,,5,28,5,25,10,53
6937,IND,2013,2013-11-14,8:29,7:29,@,TEN,11,10,Thu,W 30-27,,5,51,4,34,9,85
6938,IND,2014,2014-10-09,8:26,7:26,@,HOU,6,6,Thu,W 33-28,,5,51,5,66,10,117
6939,IND,2014,2014-10-26,4:25,4:25,@,PIT,8,8,Sun,L 34-51,,5,43,10,59,15,102
6940,IND,2015,2015-09-13,1:03,1:03,@,BUF,1,1,Sun,L 14-27,,5,49,11,113,16,162
6941,IND,2015,2015-12-06,8:30,8:30,@,PIT,13,12,Sun,L 10-45,,5,30,4,48,9,78
6942,IND,2016,2016-09-11,4:27,4:27,,DET,1,1,Sun,L 35-39,,5,45,8,70,13,115
6943,IND,2016,2016-10-30,1:02,1:02,,KAN,8,8,Sun,L 14-30,,5,45,6,40,11,85
6944,IND,2016,2016-12-18,1:00,3:00,@,MIN,15,14,Sun,W 34-6,,5,55,6,27,11,82
6945,IND,2017,2017-10-01,8:30,5:30,@,SEA,4,4,Sun,L 18-46,,5,31,6,45,11,76
6946,IND,2017,2017-10-16,8:30,7:30,@,TEN,6,6,Mon,L 22-36,,5,51,4,45,9,96
6947,IND,2017,2017-10-22,1:00,1:00,,JAX,7,7,Sun,L 0-27,,5,55,4,34,9,89
6948,IND,2019,2019-09-29,1:00,1:00,,OAK,4,4,Sun,L 24-31,,5,35,11,80,16,115
6949,IND,2020,2020-09-13,1:00,1:00,@,JAX,1,1,Sun,L 20-27,,5,80,6,61,11,141
6950,IND,2020,2020-10-11,4:25,4:25,@,CLE,5,5,Sun,L 23-32,,5,34,2,10,7,44
6951,IND,2021,2021-10-11,8:15,8:15,@,BAL,5,5,Mon,L 25-31,OT,5,45,8,74,13,119
6952,IND,2021,2021-12-05,1:00,12:00,@,HOU,13,13,Sun,W 31-0,,5,25,4,25,9,50
6953,IND,2021,2021-12-25,8:15,6:15,@,ARI,16,15,Sat,W 22-16,,5,40,11,85,16,125
6954,ARI,2000,2000-09-24,4:06,1:06,,GNB,4,3,Sun,L 3-29,,5,45,6,53,11,98
6955,ARI,2001,2001-10-07,1:09,1:09,@,PHI,4,3,Sun,W 21-20,,5,40,8,58,13,98
6956,ARI,2001,2001-10-28,3:05,3:05,@,DAL,7,6,Sun,L 3-17,,5,72,5,37,10,109
6957,ARI,2001,2001-11-18,4:15,2:15,,DET,10,9,Sun,W 45-38,,5,59,6,69,11,128
6958,ARI,2001,2001-12-15,1:37,1:37,@,NYG,14,13,Sat,L 13-17,,5,40,2,10,7,50
6959,ARI,2001,2001-12-23,4:06,2:06,,DAL,15,14,Sun,W 17-10,,5,27,9,65,14,92
6960,ARI,2001,2001-12-30,1:02,1:02,@,CAR,16,15,Sun,W 30-7,,5,30,7,81,12,111
6961,ARI,2002,2002-09-29,4:04,1:04,,NYG,4,4,Sun,W 21-7,,5,35,10,110,15,145
6962,ARI,2002,2002-11-24,4:05,2:05,,OAK,12,11,Sun,L 20-41,,5,35,13,105,18,140
6963,ARI,2003,2003-10-05,1:02,12:02,@,DAL,5,5,Sun,L 7-24,,5,36,7,64,12,100
6964,ARI,2003,2003-10-12,4:16,1:16,,BAL,6,6,Sun,L 18-26,,5,35,6,55,11,90
6965,ARI,2003,2003-12-14,4:16,2:16,,CAR,15,14,Sun,L 17-20,,5,50,4,35,9,85
6966,ARI,2006,2006-09-24,4:15,1:15,,STL,3,3,Sun,L 14-16,,5,52,5,25,10,77
6967,ARI,2006,2006-11-12,4:16,2:16,,DAL,10,9,Sun,L 10-27,,5,35,8,69,13,104
6968,ARI,2006,2006-12-24,4:05,1:05,@,SFO,16,15,Sun,W 26-20,,5,45,3,35,8,80
6969,ARI,2007,2007-09-30,4:15,1:15,,PIT,4,4,Sun,W 21-14,,5,30,11,72,16,102
6970,ARI,2008,2008-12-07,4:15,2:15,,STL,14,13,Sun,W 34-10,,5,30,1,5,6,35
6971,ARI,2008,2008-12-14,4:05,2:05,,MIN,15,14,Sun,L 14-35,,5,60,6,34,11,94
6972,ARI,2009,2009-09-27,8:31,5:31,,IND,3,3,Sun,L 10-31,,5,35,7,69,12,104
6973,ARI,2009,2009-11-01,4:15,2:15,,CAR,8,7,Sun,L 21-34,,5,35,7,72,12,107
6974,ARI,2010,2010-10-03,4:15,1:15,@,SDG,4,4,Sun,L 10-41,,5,34,5,44,10,78
6975,ARI,2010,2010-10-24,4:06,1:06,@,SEA,7,6,Sun,L 10-22,,5,32,10,95,15,127
6976,ARI,2012,2012-09-16,1:02,1:02,@,NWE,2,2,Sun,W 20-18,,5,39,8,60,13,99
6977,ARI,2012,2012-09-23,4:05,1:05,,PHI,3,3,Sun,W 27-6,,5,45,5,65,10,110
6978,ARI,2012,2012-10-04,8:20,7:20,@,STL,5,5,Thu,L 3-17,,5,35,7,60,12,95
6979,ARI,2012,2012-11-18,1:03,1:03,@,ATL,11,10,Sun,L 19-23,,5,43,5,35,10,78
6980,ARI,2012,2012-12-30,4:25,1:25,@,SFO,17,16,Sun,L 13-27,,5,34,3,25,8,59
6981,ARI,2013,2013-11-10,4:25,2:25,,HOU,10,9,Sun,W 27-24,,5,29,7,53,12,82
6982,ARI,2013,2013-11-17,1:04,1:04,@,JAX,11,10,Sun,W 27-14,,5,42,6,40,11,82
6983,ARI,2014,2014-09-08,9:20,7:20,,SDG,1,1,Mon,W 18-17,,5,23,6,47,11,70
6984,ARI,2014,2014-09-21,4:05,1:05,,SFO,3,3,Sun,W 23-14,,5,36,9,107,14,143
6985,ARI,2014,2014-11-09,4:25,2:25,,STL,10,9,Sun,W 31-14,,5,35,8,80,13,115
6986,ARI,2014,2014-11-30,4:05,4:05,@,ATL,13,12,Sun,L 18-29,,5,34,9,76,14,110
6987,ARI,2015,2015-09-13,4:05,1:05,,NOR,1,1,Sun,W 31-19,,5,30,7,73,12,103
6988,ARI,2015,2015-11-01,1:02,1:02,@,CLE,8,8,Sun,W 34-20,,5,25,7,35,12,60
6989,ARI,2017,2017-12-10,4:05,2:05,,TEN,14,13,Sun,W 12-7,,5,30,6,48,11,78
6990,ARI,2018,2018-09-30,4:05,2:05,,SEA,4,4,Sun,L 17-20,,5,38,8,57,13,95
6991,ARI,2018,2018-10-07,4:25,1:25,@,SFO,5,5,Sun,W 28-18,,5,46,9,65,14,111
6992,ARI,2018,2018-10-14,1:00,3:00,@,MIN,6,6,Sun,L 17-27,,5,30,9,52,14,82
6993,ARI,2019,2019-10-27,1:00,12:00,@,NOR,8,8,Sun,L 9-31,,5,35,2,15,7,50
6994,ARI,2019,2019-12-15,4:05,2:05,,CLE,15,14,Sun,W 38-24,,5,34,6,55,11,89
6995,ARI,2019,2019-12-22,4:25,1:25,@,SEA,16,15,Sun,W 27-13,,5,47,7,55,12,102
6996,ARI,2020,2020-10-04,1:00,1:00,@,CAR,4,4,Sun,L 21-31,,5,29,10,72,15,101
6997,ARI,2020,2020-12-06,4:05,2:05,,LAR,13,12,Sun,L 28-38,,5,21,6,75,11,96
6998,ARI,2021,2021-09-19,4:05,2:05,,MIN,2,2,Sun,W 34-33,,5,40,3,16,8,56
6999,ARI,2021,2021-10-17,4:05,4:05,@,CLE,6,6,Sun,W 37-14,,5,45,9,88,14,133
7000,DAL,2000,2000-09-10,8:35,5:35,@,ARI,2,2,Sun,L 31-32,,5,102,2,15,7,117
7001,DAL,2000,2000-09-24,1:05,12:05,,SFO,4,4,Sun,L 24-41,,5,62,8,94,13,156
7002,DAL,2000,2000-10-22,1:00,12:00,,ARI,8,7,Sun,W 48-7,,5,30,11,59,16,89
7003,DAL,2000,2000-11-23,4:08,3:08,,MIN,13,12,Thu,L 15-27,,5,45,4,21,9,66
7004,DAL,2001,2001-10-28,3:05,3:05,,ARI,7,6,Sun,W 17-3,,5,37,5,72,10,109
7005,DAL,2001,2001-11-04,1:04,1:04,@,NYG,8,7,Sun,L 24-27,OT,5,40,4,43,9,83
7006,DAL,2001,2001-11-22,4:15,3:15,,DEN,11,10,Thu,L 24-26,,5,34,6,65,11,99
7007,DAL,2001,2001-12-30,1:03,12:03,,SFO,16,15,Sun,W 27-21,,5,27,2,10,7,37
7008,DAL,2002,2002-10-06,1:03,12:03,,NYG,5,5,Sun,L 17-21,,5,37,6,48,11,85
7009,DAL,2002,2002-10-27,1:04,12:04,,SEA,8,8,Sun,L 14-17,,5,55,6,57,11,112
7010,DAL,2003,2003-09-28,4:15,4:15,@,NYJ,4,3,Sun,W 17-6,,5,38,4,40,9,78
7011,DAL,2003,2003-10-12,1:03,12:03,,PHI,6,5,Sun,W 23-21,,5,23,2,10,7,33
7012,DAL,2003,2003-11-02,4:15,3:15,,WAS,9,8,Sun,W 21-14,,5,30,8,57,13,87
7013,DAL,2003,2003-11-09,4:15,3:15,,BUF,10,9,Sun,W 10-6,,5,53,1,15,6,68
7014,DAL,2003,2003-11-27,4:16,3:16,,MIA,13,12,Thu,L 21-40,,5,50,6,69,11,119
7015,DAL,2004,2004-09-27,9:10,9:10,@,WAS,3,3,Mon,W 21-18,,5,40,7,87,12,127
7016,DAL,2004,2004-10-17,4:15,3:15,,PIT,6,5,Sun,L 20-24,,5,30,6,45,11,75
7017,DAL,2004,2004-10-31,1:03,12:03,,DET,8,7,Sun,W 31-21,,5,35,10,112,15,147
7018,DAL,2004,2004-11-25,4:36,3:36,,CHI,12,11,Thu,W 21-7,,5,30,7,45,12,75
7019,DAL,2005,2005-10-09,4:15,3:15,,PHI,5,5,Sun,W 33-10,,5,48,8,54,13,102
7020,DAL,2005,2005-11-20,1:02,12:02,,DET,11,10,Sun,W 20-7,,5,40,17,129,22,169
7021,DAL,2005,2005-12-11,4:15,3:15,,KAN,14,13,Sun,W 31-28,,5,45,3,17,8,62
7022,DAL,2005,2005-12-24,1:03,1:03,@,CAR,16,15,Sat,W 24-20,,5,44,6,49,11,93
7023,DAL,2006,2006-10-01,1:04,12:04,@,TEN,4,3,Sun,W 45-14,,5,61,5,55,10,116
7024,DAL,2007,2007-10-08,8:40,8:40,@,BUF,5,5,Mon,W 25-24,,5,31,5,49,10,80
7025,DAL,2007,2007-12-22,8:15,8:15,@,CAR,16,15,Sat,W 20-13,,5,39,3,15,8,54
7026,DAL,2007,2007-12-30,4:15,4:15,@,WAS,17,16,Sun,L 6-27,,5,37,5,37,10,74
7027,DAL,2008,2008-10-26,1:02,12:02,,TAM,8,8,Sun,W 13-9,,5,35,7,58,12,93
7028,DAL,2008,2008-11-16,8:23,8:23,@,WAS,11,10,Sun,W 14-10,,5,40,2,10,7,50
7029,DAL,2008,2008-11-27,4:29,3:29,,SEA,13,12,Thu,W 34-9,,5,38,5,46,10,84
7030,DAL,2008,2008-12-07,4:16,4:16,@,PIT,14,13,Sun,L 13-20,,5,24,2,10,7,34
7031,DAL,2008,2008-12-28,4:15,4:15,@,PHI,17,16,Sun,L 6-44,,5,46,0,0,5,46
7032,DAL,2009,2009-11-01,1:03,12:03,,SEA,8,7,Sun,W 38-17,,5,43,6,53,11,96
7033,DAL,2009,2009-12-06,4:15,4:15,@,NYG,13,12,Sun,L 24-31,,5,30,2,10,7,40
7034,DAL,2010,2010-10-25,8:41,7:41,,NYG,7,6,Mon,L 35-41,,5,42,6,46,11,88
7035,DAL,2010,2010-11-07,8:30,7:30,@,GNB,9,8,Sun,L 7-45,,5,40,2,20,7,60
7036,DAL,2010,2010-11-14,4:15,4:15,@,NYG,10,9,Sun,W 33-20,,5,60,8,69,13,129
7037,DAL,2010,2010-12-05,4:15,4:15,@,IND,13,12,Sun,W 38-35,OT,5,35,3,28,8,63
7038,DAL,2010,2010-12-12,8:30,7:30,,PHI,14,13,Sun,L 27-30,,5,40,6,59,11,99
7039,DAL,2012,2012-09-16,4:06,1:06,@,SEA,2,2,Sun,L 7-27,,5,47,5,35,10,82
7040,DAL,2012,2012-12-23,1:02,12:02,,NOR,16,15,Sun,L 31-34,OT,5,32,6,42,11,74
7041,DAL,2013,2013-09-08,8:30,7:30,,NYG,1,1,Sun,W 36-31,,5,40,6,52,11,92
7042,DAL,2013,2013-09-15,1:02,12:02,@,KAN,2,2,Sun,L 16-17,,5,27,10,45,15,72
7043,DAL,2013,2013-09-29,4:25,1:25,@,SDG,4,4,Sun,L 21-30,,5,33,7,85,12,118
7044,DAL,2013,2013-11-03,1:03,12:03,,MIN,9,9,Sun,W 27-23,,5,45,4,35,9,80
7045,DAL,2014,2014-11-02,1:04,12:04,,ARI,9,9,Sun,L 17-28,,5,33,6,62,11,95
7046,DAL,2015,2015-09-27,1:03,12:03,,ATL,3,3,Sun,L 28-39,,5,31,6,70,11,101
7047,DAL,2015,2015-11-01,4:25,3:25,,SEA,8,7,Sun,L 12-13,,5,40,5,40,10,80
7048,DAL,2015,2015-11-26,4:31,3:31,,CAR,12,11,Thu,L 14-33,,5,40,8,53,13,93
7049,DAL,2016,2016-11-20,1:00,12:00,,BAL,11,10,Sun,W 27-17,,5,45,12,136,17,181
7050,DAL,2016,2016-12-11,8:30,8:30,@,NYG,14,13,Sun,L 7-10,,5,54,7,50,12,104
7051,DAL,2016,2017-01-01,1:00,1:00,@,PHI,17,16,Sun,L 13-27,,5,35,4,61,9,96
7052,DAL,2017,2017-09-10,8:30,7:30,,NYG,1,1,Sun,W 19-3,,5,50,6,55,11,105
7053,DAL,2017,2017-10-22,4:05,1:05,@,SFO,7,6,Sun,W 40-10,,5,36,2,22,7,58
7054,DAL,2017,2017-11-05,4:25,3:25,,KAN,9,8,Sun,W 28-17,,5,65,8,52,13,117
7055,DAL,2017,2017-11-12,4:25,4:25,@,ATL,10,9,Sun,L 7-27,,5,54,5,35,10,89
7056,DAL,2018,2018-11-11,8:20,8:20,@,PHI,10,9,Sun,W 27-20,,5,37,0,0,5,37
7057,DAL,2019,2019-11-10,8:20,7:20,,MIN,10,9,Sun,L 24-28,,5,39,5,35,10,74
7058,DAL,2019,2019-11-28,4:30,3:30,,BUF,13,12,Thu,L 15-26,,5,66,7,53,12,119
7059,DAL,2020,2020-11-26,4:30,3:30,,WAS,12,11,Thu,L 16-41,,5,45,5,53,10,98
7060,DAL,2020,2020-12-13,1:00,1:00,@,CIN,14,13,Sun,W 30-7,,5,30,3,25,8,55
7061,DAL,2020,2020-12-20,1:00,12:00,,SFO,15,14,Sun,W 41-33,,5,58,4,39,9,97
7062,DAL,2020,2020-12-27,4:25,3:25,,PHI,16,15,Sun,W 37-17,,5,73,12,115,17,188
7063,DAL,2021,2021-11-07,1:00,12:00,,DEN,9,8,Sun,L 16-30,,5,38,5,37,10,75
7064,DAL,2021,2021-12-02,8:20,7:20,@,NOR,13,12,Thu,W 27-17,,5,35,7,59,12,94
7065,DAL,2021,2022-01-08,8:15,8:15,@,PHI,18,17,Sat,W 51-26,,5,44,3,30,8,74
7066,DEN,2000,2000-09-04,9:07,8:07,@,STL,1,1,Mon,L 36-41,,5,27,5,56,10,83
7067,DEN,2000,2000-11-13,9:09,7:09,,OAK,11,10,Mon,W 27-24,,5,45,9,54,14,99
7068,DEN,2000,2000-11-26,4:16,1:16,@,SEA,13,12,Sun,W 38-31,,5,53,5,43,10,96
7069,DEN,2001,2001-12-02,1:02,1:02,@,MIA,12,12,Sun,L 10-21,,5,39,7,70,12,109
7070,DEN,2002,2002-12-08,4:16,4:16,@,NYJ,14,13,Sun,L 13-19,,5,55,1,15,6,70
7071,DEN,2003,2003-09-07,1:06,1:06,@,CIN,1,1,Sun,W 30-10,,5,58,4,25,9,83
7072,DEN,2003,2003-10-19,1:00,12:00,@,MIN,7,7,Sun,L 20-28,,5,40,14,108,19,148
7073,DEN,2004,2004-11-28,8:36,6:36,,OAK,12,11,Sun,L 24-25,,5,31,5,38,10,69
7074,DEN,2004,2004-12-12,4:05,2:05,,MIA,14,13,Sun,W 20-17,,5,43,4,40,9,83
7075,DEN,2005,2005-09-18,4:15,2:15,,SDG,2,2,Sun,W 20-17,,5,45,7,42,12,87
7076,DEN,2005,2005-10-02,1:02,1:02,@,JAX,4,4,Sun,W 20-7,,5,30,15,119,20,149
7077,DEN,2005,2005-12-24,4:15,2:15,,OAK,16,15,Sat,W 22-3,,5,25,6,41,11,66
7078,DEN,2006,2006-10-15,8:21,6:21,,OAK,6,5,Sun,W 13-3,,5,39,13,95,18,134
7079,DEN,2007,2007-11-19,8:40,6:40,,TEN,11,10,Mon,W 34-20,,5,35,6,80,11,115
7080,DEN,2007,2007-11-25,4:16,3:16,@,CHI,12,11,Sun,L 34-37,OT,5,28,5,50,10,78
7081,DEN,2007,2007-12-02,4:05,1:05,@,OAK,13,12,Sun,L 20-34,,5,25,3,20,8,45
7082,DEN,2007,2007-12-13,8:15,7:15,@,HOU,15,14,Thu,L 13-31,,5,25,3,15,8,40
7083,DEN,2007,2007-12-30,4:16,2:16,,MIN,17,16,Sun,W 22-19,OT,5,40,4,30,9,70
7084,DEN,2009,2009-09-20,4:15,2:15,,CLE,2,2,Sun,W 27-6,,5,50,4,43,9,93
7085,DEN,2009,2009-09-27,4:15,1:15,@,OAK,3,3,Sun,W 23-3,,5,30,6,53,11,83
7086,DEN,2009,2010-01-03,4:15,2:15,,KAN,17,16,Sun,L 24-44,,5,54,5,76,10,130
7087,DEN,2010,2010-10-17,4:05,2:05,,NYJ,6,6,Sun,L 20-24,,5,81,6,74,11,155
7088,DEN,2010,2010-10-24,4:15,2:15,,OAK,7,7,Sun,L 14-59,,5,64,10,94,15,158
7089,DEN,2010,2011-01-02,4:15,2:15,,SDG,17,16,Sun,L 28-33,,5,45,3,32,8,77
7090,DEN,2011,2011-10-23,1:02,1:02,@,MIA,7,6,Sun,W 18-15,OT,5,30,2,20,7,50
7091,DEN,2011,2011-10-30,4:10,2:10,,DET,8,7,Sun,L 10-45,,5,55,4,45,9,100
7092,DEN,2012,2012-10-28,8:30,6:30,,NOR,8,7,Sun,W 34-14,,5,34,3,15,8,49
7093,DEN,2012,2012-11-04,1:02,1:02,@,CIN,9,8,Sun,W 31-23,,5,29,8,83,13,112
7094,DEN,2012,2012-12-30,4:25,2:25,,KAN,17,16,Sun,W 38-3,,5,30,5,32,10,62
7095,DEN,2013,2013-09-23,8:40,6:40,,OAK,3,3,Mon,W 37-21,,5,40,8,77,13,117
7096,DEN,2013,2013-10-06,4:25,3:25,@,DAL,5,5,Sun,W 51-48,,5,55,9,81,14,136
7097,DEN,2014,2014-11-30,8:32,7:32,@,KAN,13,12,Sun,W 29-16,,5,32,5,35,10,67
7098,DEN,2014,2014-12-07,4:05,2:05,,BUF,14,13,Sun,W 24-17,,5,45,11,98,16,143
7099,DEN,2015,2015-11-15,4:30,2:30,,KAN,10,9,Sun,L 13-29,,5,55,11,102,16,157
7100,DEN,2015,2015-12-28,8:30,6:30,,CIN,16,15,Mon,W 20-17,OT,5,40,6,45,11,85
7101,DEN,2016,2016-09-25,1:02,1:02,@,CIN,3,3,Sun,W 29-17,,5,41,9,69,14,110
7102,DEN,2016,2016-12-18,4:25,2:25,,NWE,15,14,Sun,L 3-16,,5,49,4,30,9,79
7103,DEN,2016,2017-01-01,4:25,2:25,,OAK,17,16,Sun,W 24-6,,5,43,13,125,18,168
7104,DEN,2017,2017-10-15,8:30,6:30,,NYG,6,5,Sun,L 10-23,,5,46,5,77,10,123
7105,DEN,2017,2017-11-12,8:30,6:30,,NWE,10,9,Sun,L 16-41,,5,28,1,5,6,33
7106,DEN,2017,2017-11-19,4:25,2:25,,CIN,11,10,Sun,L 17-20,,5,50,3,14,8,64
7107,DEN,2018,2018-10-18,8:20,6:20,@,ARI,7,7,Thu,W 45-10,,5,50,7,45,12,95
7108,DEN,2019,2019-09-29,4:25,2:25,,JAX,4,4,Sun,L 24-26,,5,48,12,104,17,152
7109,DEN,2020,2020-09-14,10:10,8:10,,TEN,1,1,Mon,L 14-16,,5,56,5,37,10,93
7110,DEN,2020,2020-10-25,4:25,2:25,,KAN,7,6,Sun,L 16-43,,5,34,1,15,6,49
7111,DEN,2020,2020-11-08,1:00,1:00,@,ATL,9,8,Sun,L 27-34,,5,65,5,61,10,126
7112,DEN,2021,2021-09-12,4:25,4:25,@,NYG,1,1,Sun,W 27-13,,5,51,4,48,9,99
7113,DEN,2021,2021-11-07,1:00,12:00,@,DAL,9,9,Sun,W 30-16,,5,37,5,38,10,75
7114,DEN,2021,2021-11-28,4:05,2:05,,LAC,12,11,Sun,W 28-13,,5,35,9,75,14,110
7115,DEN,2021,2021-12-05,8:20,7:20,@,KAN,13,12,Sun,L 9-22,,5,37,7,60,12,97
7116,DET,2000,2000-11-05,1:01,1:01,,MIA,10,9,Sun,L 8-23,,5,40,7,62,12,102
7117,DET,2000,2000-11-30,8:35,7:35,@,MIN,14,13,Thu,L 17-24,,5,35,6,59,11,94
7118,DET,2001,2001-12-30,1:03,1:03,,CHI,16,15,Sun,L 0-24,,5,50,7,68,12,118
7119,DET,2002,2002-09-29,1:03,1:03,,NOR,4,4,Sun,W 26-21,,5,44,6,38,11,82
7120,DET,2002,2002-10-13,1:00,12:00,@,MIN,6,5,Sun,L 24-31,,5,56,10,75,15,131
7121,DET,2002,2002-11-17,4:16,4:16,,NYJ,11,10,Sun,L 14-31,,5,47,4,45,9,92
7122,DET,2003,2003-10-05,4:15,1:15,@,SFO,5,5,Sun,L 17-24,,5,48,4,45,9,93
7123,DET,2003,2003-11-23,1:00,12:00,@,MIN,12,11,Sun,L 14-24,,5,50,11,95,16,145
7124,DET,2003,2003-11-27,12:37,12:37,,GNB,13,12,Thu,W 22-14,,5,40,6,49,11,89
7125,DET,2003,2003-12-14,1:00,12:00,@,KAN,15,14,Sun,L 17-45,,5,32,6,55,11,87
7126,DET,2005,2005-10-30,1:04,1:04,,CHI,8,7,Sun,L 13-19,OT,5,40,10,75,15,115
7127,DET,2005,2005-12-11,8:36,7:36,@,GNB,14,13,Sun,L 13-16,OT,5,50,5,25,10,75
7128,DET,2005,2006-01-01,1:02,1:02,@,PIT,17,16,Sun,L 21-35,,5,47,2,15,7,62
7129,DET,2006,2006-11-12,1:03,1:03,,SFO,10,9,Sun,L 13-19,,5,40,5,51,10,91
7130,DET,2007,2007-10-28,1:05,12:05,@,CHI,8,7,Sun,W 16-7,,5,32,7,78,12,110
7131,DET,2008,2008-09-07,1:04,1:04,@,ATL,1,1,Sun,L 21-34,,5,30,7,68,12,98
7132,DET,2008,2008-09-14,1:03,1:03,,GNB,2,2,Sun,L 25-48,,5,40,8,62,13,102
7133,DET,2008,2008-10-12,1:05,12:05,@,MIN,6,5,Sun,L 10-12,,5,96,7,99,12,195
7134,DET,2008,2008-11-27,12:37,12:37,,TEN,13,12,Thu,L 10-47,,5,38,9,65,14,103
7135,DET,2008,2008-12-28,1:02,12:02,@,GNB,17,16,Sun,L 21-31,,5,60,6,60,11,120
7136,DET,2010,2011-01-02,1:03,1:03,,MIN,17,16,Sun,W 20-13,,5,33,3,25,8,58
7137,DET,2012,2012-09-30,1:03,1:03,,MIN,4,4,Sun,L 13-20,,5,72,5,87,10,159
7138,DET,2012,2012-10-22,8:40,7:40,@,CHI,7,6,Mon,L 7-13,,5,47,9,49,14,96
7139,DET,2012,2012-10-28,1:03,1:03,,SEA,8,7,Sun,W 28-24,,5,61,2,10,7,71
7140,DET,2012,2012-11-04,1:04,1:04,@,JAX,9,8,Sun,W 31-14,,5,42,3,40,8,82
7141,DET,2012,2012-12-09,8:30,7:30,@,GNB,14,13,Sun,L 20-27,,5,55,7,50,12,105
7142,DET,2013,2013-11-10,1:03,12:03,@,CHI,10,9,Sun,W 21-19,,5,51,5,39,10,90
7143,DET,2013,2013-11-24,1:03,1:03,,TAM,12,11,Sun,L 21-24,,5,39,9,67,14,106
7144,DET,2013,2013-11-28,12:36,12:36,,GNB,13,12,Thu,W 40-10,,5,50,3,25,8,75
7145,DET,2014,2014-09-14,1:04,1:04,@,CAR,2,2,Sun,L 7-24,,5,33,4,45,9,78
7146,DET,2014,2014-09-28,1:02,1:02,@,NYJ,4,4,Sun,W 24-17,,5,33,6,32,11,65
7147,DET,2014,2014-10-12,1:02,12:02,@,MIN,6,6,Sun,W 17-3,,5,40,9,60,14,100
7148,DET,2014,2014-11-27,12:39,12:39,,CHI,13,12,Thu,W 34-17,,5,38,5,41,10,79
7149,DET,2014,2014-12-14,4:25,4:25,,MIN,15,14,Sun,W 16-14,,5,35,3,25,8,60
7150,DET,2015,2015-10-25,1:02,1:02,,MIN,7,7,Sun,L 19-28,,5,30,3,31,8,61
7151,DET,2015,2015-12-13,1:02,12:02,@,STL,14,13,Sun,L 14-21,,5,45,5,48,10,93
7152,DET,2016,2016-11-20,1:00,1:00,,JAX,11,10,Sun,W 26-19,,5,32,4,25,9,57
7153,DET,2016,2016-12-26,8:30,7:30,@,DAL,16,15,Mon,L 21-42,,5,62,8,47,13,109
7154,DET,2016,2017-01-01,8:30,8:30,,GNB,17,16,Sun,L 24-31,,5,30,10,75,15,105
7155,DET,2017,2017-12-31,1:00,1:00,,GNB,17,16,Sun,W 35-11,,5,62,8,68,13,130
7156,DET,2018,2018-11-22,12:30,12:30,,CHI,12,11,Thu,L 16-23,,5,54,3,20,8,74
7157,DET,2019,2019-11-03,4:05,1:05,@,OAK,9,8,Sun,L 24-31,,5,35,10,96,15,131
7158,DET,2020,2020-10-04,1:00,1:00,,NOR,4,4,Sun,L 29-35,,5,49,4,67,9,116
7159,DET,2020,2020-10-25,1:00,1:00,@,ATL,7,6,Sun,W 23-22,,5,50,8,53,13,103
7160,DET,2021,2021-09-12,1:00,1:00,,SFO,1,1,Sun,L 33-41,,5,45,7,79,12,124
7161,GNB,2000,2000-09-17,1:02,12:02,,PHI,3,3,Sun,W 6-3,,5,31,12,115,17,146
7162,GNB,2000,2000-12-03,8:35,7:35,@,CHI,14,13,Sun,W 28-6,,5,42,5,41,10,83
7163,GNB,2001,2001-10-21,3:15,3:15,@,MIN,6,6,Sun,L 13-35,,5,48,7,54,12,102
7164,GNB,2002,2002-10-07,9:08,8:08,@,CHI,5,5,Mon,W 34-21,,5,49,7,65,12,114
7165,GNB,2002,2002-10-13,1:02,1:02,@,NWE,6,6,Sun,W 28-10,,5,60,12,126,17,186
7166,GNB,2002,2002-12-29,4:16,4:16,@,NYJ,17,16,Sun,L 17-42,,5,43,3,30,8,73
7167,GNB,2004,2005-01-02,1:03,12:03,@,CHI,17,16,Sun,W 31-14,,5,35,4,29,9,64
7168,GNB,2005,2005-11-21,9:07,8:07,,MIN,11,10,Mon,L 17-20,,5,31,6,77,11,108
7169,GNB,2005,2005-12-11,8:36,7:36,,DET,14,13,Sun,W 16-13,OT,5,25,5,50,10,75
7170,GNB,2006,2006-09-10,4:15,3:15,,CHI,1,1,Sun,L 0-26,,5,45,4,25,9,70
7171,GNB,2006,2006-09-17,1:02,12:02,,NOR,2,2,Sun,L 27-34,,5,31,2,14,7,45
7172,GNB,2006,2006-09-24,1:02,1:02,@,DET,3,3,Sun,W 31-24,,5,30,6,46,11,76
7173,GNB,2006,2006-11-05,1:02,1:02,@,BUF,9,8,Sun,L 10-24,,5,36,8,50,13,86
7174,GNB,2006,2006-11-12,1:05,12:05,@,MIN,10,9,Sun,W 23-17,,5,34,7,49,12,83
7175,GNB,2007,2007-09-23,1:02,12:02,,SDG,3,3,Sun,W 31-24,,5,38,8,70,13,108
7176,GNB,2008,2008-10-12,4:16,1:16,@,SEA,6,6,Sun,W 27-17,,5,45,6,50,11,95
7177,GNB,2009,2009-11-08,1:03,1:03,@,TAM,9,8,Sun,L 28-38,,5,35,2,15,7,50
7178,GNB,2009,2009-12-27,1:02,12:02,,SEA,16,15,Sun,W 48-10,,5,50,8,86,13,136
7179,GNB,2010,2010-12-05,1:02,12:02,,SFO,13,12,Sun,W 34-16,,5,40,6,32,11,72
7180,GNB,2011,2011-11-06,4:15,1:15,@,SDG,9,8,Sun,W 45-38,,5,33,8,64,13,97
7181,GNB,2011,2011-11-20,1:02,12:02,,TAM,11,10,Sun,W 35-26,,5,37,9,55,14,92
7182,GNB,2011,2011-12-11,4:15,3:15,,OAK,14,13,Sun,W 46-16,,5,35,11,89,16,124
7183,GNB,2011,2011-12-18,1:03,12:03,@,KAN,15,14,Sun,L 14-19,,5,37,7,55,12,92
7184,GNB,2012,2012-10-28,1:05,12:05,,JAX,8,8,Sun,W 24-15,,5,33,7,77,12,110
7185,GNB,2013,2013-09-08,4:26,1:26,@,SFO,1,1,Sun,L 28-34,,5,44,11,85,16,129
7186,GNB,2013,2013-11-10,1:02,12:02,,PHI,10,9,Sun,L 13-27,,5,31,5,65,10,96
7187,GNB,2013,2013-11-17,4:25,4:25,@,NYG,11,10,Sun,L 13-27,,5,38,3,30,8,68
7188,GNB,2014,2014-09-21,1:02,1:02,@,DET,3,3,Sun,L 7-19,,5,30,6,40,11,70
7189,GNB,2014,2014-10-02,8:26,7:26,,MIN,5,5,Thu,W 42-10,,5,30,9,91,14,121
7190,GNB,2014,2014-10-19,1:02,12:02,,CAR,7,7,Sun,W 38-17,,5,29,9,70,14,99
7191,GNB,2014,2014-11-09,8:30,7:30,,CHI,10,9,Sun,W 55-14,,5,50,11,163,16,213
7192,GNB,2014,2014-12-08,8:30,7:30,,ATL,14,13,Mon,W 43-37,,5,40,3,11,8,51
7193,GNB,2014,2014-12-21,1:03,1:03,@,TAM,16,15,Sun,W 20-3,,5,40,3,30,8,70
7194,GNB,2014,2014-12-28,4:25,3:25,,DET,17,16,Sun,W 30-20,,5,40,10,53,15,93
7195,GNB,2015,2015-11-15,1:04,12:04,,DET,10,9,Sun,L 16-18,,5,55,3,35,8,90
7196,GNB,2016,2016-09-11,1:04,1:04,@,JAX,1,1,Sun,W 27-23,,5,24,9,79,14,103
7197,GNB,2016,2016-10-16,4:25,3:25,,DAL,6,5,Sun,L 16-30,,5,23,7,60,12,83
7198,GNB,2016,2016-12-11,4:25,3:25,,SEA,14,13,Sun,W 38-10,,5,50,7,63,12,113
7199,GNB,2017,2017-11-12,1:00,12:00,@,CHI,10,9,Sun,W 23-16,,5,35,8,78,13,113
7200,GNB,2017,2017-11-19,1:00,12:00,,BAL,11,10,Sun,L 0-23,,5,53,3,30,8,83
7201,GNB,2018,2018-09-30,1:00,12:00,,BUF,4,4,Sun,W 22-0,,5,60,3,20,8,80
7202,GNB,2018,2018-11-15,8:20,5:20,@,SEA,11,10,Thu,L 24-27,,5,80,6,30,11,110
7203,GNB,2018,2018-12-30,1:00,12:00,,DET,17,16,Sun,L 0-31,,5,38,3,34,8,72
7204,GNB,2019,2019-09-26,8:20,7:20,,PHI,4,4,Thu,L 27-34,,5,50,9,93,14,143
7205,GNB,2019,2019-11-24,8:20,5:20,@,SFO,12,11,Sun,L 8-37,,5,50,9,78,14,128
7206,GNB,2019,2019-12-08,1:00,12:00,,WAS,14,13,Sun,W 20-15,,5,34,3,25,8,59
7207,GNB,2020,2020-10-25,1:00,12:00,@,HOU,7,6,Sun,W 35-20,,5,40,6,55,11,95
7208,GNB,2020,2020-11-05,8:20,5:20,@,SFO,9,8,Thu,W 34-17,,5,45,4,33,9,78
7209,GNB,2020,2020-12-06,4:25,3:25,,PHI,13,12,Sun,W 30-16,,5,30,4,40,9,70
7210,GNB,2020,2020-12-19,8:15,7:15,,CAR,15,14,Sat,W 24-16,,5,50,7,66,12,116
7211,GNB,2021,2021-09-12,4:25,4:25,@,NOR,1,1,Sun,L 3-38,,5,41,6,36,11,77
7212,GNB,2021,2021-09-20,8:15,7:15,,DET,2,2,Mon,W 35-17,,5,50,9,78,14,128
7213,HOU,2002,2002-11-10,1:03,12:03,@,TEN,10,9,Sun,L 10-17,,5,47,3,20,8,67
7214,HOU,2002,2002-11-17,1:02,12:02,,JAX,11,10,Sun,L 21-24,,5,40,7,62,12,102
7215,HOU,2003,2003-11-30,1:03,12:03,,ATL,13,12,Sun,W 17-13,,5,53,6,49,11,102
7216,HOU,2004,2004-12-05,1:03,1:03,@,NYJ,13,12,Sun,L 7-29,,5,48,6,49,11,97
7217,HOU,2005,2005-10-30,1:02,12:02,,CLE,8,7,Sun,W 19-16,,5,35,1,5,6,40
7218,HOU,2005,2005-12-18,1:02,12:02,,ARI,15,14,Sun,W 30-19,,5,43,7,69,12,112
7219,HOU,2006,2006-11-19,1:03,12:03,,BUF,11,10,Sun,L 21-24,,5,40,3,17,8,57
7220,HOU,2006,2006-12-03,4:05,1:05,@,OAK,13,12,Sun,W 23-14,,5,46,7,60,12,106
7221,HOU,2007,2007-09-16,1:02,1:02,@,CAR,2,2,Sun,W 34-21,,5,40,5,35,10,75
7222,HOU,2007,2007-10-28,4:05,1:05,@,SDG,8,8,Sun,L 10-35,,5,31,3,46,8,77
7223,HOU,2007,2007-11-25,1:03,1:03,@,CLE,12,11,Sun,L 17-27,,5,26,7,71,12,97
7224,HOU,2007,2007-12-02,1:02,12:02,@,TEN,13,12,Sun,L 20-28,,5,36,7,44,12,80
7225,HOU,2007,2007-12-09,1:01,12:01,,TAM,14,13,Sun,W 28-14,,5,35,4,25,9,60
7226,HOU,2008,2008-09-07,1:02,1:02,@,PIT,1,1,Sun,L 17-38,,5,43,4,41,9,84
7227,HOU,2008,2008-10-19,4:05,3:05,,DET,7,6,Sun,W 28-21,,5,41,4,31,9,72
7228,HOU,2008,2008-11-02,1:05,12:05,@,MIN,9,8,Sun,L 21-28,,5,35,3,20,8,55
7229,HOU,2008,2008-12-01,8:40,7:40,,JAX,13,12,Mon,W 30-17,,5,30,8,60,13,90
7230,HOU,2009,2009-09-27,1:03,12:03,,JAX,3,3,Sun,L 24-31,,5,60,5,40,10,100
7231,HOU,2009,2009-11-01,1:02,1:02,@,BUF,8,8,Sun,W 31-10,,5,45,4,36,9,81
7232,HOU,2009,2010-01-03,1:02,12:02,,NWE,17,16,Sun,W 34-27,,5,35,4,55,9,90
7233,HOU,2010,2010-09-19,4:15,4:15,@,WAS,2,2,Sun,W 30-27,OT,5,45,7,58,12,103
7234,HOU,2010,2010-09-26,1:02,12:02,,DAL,3,3,Sun,L 13-27,,5,32,8,49,13,81
7235,HOU,2010,2010-10-03,4:05,1:05,@,OAK,4,4,Sun,W 31-24,,5,26,2,23,7,49
7236,HOU,2010,2010-10-17,1:03,12:03,,KAN,6,6,Sun,W 35-31,,5,53,5,35,10,88
7237,HOU,2010,2010-11-01,8:41,8:41,@,IND,8,7,Mon,L 17-30,,5,30,9,69,14,99
7238,HOU,2010,2011-01-02,4:15,3:15,,JAX,17,16,Sun,W 34-17,,5,48,2,15,7,63
7239,HOU,2011,2011-10-16,4:06,4:06,@,BAL,6,6,Sun,L 14-29,,5,15,5,25,10,40
7240,HOU,2011,2011-12-04,1:03,12:03,,ATL,13,12,Sun,W 17-10,,5,35,7,43,12,78
7241,HOU,2011,2011-12-11,1:02,1:02,@,CIN,14,13,Sun,W 20-19,,5,50,3,27,8,77
7242,HOU,2012,2012-10-21,1:02,12:02,,BAL,7,7,Sun,W 43-13,,5,60,5,56,10,116
7243,HOU,2013,2013-09-15,1:03,12:03,,TEN,2,2,Sun,W 30-24,OT,5,40,9,70,14,110
7244,HOU,2013,2013-11-03,8:30,7:30,,IND,9,8,Sun,L 24-27,,5,86,3,15,8,101
7245,HOU,2013,2013-12-29,1:02,12:02,@,TEN,17,16,Sun,L 10-16,,5,55,7,76,12,131
7246,HOU,2014,2014-09-21,1:02,1:02,@,NYG,3,3,Sun,L 17-30,,5,40,4,31,9,71
7247,HOU,2014,2014-10-05,1:03,12:03,@,DAL,5,5,Sun,L 17-20,OT,5,35,7,56,12,91
7248,HOU,2014,2014-10-09,8:26,7:26,,IND,6,6,Thu,L 28-33,,5,66,5,51,10,117
7249,HOU,2014,2014-11-16,1:03,1:03,@,CLE,11,10,Sun,W 23-7,,5,55,8,67,13,122
7250,HOU,2014,2014-11-30,1:02,12:02,,TEN,13,12,Sun,W 45-21,,5,40,6,66,11,106
7251,HOU,2015,2015-10-04,1:02,1:02,@,ATL,4,4,Sun,L 21-48,,5,35,10,80,15,115
7252,HOU,2015,2015-11-16,8:30,8:30,@,CIN,10,9,Mon,W 10-6,,5,54,9,70,14,124
7253,HOU,2016,2016-09-18,1:02,12:02,,KAN,2,2,Sun,W 19-12,,5,44,9,77,14,121
7254,HOU,2018,2018-10-07,8:20,7:20,,DAL,5,5,Sun,W 19-16,OT,5,25,7,72,12,97
7255,HOU,2018,2018-12-02,1:00,12:00,,CLE,13,12,Sun,W 29-13,,5,77,6,45,11,122
7256,HOU,2018,2018-12-15,4:30,4:30,@,NYJ,15,14,Sat,W 29-22,,5,43,9,60,14,103
7257,HOU,2019,2019-11-17,1:00,1:00,@,BAL,11,10,Sun,L 7-41,,5,60,8,65,13,125
7258,HOU,2019,2019-12-15,1:00,12:00,@,TEN,15,14,Sun,W 24-21,,5,27,4,30,9,57
7259,HOU,2019,2019-12-29,4:25,3:25,,TEN,17,16,Sun,L 14-35,,5,35,5,37,10,72
7260,HOU,2020,2020-09-10,8:20,7:20,@,KAN,1,1,Thu,L 20-34,,5,37,1,5,6,42
7261,HOU,2020,2020-10-11,1:00,12:00,,JAX,5,5,Sun,W 30-14,,5,25,4,35,9,60
7262,HOU,2020,2020-11-22,1:00,12:00,,NWE,11,10,Sun,W 27-20,,5,35,7,55,12,90
7263,HOU,2020,2020-12-20,1:00,1:00,@,IND,15,14,Sun,L 20-27,,5,24,4,35,9,59
7264,HOU,2021,2021-09-12,1:00,12:00,,JAX,1,1,Sun,W 37-21,,5,50,10,82,15,132
7265,HOU,2021,2022-01-02,4:05,1:05,@,SFO,17,16,Sun,L 7-23,,5,67,7,111,12,178
7266,JAX,2000,2000-10-16,9:10,8:10,@,TEN,7,7,Mon,L 13-27,,5,40,10,89,15,129
7267,JAX,2000,2000-10-22,4:15,4:15,,WAS,8,8,Sun,L 16-35,,5,42,6,59,11,101
7268,JAX,2001,2001-12-30,1:05,1:05,,KAN,16,15,Sun,L 26-30,,5,44,5,55,10,99
7269,JAX,2002,2002-09-08,1:04,1:04,,IND,1,1,Sun,L 25-28,,5,40,2,14,7,54
7270,JAX,2002,2002-09-15,1:00,12:00,@,KAN,2,2,Sun,W 23-16,,5,45,5,48,10,93
7271,JAX,2002,2002-10-20,1:02,1:02,@,BAL,7,6,Sun,L 10-17,,5,30,4,30,9,60
7272,JAX,2002,2002-10-27,4:15,4:15,,HOU,8,7,Sun,L 19-21,,5,50,9,60,14,110
7273,JAX,2002,2002-12-08,1:03,1:03,,CLE,14,13,Sun,L 20-21,,5,51,10,68,15,119
7274,JAX,2002,2002-12-15,1:02,1:02,@,CIN,15,14,Sun,W 29-15,,5,54,5,29,10,83
7275,JAX,2003,2003-10-26,1:01,1:01,,TEN,8,7,Sun,L 17-30,,5,45,8,49,13,94
7276,JAX,2003,2003-11-30,8:36,8:36,,TAM,13,12,Sun,W 17-10,,5,48,7,80,12,128
7277,JAX,2004,2004-10-03,1:02,1:02,,IND,4,4,Sun,L 17-24,,5,28,3,26,8,54
7278,JAX,2004,2004-10-10,4:05,1:05,@,SDG,5,5,Sun,L 21-34,,5,33,4,44,9,77
7279,JAX,2004,2004-10-17,1:02,1:02,,KAN,6,6,Sun,W 22-16,,5,46,5,30,10,76
7280,JAX,2004,2004-12-26,1:03,1:03,,HOU,16,15,Sun,L 0-21,,5,45,6,50,11,95
7281,JAX,2005,2005-11-13,1:01,1:01,,BAL,10,9,Sun,W 30-3,,5,42,9,86,14,128
7282,JAX,2005,2005-12-04,1:03,1:03,@,CLE,13,12,Sun,W 20-14,,5,50,7,97,12,147
7283,JAX,2006,2006-10-29,1:07,1:07,@,PHI,8,7,Sun,W 13-6,,5,44,8,50,13,94
7284,JAX,2006,2006-12-31,1:00,12:00,@,KAN,17,16,Sun,L 30-35,,5,35,5,32,10,67
7285,JAX,2007,2007-10-07,1:00,12:00,@,KAN,5,4,Sun,W 17-7,,5,30,3,25,8,55
7286,JAX,2007,2007-10-28,4:05,4:05,@,TAM,8,7,Sun,W 24-23,,5,45,7,74,12,119
7287,JAX,2007,2007-11-18,1:03,1:03,,SDG,11,10,Sun,W 24-17,,5,42,4,31,9,73
7288,JAX,2008,2008-09-14,1:03,1:03,,BUF,2,2,Sun,L 16-20,,5,35,4,40,9,75
7289,JAX,2008,2008-09-21,4:15,4:15,@,IND,3,3,Sun,W 23-21,,5,44,6,37,11,81
7290,JAX,2008,2008-11-09,1:02,1:02,@,DET,10,9,Sun,W 38-14,,5,33,6,46,11,79
7291,JAX,2009,2009-09-27,1:03,12:03,@,HOU,3,3,Sun,W 31-24,,5,40,5,60,10,100
7292,JAX,2009,2009-11-08,1:03,1:03,,KAN,9,8,Sun,W 24-21,,5,31,1,10,6,41
7293,JAX,2009,2009-11-15,1:02,1:02,@,NYJ,10,9,Sun,W 24-22,,5,40,4,26,9,66
7294,JAX,2010,2010-09-12,1:03,1:03,,DEN,1,1,Sun,W 24-17,,5,47,7,70,12,117
7295,JAX,2010,2010-09-19,4:15,1:15,@,SDG,2,2,Sun,L 13-38,,5,33,4,25,9,58
7296,JAX,2010,2010-10-10,1:02,1:02,@,BUF,5,5,Sun,W 36-26,,5,38,5,35,10,73
7297,JAX,2011,2011-09-11,1:05,1:05,,TEN,1,1,Sun,W 16-14,,5,39,7,60,12,99
7298,JAX,2011,2011-10-30,1:02,12:02,@,HOU,8,8,Sun,L 14-24,,5,39,7,60,12,99
7299,JAX,2011,2011-11-13,1:02,1:02,@,IND,10,9,Sun,W 17-3,,5,55,6,40,11,95
7300,JAX,2011,2011-12-15,8:29,8:29,@,ATL,15,14,Thu,L 14-41,,5,40,4,31,9,71
7301,JAX,2012,2012-11-25,1:03,1:03,,TEN,12,11,Sun,W 24-19,,5,30,6,42,11,72
7302,JAX,2012,2012-12-23,1:02,1:02,,NWE,16,15,Sun,L 16-23,,5,47,4,39,9,86
7303,JAX,2013,2013-09-08,1:03,1:03,,KAN,1,1,Sun,L 2-28,,5,30,3,20,8,50
7304,JAX,2013,2013-12-01,1:02,1:02,@,CLE,13,12,Sun,W 32-28,,5,35,9,50,14,85
7305,JAX,2013,2013-12-29,1:02,1:02,@,IND,17,16,Sun,L 10-30,,5,50,2,10,7,60
7306,JAX,2014,2014-12-14,1:02,1:02,@,BAL,15,14,Sun,L 12-20,,5,60,9,70,14,130
7307,JAX,2015,2015-12-13,1:02,1:02,,IND,14,13,Sun,W 51-16,,5,40,8,85,13,125
7308,JAX,2015,2015-12-20,1:02,1:02,,ATL,15,14,Sun,L 17-23,,5,62,5,43,10,105
7309,JAX,2016,2016-10-16,1:02,12:02,@,CHI,6,5,Sun,W 17-16,,5,50,10,87,15,137
7310,JAX,2016,2016-11-06,1:00,12:00,@,KAN,9,8,Sun,L 14-19,,5,46,8,75,13,121
7311,JAX,2017,2017-10-15,4:05,4:05,,LAR,6,6,Sun,L 17-27,,5,40,7,70,12,110
7312,JAX,2017,2017-11-05,1:00,1:00,,CIN,9,8,Sun,W 23-7,,5,50,8,77,13,127
7313,JAX,2017,2017-11-26,4:25,2:25,@,ARI,12,11,Sun,L 24-27,,5,45,10,98,15,143
7314,JAX,2018,2018-10-07,1:00,12:00,@,KAN,5,5,Sun,L 14-30,,5,45,11,105,16,150
7315,JAX,2018,2018-10-28,9:30,2:30,,PHI,8,8,Sun,L 18-24,,5,45,4,36,9,81
7316,JAX,2020,2020-10-18,1:00,1:00,,DET,6,6,Sun,L 16-34,,5,56,7,60,12,116
7317,JAX,2020,2020-11-29,1:00,1:00,,CLE,12,11,Sun,L 25-27,,5,24,6,47,11,71
7318,KAN,2000,2000-12-10,1:00,12:00,,CAR,15,14,Sun,W 15-14,,5,35,5,47,10,82
7319,KAN,2000,2000-12-24,1:05,1:05,@,ATL,17,16,Sun,L 13-29,,5,25,4,30,9,55
7320,KAN,2001,2001-12-30,1:05,1:05,@,JAX,16,15,Sun,W 30-26,,5,55,5,44,10,99
7321,KAN,2002,2002-09-15,1:00,12:00,,JAX,2,2,Sun,L 16-23,,5,48,5,45,10,93
7322,KAN,2002,2002-10-20,1:00,12:00,,DEN,7,7,Sun,L 34-37,OT,5,50,8,75,13,125
7323,KAN,2002,2002-11-17,1:00,12:00,,BUF,11,10,Sun,W 17-16,,5,39,13,139,18,178
7324,KAN,2003,2003-10-12,1:02,12:02,@,GNB,6,6,Sun,W 40-34,OT,5,40,3,25,8,65
7325,KAN,2003,2003-10-26,8:30,7:30,,BUF,8,8,Sun,W 38-5,,5,60,5,31,10,91
7326,KAN,2003,2003-11-09,1:00,12:00,,CLE,10,9,Sun,W 41-20,,5,70,4,38,9,108
7327,KAN,2003,2003-12-07,4:15,2:15,@,DEN,14,13,Sun,L 27-45,,5,44,4,23,9,67
7328,KAN,2004,2004-10-17,1:02,1:02,@,JAX,6,5,Sun,L 16-22,,5,30,5,46,10,76
7329,KAN,2004,2004-10-24,1:00,12:00,,ATL,7,6,Sun,W 56-10,,5,45,3,41,8,86
7330,KAN,2004,2004-10-31,1:00,12:00,,IND,8,7,Sun,W 45-35,,5,46,7,40,12,86
7331,KAN,2004,2004-11-28,1:00,12:00,,SDG,12,11,Sun,L 31-34,,5,26,9,60,14,86
7332,KAN,2004,2005-01-02,4:15,1:15,@,SDG,17,16,Sun,L 17-24,,5,45,7,50,12,95
7333,KAN,2005,2005-11-20,8:37,7:37,@,HOU,11,10,Sun,W 45-17,,5,30,6,43,11,73
7334,KAN,2005,2005-11-27,1:00,12:00,,NWE,12,11,Sun,W 26-16,,5,35,2,22,7,57
7335,KAN,2006,2006-09-10,1:00,12:00,,CIN,1,1,Sun,L 10-23,,5,40,5,40,10,80
7336,KAN,2006,2006-10-08,4:05,1:05,@,ARI,5,4,Sun,W 23-20,,5,49,7,50,12,99
7337,KAN,2006,2006-11-05,1:02,12:02,@,STL,9,8,Sun,W 31-17,,5,23,8,67,13,90
7338,KAN,2006,2006-12-31,1:00,12:00,,JAX,17,16,Sun,W 35-30,,5,32,5,35,10,67
7339,KAN,2007,2007-09-09,1:05,12:05,@,HOU,1,1,Sun,L 3-20,,5,40,6,45,11,85
7340,KAN,2007,2007-11-18,1:02,1:02,@,IND,11,10,Sun,L 10-13,,5,33,2,10,7,43
7341,KAN,2008,2008-09-14,1:00,12:00,,OAK,2,2,Sun,L 8-23,,5,36,9,61,14,97
7342,KAN,2008,2008-09-28,1:00,12:00,,DEN,4,4,Sun,W 33-19,,5,45,3,22,8,67
7343,KAN,2008,2008-12-21,1:00,12:00,,MIA,16,15,Sun,L 31-38,,5,46,2,15,7,61
7344,KAN,2009,2009-11-15,4:05,1:05,@,OAK,10,9,Sun,W 16-10,,5,35,10,88,15,123
7345,KAN,2009,2009-11-29,4:05,1:05,@,SDG,12,11,Sun,L 14-43,,5,25,8,55,13,80
7346,KAN,2009,2009-12-13,1:00,12:00,,BUF,14,13,Sun,L 10-16,,5,43,3,40,8,83
7347,KAN,2009,2010-01-03,4:15,2:15,@,DEN,17,16,Sun,W 44-24,,5,76,5,54,10,130
7348,KAN,2010,2010-10-17,1:03,12:03,@,HOU,6,5,Sun,L 31-35,,5,35,5,53,10,88
7349,KAN,2010,2010-10-31,1:08,12:08,,BUF,8,7,Sun,W 13-10,OT,5,50,5,35,10,85
7350,KAN,2010,2010-11-21,1:03,12:03,,ARI,11,10,Sun,W 31-13,,5,23,11,96,16,119
7351,KAN,2010,2010-11-28,4:06,1:06,@,SEA,12,11,Sun,W 42-24,,5,50,3,26,8,76
7352,KAN,2010,2010-12-19,1:00,12:00,@,STL,15,14,Sun,W 27-13,,5,40,9,60,14,100
7353,KAN,2010,2011-01-02,1:02,12:02,,OAK,17,16,Sun,L 10-31,,5,39,10,77,15,116
7354,KAN,2011,2011-10-09,1:02,1:02,@,IND,5,5,Sun,W 28-24,,5,39,4,40,9,79
7355,KAN,2011,2011-11-21,8:40,8:40,@,NWE,11,10,Mon,L 3-34,,5,34,3,20,8,54
7356,KAN,2012,2012-10-28,4:06,3:06,,OAK,8,7,Sun,L 16-26,,5,40,2,20,7,60
7357,KAN,2012,2012-11-01,8:27,5:27,@,SDG,9,8,Thu,L 13-31,,5,37,8,54,13,91
7358,KAN,2012,2012-12-09,1:02,1:02,@,CLE,14,13,Sun,L 7-30,,5,35,7,55,12,90
7359,KAN,2012,2012-12-30,4:25,2:25,@,DEN,17,16,Sun,L 3-38,,5,32,5,30,10,62
7360,KAN,2013,2013-10-20,4:26,3:26,,HOU,7,7,Sun,W 17-16,,5,24,4,40,9,64
7361,KAN,2013,2013-10-27,1:02,12:02,,CLE,8,8,Sun,W 23-17,,5,31,9,70,14,101
7362,KAN,2013,2013-11-03,1:02,1:02,@,BUF,9,9,Sun,W 23-13,,5,38,6,48,11,86
7363,KAN,2014,2014-11-30,8:32,7:32,,DEN,13,12,Sun,L 16-29,,5,35,5,32,10,67
7364,KAN,2015,2015-11-22,4:05,1:05,@,SDG,11,10,Sun,W 33-3,,5,35,6,39,11,74
7365,KAN,2015,2015-12-27,1:03,12:03,,CLE,16,15,Sun,W 17-13,,5,33,8,83,13,116
7366,KAN,2015,2016-01-03,4:26,3:26,,OAK,17,16,Sun,W 23-17,,5,55,7,59,12,114
7367,KAN,2016,2016-09-25,4:26,3:26,,NYJ,3,3,Sun,W 24-3,,5,59,3,15,8,74
7368,KAN,2016,2016-11-20,1:00,12:00,,TAM,11,10,Sun,L 17-19,,5,30,7,42,12,72
7369,KAN,2016,2016-12-18,1:00,12:00,,TEN,15,14,Sun,L 17-19,,5,40,2,25,7,65
7370,KAN,2017,2017-09-17,1:00,12:00,,PHI,2,2,Sun,W 27-20,,5,40,4,30,9,70
7371,KAN,2017,2017-12-24,1:00,12:00,,MIA,16,15,Sun,W 29-13,,5,40,11,75,16,115
7372,KAN,2018,2018-10-14,8:20,8:20,@,NWE,6,6,Sun,L 40-43,,5,58,0,0,5,58
7373,KAN,2019,2019-09-08,1:00,1:00,@,JAX,1,1,Sun,W 40-26,,5,55,10,71,15,126
7374,KAN,2019,2019-12-15,1:00,12:00,,DEN,15,14,Sun,W 23-3,,5,45,7,72,12,117
7375,KAN,2019,2019-12-29,1:00,12:00,,LAC,17,16,Sun,W 31-21,,5,39,8,40,13,79
7376,KAN,2020,2020-12-06,8:20,7:20,,DEN,13,12,Sun,W 22-16,,5,44,4,31,9,75
7377,KAN,2020,2020-12-20,4:25,3:25,@,NOR,15,14,Sun,W 32-29,,5,54,10,93,15,147
7378,KAN,2020,2021-01-03,4:25,3:25,,LAC,17,16,Sun,L 21-38,,5,69,4,23,9,92
7379,KAN,2021,2021-09-12,4:25,3:25,,CLE,1,1,Sun,W 33-29,,5,36,5,30,10,66
7380,KAN,2021,2021-09-19,8:20,8:20,@,BAL,2,2,Sun,L 35-36,,5,46,8,55,13,101
7381,KAN,2021,2021-10-17,1:00,1:00,@,WAS,6,6,Sun,W 31-13,,5,47,6,44,11,91
7382,KAN,2021,2021-12-26,4:25,3:25,,PIT,16,15,Sun,W 36-10,,5,41,5,40,10,81
7383,KAN,2021,2022-01-08,4:30,2:30,@,DEN,18,17,Sat,W 28-24,,5,45,6,45,11,90
7384,MIA,2000,2000-09-24,1:03,1:03,,NWE,4,4,Sun,W 10-3,,5,40,3,30,8,70
7385,MIA,2000,2000-10-08,1:02,1:02,,BUF,6,6,Sun,W 22-13,,5,64,3,40,8,104
7386,MIA,2000,2000-12-24,1:02,1:02,@,NWE,17,16,Sun,W 27-24,,5,25,5,58,10,83
7387,MIA,2001,2001-09-23,1:10,1:10,,OAK,2,2,Sun,W 18-15,,5,40,3,25,8,65
7388,MIA,2001,2001-09-30,12:03,12:03,@,STL,3,3,Sun,L 10-42,,5,30,9,59,14,89
7389,MIA,2001,2001-11-04,1:01,1:01,,CAR,8,7,Sun,W 23-6,,5,45,5,44,10,89
7390,MIA,2001,2001-12-30,1:02,1:02,,ATL,16,15,Sun,W 21-14,,5,48,5,37,10,85
7391,MIA,2002,2002-10-06,1:02,1:02,,NWE,5,5,Sun,W 26-13,,5,35,6,49,11,84
7392,MIA,2002,2002-12-01,1:02,1:02,@,BUF,13,12,Sun,L 21-38,,5,38,7,56,12,94
7393,MIA,2003,2003-11-02,1:04,1:04,,IND,9,8,Sun,L 17-23,,5,44,5,35,10,79
7394,MIA,2003,2003-11-16,1:03,1:03,,BAL,11,10,Sun,W 9-6,OT,5,50,10,88,15,138
7395,MIA,2003,2003-12-28,1:03,1:03,,NYJ,17,16,Sun,W 23-21,,5,30,4,40,9,70
7396,MIA,2004,2005-01-02,1:02,1:02,@,BAL,17,16,Sun,L 23-30,,5,50,6,50,11,100
7397,MIA,2005,2005-10-30,4:05,3:05,@,NOR,8,7,Sun,W 21-6,,5,34,8,77,13,111
7398,MIA,2006,2006-09-24,1:02,1:02,,TEN,3,3,Sun,W 13-10,,5,29,6,47,11,76
7399,MIA,2006,2006-10-01,1:02,12:02,@,HOU,4,4,Sun,L 15-17,,5,35,2,15,7,50
7400,MIA,2006,2006-11-19,1:03,1:03,,MIN,11,10,Sun,W 24-20,,5,40,6,49,11,89
7401,MIA,2007,2007-09-30,1:32,1:32,,OAK,4,4,Sun,L 17-35,,5,34,2,15,7,49
7402,MIA,2007,2007-12-30,1:03,1:03,,CIN,17,16,Sun,L 25-38,,5,55,3,20,8,75
7403,MIA,2008,2008-09-21,1:02,1:02,@,NWE,3,3,Sun,W 38-13,,5,35,2,10,7,45
7404,MIA,2008,2008-12-07,4:05,4:05,@,BUF,14,13,Sun,W 16-3,,5,28,3,25,8,53
7405,MIA,2009,2009-10-04,4:05,4:05,,BUF,4,4,Sun,W 38-10,,5,45,3,19,8,64
7406,MIA,2009,2009-11-19,8:20,8:20,@,CAR,11,10,Thu,W 24-17,,5,30,4,35,9,65
7407,MIA,2010,2010-11-18,8:29,8:29,,CHI,11,10,Thu,L 0-16,,5,45,5,45,10,90
7408,MIA,2010,2010-11-28,4:05,1:05,@,OAK,12,11,Sun,W 33-17,,5,35,4,20,9,55
7409,MIA,2010,2010-12-12,4:15,4:15,@,NYJ,14,13,Sun,W 10-6,,5,36,6,50,11,86
7410,MIA,2010,2011-01-02,1:02,1:02,@,NWE,17,16,Sun,L 7-38,,5,40,5,72,10,112
7411,MIA,2011,2011-12-18,1:02,1:02,@,BUF,15,14,Sun,W 30-23,,5,62,11,92,16,154
7412,MIA,2011,2012-01-01,1:02,1:02,,NYJ,17,16,Sun,W 19-17,,5,35,6,40,11,75
7413,MIA,2012,2012-10-14,1:00,1:00,,STL,6,6,Sun,W 17-14,,5,40,12,94,17,134
7414,MIA,2012,2012-12-09,4:05,1:05,@,SFO,14,13,Sun,L 13-27,,5,43,6,45,11,88
7415,MIA,2012,2012-12-16,1:03,1:03,,JAX,15,14,Sun,W 24-3,,5,41,10,88,15,129
7416,MIA,2013,2013-09-30,8:40,7:40,@,NOR,4,4,Mon,L 17-38,,5,25,6,45,11,70
7417,MIA,2013,2013-12-08,1:02,1:02,@,PIT,14,13,Sun,W 34-28,,5,36,9,63,14,99
7418,MIA,2013,2013-12-29,1:02,1:02,,NYJ,17,16,Sun,L 7-20,,5,38,5,36,10,74
7419,MIA,2014,2014-09-28,1:06,6:06,@,OAK,4,4,Sun,W 38-14,,5,35,9,80,14,115
7420,MIA,2014,2014-10-12,1:02,1:02,,GNB,6,5,Sun,L 24-27,,5,25,4,44,9,69
7421,MIA,2014,2014-11-09,1:02,1:02,@,DET,10,9,Sun,L 16-20,,5,44,10,98,15,142
7422,MIA,2014,2014-12-14,1:02,1:02,@,NWE,15,14,Sun,L 13-41,,5,35,5,51,10,86
7423,MIA,2014,2014-12-28,1:02,1:02,,NYJ,17,16,Sun,L 24-37,,5,40,5,40,10,80
7424,MIA,2015,2015-12-06,1:03,1:03,,BAL,13,12,Sun,W 15-13,,5,31,5,36,10,67
7425,MIA,2016,2016-09-18,1:02,1:02,@,NWE,2,2,Sun,L 24-31,,5,49,7,65,12,114
7426,MIA,2017,2017-09-17,4:05,1:05,@,LAC,2,1,Sun,W 19-17,,5,23,6,56,11,79
7427,MIA,2017,2017-10-08,1:00,1:00,,TEN,5,4,Sun,W 16-10,,5,23,11,77,16,100
7428,MIA,2018,2018-10-25,8:20,7:20,@,HOU,8,8,Thu,L 23-42,,5,63,8,57,13,120
7429,MIA,2018,2018-11-04,1:00,1:00,,NYJ,9,9,Sun,W 13-6,,5,55,5,45,10,100
7430,MIA,2019,2019-09-22,1:00,12:00,@,DAL,3,3,Sun,L 6-31,,5,35,8,100,13,135
7431,MIA,2019,2019-09-29,1:00,1:00,,LAC,4,4,Sun,L 10-30,,5,53,10,89,15,142
7432,MIA,2019,2019-10-13,1:00,1:00,,WAS,6,5,Sun,L 16-17,,5,45,6,56,11,101
7433,MIA,2019,2019-10-28,8:15,8:15,@,PIT,8,7,Mon,L 14-27,,5,45,9,70,14,115
7434,MIA,2019,2019-12-08,1:00,1:00,@,NYJ,14,13,Sun,L 21-22,,5,48,5,88,10,136
7435,MIA,2020,2020-10-18,4:05,4:05,,NYJ,6,6,Sun,W 24-0,,5,25,7,80,12,105
7436,MIA,2020,2020-11-22,4:05,2:05,@,DEN,11,10,Sun,L 13-20,,5,50,8,70,13,120
7437,MIA,2020,2020-12-26,8:15,5:15,@,LVR,16,15,Sat,W 26-25,,5,76,4,40,9,116
7438,MIA,2021,2021-09-12,4:25,4:25,@,NWE,1,1,Sun,W 17-16,,5,28,8,84,13,112
7439,MIA,2021,2021-10-03,1:00,1:00,,IND,4,4,Sun,L 17-27,,5,32,8,86,13,118
7440,MIA,2021,2021-10-10,1:00,1:00,@,TAM,5,5,Sun,L 17-45,,5,37,6,47,11,84
7441,MIA,2021,2021-11-28,1:00,1:00,,CAR,12,12,Sun,W 33-10,,5,35,7,61,12,96
7442,MIA,2021,2021-12-19,1:00,1:00,,NYJ,15,14,Sun,W 31-24,,5,45,3,32,8,77
7443,MIA,2021,2022-01-02,1:00,12:00,@,TEN,17,16,Sun,L 3-34,,5,55,6,70,11,125
7444,MIA,2021,2022-01-09,1:00,1:00,,NWE,18,17,Sun,W 33-24,,5,33,8,78,13,111
7445,MIN,2000,2000-09-17,4:15,4:15,@,NWE,3,3,Sun,W 21-13,,5,61,9,64,14,125
7446,MIN,2001,2001-10-28,1:01,1:01,@,TAM,7,7,Sun,L 14-41,,5,40,5,56,10,96
7447,MIN,2001,2001-12-02,1:01,1:01,@,PIT,12,11,Sun,L 16-21,,5,36,3,30,8,66
7448,MIN,2001,2001-12-09,1:00,12:00,,TEN,13,12,Sun,W 42-24,,5,35,3,20,8,55
7449,MIN,2003,2003-12-07,1:00,12:00,,SEA,14,13,Sun,W 34-7,,5,30,7,39,12,69
7450,MIN,2004,2004-09-12,4:15,3:15,,DAL,1,1,Sun,W 35-17,,5,40,9,119,14,159
7451,MIN,2004,2004-10-17,8:36,7:36,@,NOR,6,5,Sun,W 38-31,,5,35,4,21,9,56
7452,MIN,2004,2004-12-12,1:00,12:00,,SEA,14,13,Sun,L 23-27,,5,42,5,79,10,121
7453,MIN,2005,2005-12-11,1:05,12:05,,STL,14,13,Sun,W 27-13,,5,60,9,60,14,120
7454,MIN,2006,2006-10-08,1:05,12:05,,DET,5,5,Sun,W 26-17,,5,40,7,50,12,90
7455,MIN,2006,2006-10-22,4:16,1:16,@,SEA,7,6,Sun,W 31-13,,5,45,5,30,10,75
7456,MIN,2006,2006-12-31,1:05,12:05,,STL,17,16,Sun,L 21-41,,5,35,4,62,9,97
7457,MIN,2007,2007-11-11,1:02,12:02,@,GNB,10,9,Sun,L 0-34,,5,51,4,35,9,86
7458,MIN,2008,2008-11-16,1:02,1:02,@,TAM,11,10,Sun,L 13-19,,5,28,5,54,10,82
7459,MIN,2008,2008-11-23,1:05,1:05,@,JAX,12,11,Sun,W 30-12,,5,49,8,81,13,130
7460,MIN,2009,2009-09-20,1:03,1:03,@,DET,2,2,Sun,W 27-13,,5,43,6,45,11,88
7461,MIN,2009,2009-10-11,1:00,12:00,@,STL,5,5,Sun,W 38-10,,5,44,7,82,12,126
7462,MIN,2009,2009-11-22,1:05,12:05,,SEA,11,10,Sun,W 35-9,,5,31,10,64,15,95
7463,MIN,2009,2009-12-20,8:30,8:30,@,CAR,15,14,Sun,L 7-26,,5,45,6,49,11,94
7464,MIN,2010,2010-10-17,4:15,3:15,,DAL,6,5,Sun,W 24-21,,5,45,11,91,16,136
7465,MIN,2010,2010-10-31,4:15,4:15,@,NWE,8,7,Sun,L 18-28,,5,35,6,47,11,82
7466,MIN,2010,2010-12-28,8:06,8:06,@,PHI,16,15,Tue,W 24-14,,5,74,12,62,17,136
7467,MIN,2011,2011-10-09,1:05,12:05,,ARI,5,5,Sun,W 34-10,,5,35,6,64,11,99
7468,MIN,2011,2011-10-16,8:30,7:30,@,CHI,6,6,Sun,L 10-39,,5,40,3,15,8,55
7469,MIN,2011,2011-12-11,1:03,1:03,@,DET,14,13,Sun,L 28-34,,5,37,10,76,15,113
7470,MIN,2011,2012-01-01,1:05,12:05,,CHI,17,16,Sun,L 13-17,,5,38,4,20,9,58
7471,MIN,2012,2012-09-09,1:05,12:05,,JAX,1,1,Sun,W 26-23,OT,5,47,4,25,9,72
7472,MIN,2012,2012-09-30,1:03,1:03,@,DET,4,4,Sun,W 20-13,,5,87,5,72,10,159
7473,MIN,2012,2012-10-07,4:15,3:15,,TEN,5,5,Sun,W 30-7,,5,60,10,75,15,135
7474,MIN,2012,2012-10-14,4:24,4:24,@,WAS,6,6,Sun,L 26-38,,5,29,7,66,12,95
7475,MIN,2012,2012-10-25,8:29,7:29,,TAM,8,8,Thu,L 17-36,,5,32,4,49,9,81
7476,MIN,2012,2012-12-02,1:02,12:02,@,GNB,13,12,Sun,L 14-23,,5,48,10,78,15,126
7477,MIN,2012,2012-12-23,1:03,12:03,@,HOU,16,15,Sun,W 23-6,,5,52,9,60,14,112
7478,MIN,2013,2013-09-08,1:02,1:02,@,DET,1,1,Sun,L 24-34,,5,52,11,88,16,140
7479,MIN,2013,2013-09-29,1:07,6:07,,PIT,4,4,Sun,W 34-27,,5,89,4,50,9,139
7480,MIN,2013,2013-10-13,1:05,12:05,,CAR,6,5,Sun,L 10-35,,5,55,6,40,11,95
7481,MIN,2013,2013-11-24,1:02,12:02,@,GNB,12,11,Sun,T 26-26,OT,5,53,7,50,12,103
7482,MIN,2013,2013-12-22,1:02,1:02,@,CIN,16,15,Sun,L 14-42,,5,40,6,55,11,95
7483,MIN,2014,2014-09-21,1:03,12:03,@,NOR,3,3,Sun,L 9-20,,5,44,4,30,9,74
7484,MIN,2014,2014-11-30,1:02,12:02,,CAR,13,12,Sun,W 31-13,,5,25,4,35,9,60
7485,MIN,2015,2015-09-14,10:20,7:20,@,SFO,1,1,Mon,L 3-20,,5,25,8,57,13,82
7486,MIN,2015,2015-10-18,1:02,12:02,,KAN,6,5,Sun,W 16-10,,5,50,8,95,13,145
7487,MIN,2015,2016-01-03,8:30,7:30,@,GNB,17,16,Sun,W 20-13,,5,37,7,54,12,91
7488,MIN,2016,2016-11-24,12:30,12:30,@,DET,12,11,Thu,L 13-16,,5,40,4,16,9,56
7489,MIN,2017,2017-09-11,7:10,9:10,,NOR,1,1,Mon,W 29-19,,5,50,6,52,11,102
7490,MIN,2017,2017-09-24,1:00,3:00,,TAM,3,3,Sun,W 34-17,,5,53,7,37,12,90
7491,MIN,2017,2017-10-29,9:30,2:30,@,CLE,8,8,Sun,W 33-16,,5,58,5,74,10,132
7492,MIN,2018,2018-12-02,4:25,4:25,@,NWE,13,12,Sun,L 10-24,,5,55,7,60,12,115
7493,MIN,2019,2019-11-10,8:20,7:20,@,DAL,10,10,Sun,W 28-24,,5,35,5,39,10,74
7494,MIN,2019,2019-11-17,1:00,3:00,,DEN,11,11,Sun,W 27-23,,5,49,6,35,11,84
7495,MIN,2019,2019-12-15,4:05,1:05,@,LAC,15,14,Sun,W 39-10,,5,41,5,48,10,89
7496,MIN,2020,2020-09-13,1:00,3:00,,GNB,1,1,Sun,L 34-43,,5,20,6,63,11,83
7497,MIN,2020,2020-12-13,1:00,1:00,@,TAM,14,13,Sun,L 14-26,,5,71,5,34,10,105
7498,MIN,2021,2021-11-28,4:25,1:25,@,SFO,12,11,Sun,L 26-34,,5,38,5,57,10,95
7499,NOR,2000,2000-09-24,1:02,12:02,,PHI,4,4,Sun,L 7-21,,5,40,10,64,15,104
7500,NOR,2000,2000-10-29,4:05,2:05,@,ARI,9,8,Sun,W 21-10,,5,55,4,27,9,82
7501,NOR,2001,2001-11-25,4:05,4:05,@,NWE,11,10,Sun,L 17-34,,5,86,6,64,11,150
7502,NOR,2002,2002-09-08,4:15,4:15,@,TAM,1,1,Sun,W 26-20,OT,5,45,8,85,13,130
7503,NOR,2002,2002-11-24,1:02,12:02,,CLE,12,11,Sun,L 15-24,,5,24,4,31,9,55
7504,NOR,2003,2003-09-21,1:03,12:03,@,TEN,3,3,Sun,L 12-27,,5,27,3,14,8,41
7505,NOR,2003,2003-09-28,8:37,7:37,,IND,4,4,Sun,L 21-55,,5,50,2,20,7,70
7506,NOR,2003,2003-11-02,1:05,1:05,@,TAM,9,9,Sun,W 17-14,,5,47,5,35,10,82
7507,NOR,2004,2004-09-26,1:02,12:02,@,STL,3,3,Sun,W 28-25,OT,5,25,12,85,17,110
7508,NOR,2004,2004-10-24,4:15,1:15,@,OAK,7,7,Sun,W 31-26,,5,30,6,46,11,76
7509,NOR,2004,2004-11-28,4:05,4:05,@,ATL,12,11,Sun,L 21-24,,5,25,6,46,11,71
7510,NOR,2005,2005-12-04,1:05,12:05,,TAM,13,12,Sun,L 3-10,,5,35,5,26,10,61
7511,NOR,2006,2006-10-01,1:02,1:02,@,CAR,4,4,Sun,L 18-21,,5,38,7,48,12,86
7512,NOR,2006,2006-11-26,1:05,1:05,@,ATL,12,11,Sun,W 31-13,,5,35,7,65,12,100
7513,NOR,2007,2007-10-07,1:03,12:03,,CAR,5,4,Sun,L 13-16,,5,35,7,59,12,94
7514,NOR,2007,2007-10-14,8:23,5:23,@,SEA,6,5,Sun,W 28-17,,5,37,3,11,8,48
7515,NOR,2007,2007-11-25,1:03,1:03,@,CAR,12,11,Sun,W 31-6,,5,76,5,35,10,111
7516,NOR,2008,2008-09-14,1:03,1:03,@,WAS,2,2,Sun,L 24-29,,5,55,4,26,9,81
7517,NOR,2008,2008-11-30,1:02,1:02,@,TAM,13,12,Sun,L 20-23,,5,45,1,5,6,50
7518,NOR,2008,2008-12-11,8:14,7:14,@,CHI,15,14,Thu,L 24-27,OT,5,97,4,24,9,121
7519,NOR,2010,2010-09-20,8:36,5:36,@,SFO,2,2,Mon,W 25-22,,5,54,5,40,10,94
7520,NOR,2010,2010-12-12,4:05,3:05,,STL,14,13,Sun,W 31-13,,5,55,4,39,9,94
7521,NOR,2010,2011-01-02,1:00,12:00,,TAM,17,16,Sun,L 13-23,,5,45,7,54,12,99
7522,NOR,2011,2011-10-30,1:00,12:00,@,STL,8,8,Sun,L 21-31,,5,32,9,64,14,96
7523,NOR,2012,2012-11-11,1:02,12:02,,ATL,10,9,Sun,W 31-27,,5,35,6,53,11,88
7524,NOR,2012,2012-11-29,8:29,8:29,@,ATL,13,12,Thu,L 13-23,,5,30,5,25,10,55
7525,NOR,2012,2012-12-30,1:03,12:03,,CAR,17,16,Sun,L 38-44,,5,55,4,36,9,91
7526,NOR,2013,2013-09-15,4:05,4:05,@,TAM,2,2,Sun,W 16-14,,5,35,10,118,15,153
7527,NOR,2013,2013-11-21,8:30,8:30,@,ATL,12,11,Thu,W 17-13,,5,66,3,25,8,91
7528,NOR,2013,2013-12-08,8:30,7:30,,CAR,14,13,Sun,W 31-13,,5,45,5,35,10,80
7529,NOR,2014,2014-09-14,1:03,1:03,@,CLE,2,2,Sun,L 24-26,,5,39,4,30,9,69
7530,NOR,2014,2014-11-16,1:02,12:02,,CIN,11,10,Sun,L 10-27,,5,34,4,33,9,67
7531,NOR,2014,2014-11-24,8:30,7:30,,BAL,12,11,Mon,L 27-34,,5,50,6,42,11,92
7532,NOR,2015,2015-12-27,4:05,3:05,,JAX,16,15,Sun,W 38-27,,5,40,8,55,13,95
7533,NOR,2016,2016-09-26,8:30,7:30,,ATL,3,3,Mon,L 32-45,,5,75,4,35,9,110
7534,NOR,2016,2016-12-18,4:05,2:05,@,ARI,15,14,Sun,W 48-41,,5,46,7,52,12,98
7535,NOR,2017,2017-09-17,1:00,12:00,,NWE,2,2,Sun,L 20-36,,5,35,9,66,14,101
7536,NOR,2018,2018-09-30,4:25,4:25,@,NYG,4,4,Sun,W 33-18,,5,51,6,67,11,118
7537,NOR,2018,2018-11-29,8:20,7:20,@,DAL,13,12,Thu,L 10-13,,5,48,8,80,13,128
7538,NOR,2019,2019-12-08,1:00,12:00,,SFO,14,13,Sun,L 46-48,,5,50,10,67,15,117
7539,NOR,2020,2020-10-12,8:15,7:15,,LAC,5,5,Mon,W 30-27,OT,5,60,1,10,6,70
7540,NOR,2020,2020-11-01,4:25,3:25,@,CHI,8,7,Sun,W 26-23,OT,5,45,7,53,12,98
7541,NOR,2020,2020-11-15,4:25,3:25,,SFO,10,9,Sun,W 27-13,,5,61,6,51,11,112
7542,NOR,2020,2020-11-22,1:00,12:00,,ATL,11,10,Sun,W 24-9,,5,35,7,53,12,88
7543,NOR,2020,2020-11-29,4:05,2:05,@,DEN,12,11,Sun,W 31-3,,5,35,2,10,7,45
7544,NOR,2021,2021-10-03,1:00,12:00,,NYG,4,4,Sun,L 21-27,OT,5,35,3,25,8,60
7545,NOR,2021,2022-01-02,1:00,12:00,,CAR,17,16,Sun,W 18-10,,5,33,1,5,6,38
7546,NWE,2000,2000-09-03,1:02,1:02,,TAM,1,1,Sun,L 16-21,,5,33,4,25,9,58
7547,NWE,2000,2000-10-01,4:06,2:06,@,DEN,5,5,Sun,W 28-19,,5,17,7,50,12,67
7548,NWE,2000,2000-11-12,1:03,1:03,@,CLE,11,10,Sun,L 11-19,,5,40,4,25,9,65
7549,NWE,2000,2000-12-04,9:09,9:09,,KAN,14,13,Mon,W 30-24,,5,65,7,40,12,105
7550,NWE,2000,2000-12-24,1:02,1:02,,MIA,17,16,Sun,L 24-27,,5,58,5,25,10,83
7551,NWE,2001,2001-12-09,1:02,1:02,,CLE,13,13,Sun,W 27-16,,5,31,2,21,7,52
7552,NWE,2002,2002-11-24,1:02,1:02,,MIN,12,11,Sun,W 24-17,,5,25,8,74,13,99
7553,NWE,2003,2003-10-19,1:03,1:03,@,MIA,7,7,Sun,W 19-13,OT,5,34,4,40,9,74
7554,NWE,2003,2003-11-23,1:02,12:02,@,HOU,12,11,Sun,W 23-20,OT,5,58,6,45,11,103
7555,NWE,2003,2003-12-20,8:37,8:37,@,NYJ,16,15,Sat,W 21-16,,5,31,4,25,9,56
7556,NWE,2004,2004-11-14,8:36,8:36,,BUF,10,9,Sun,W 29-6,,5,44,2,48,7,92
7557,NWE,2005,2005-11-20,1:02,1:02,,NOR,11,10,Sun,W 24-17,,5,50,11,99,16,149
7558,NWE,2007,2007-10-14,4:17,3:17,@,DAL,6,6,Sun,W 48-27,,5,50,12,100,17,150
7559,NWE,2007,2007-10-21,1:02,1:02,@,MIA,7,7,Sun,W 49-28,,5,40,4,41,9,81
7560,NWE,2007,2007-12-29,8:15,8:15,@,NYG,17,16,Sat,W 38-35,,5,42,5,53,10,95
7561,NWE,2008,2008-10-20,8:40,8:40,,DEN,7,6,Mon,W 41-7,,5,65,8,87,13,152
7562,NWE,2008,2008-11-13,8:15,8:15,,NYJ,11,10,Thu,L 31-34,OT,5,29,4,25,9,54
7563,NWE,2009,2009-10-04,1:02,1:02,,BAL,4,4,Sun,W 27-21,,5,41,9,85,14,126
7564,NWE,2009,2009-11-08,1:02,1:02,,MIA,9,8,Sun,W 27-17,,5,49,3,35,8,84
7565,NWE,2010,2010-11-25,12:38,12:38,@,DET,12,11,Thu,W 45-24,,5,50,8,66,13,116
7566,NWE,2010,2011-01-02,1:02,1:02,,MIA,17,16,Sun,W 38-7,,5,72,5,40,10,112
7567,NWE,2011,2011-10-02,4:15,1:15,@,OAK,4,4,Sun,W 31-19,,5,45,9,85,14,130
7568,NWE,2011,2011-10-16,4:15,4:15,,DAL,6,6,Sun,W 20-16,,5,35,10,77,15,112
7569,NWE,2011,2011-12-24,1:02,1:02,,MIA,16,15,Sat,W 27-24,,5,50,6,39,11,89
7570,NWE,2013,2013-10-27,1:02,1:02,,MIA,8,8,Sun,W 27-17,,5,35,7,61,12,96
7571,NWE,2013,2013-11-18,8:42,8:42,@,CAR,11,10,Mon,L 20-24,,5,50,7,47,12,97
7572,NWE,2013,2013-11-24,8:30,8:30,,DEN,12,11,Sun,W 34-31,OT,5,36,9,85,14,121
7573,NWE,2014,2014-11-16,8:31,8:31,@,IND,11,10,Sun,W 42-20,,5,53,4,27,9,80
7574,NWE,2014,2014-12-14,1:02,1:02,,MIA,15,14,Sun,W 41-13,,5,51,5,35,10,86
7575,NWE,2014,2014-12-21,1:02,1:02,@,NYJ,16,15,Sun,W 17-16,,5,38,2,14,7,52
7576,NWE,2014,2014-12-28,1:02,1:02,,BUF,17,16,Sun,L 9-17,,5,55,5,44,10,99
7577,NWE,2015,2015-11-23,8:30,8:30,,BUF,11,10,Mon,W 20-13,,5,61,5,44,10,105
7578,NWE,2015,2015-11-29,8:30,6:30,@,DEN,12,11,Sun,L 24-30,OT,5,47,6,46,11,93
7579,NWE,2015,2015-12-20,1:02,1:02,,TEN,15,14,Sun,W 33-16,,5,35,3,29,8,64
7580,NWE,2016,2016-10-09,1:02,1:02,@,CLE,5,5,Sun,W 33-13,,5,61,5,35,10,96
7581,NWE,2016,2016-11-20,4:25,1:25,@,SFO,11,10,Sun,W 30-17,,5,40,10,68,15,108
7582,NWE,2016,2016-12-12,8:30,8:30,,BAL,14,13,Mon,W 30-23,,5,48,8,47,13,95
7583,NWE,2017,2017-09-24,1:00,1:00,,HOU,3,3,Sun,W 36-33,,5,69,10,60,15,129
7584,NWE,2018,2018-09-23,8:20,8:20,@,DET,3,3,Sun,L 10-26,,5,38,6,70,11,108
7585,NWE,2018,2018-10-29,8:15,8:15,@,BUF,8,8,Mon,W 25-6,,5,33,6,51,11,84
7586,NWE,2018,2018-11-04,8:20,8:20,,GNB,9,9,Sun,W 31-17,,5,30,7,63,12,93
7587,NWE,2018,2018-12-09,1:00,1:00,@,MIA,14,13,Sun,L 33-34,,5,30,7,81,12,111
7588,NWE,2018,2018-12-23,1:00,1:00,,BUF,16,15,Sun,W 24-12,,5,49,3,29,8,78
7589,NWE,2019,2019-09-15,1:00,1:00,@,MIA,2,2,Sun,W 43-0,,5,54,4,22,9,76
7590,NWE,2019,2019-12-08,4:25,4:25,,KAN,14,13,Sun,L 16-23,,5,25,10,136,15,161
7591,NWE,2020,2020-11-01,1:00,1:00,@,BUF,8,7,Sun,L 21-24,,5,35,5,30,10,65
7592,NWE,2020,2020-12-10,8:20,5:20,@,LAR,14,13,Thu,L 3-24,,5,27,5,35,10,62
7593,NWE,2021,2021-10-10,1:00,12:00,@,HOU,5,5,Sun,W 25-22,,5,27,8,70,13,97
7594,NWE,2021,2021-10-17,4:25,4:25,,DAL,6,6,Sun,L 29-35,OT,5,47,12,115,17,162
7595,NWE,2021,2021-11-18,8:20,8:20,@,ATL,11,11,Thu,W 25-0,,5,59,9,72,14,131
7596,NYG,2000,2000-10-29,4:07,4:07,,PHI,9,8,Sun,W 24-7,,5,35,8,74,13,109
7597,NYG,2001,2001-10-28,4:05,4:05,@,WAS,7,7,Sun,L 21-35,,5,43,11,76,16,119
7598,NYG,2001,2001-11-25,4:15,4:15,,OAK,11,11,Sun,L 10-28,,5,40,4,30,9,70
7599,NYG,2002,2002-12-22,1:00,1:00,@,IND,16,15,Sun,W 44-27,,5,33,7,59,12,92
7600,NYG,2003,2003-10-05,1:03,1:03,,MIA,5,4,Sun,L 10-23,,5,35,6,50,11,85
7601,NYG,2003,2003-11-30,1:02,1:02,,BUF,13,12,Sun,L 7-24,,5,58,8,60,13,118
7602,NYG,2004,2004-09-12,4:21,4:21,@,PHI,1,1,Sun,L 17-31,,5,30,8,50,13,80
7603,NYG,2004,2004-12-18,1:37,1:37,,PIT,15,14,Sat,L 30-33,,5,55,2,14,7,69
7604,NYG,2006,2006-10-15,1:04,1:04,@,ATL,6,5,Sun,W 27-14,,5,45,4,40,9,85
7605,NYG,2006,2006-11-20,8:40,8:40,@,JAX,11,10,Mon,L 10-26,,5,35,9,65,14,100
7606,NYG,2006,2006-11-26,4:15,3:15,@,TEN,12,11,Sun,L 21-24,,5,43,3,30,8,73
7607,NYG,2006,2006-12-17,4:15,4:15,,PHI,15,14,Sun,L 22-36,,5,55,12,103,17,158
7608,NYG,2006,2006-12-30,8:05,8:05,@,WAS,17,16,Sat,W 34-28,,5,41,10,100,15,141
7609,NYG,2007,2007-11-25,1:03,1:03,,MIN,12,11,Sun,L 17-41,,5,30,4,15,9,45
7610,NYG,2007,2007-12-29,8:15,8:15,,NWE,17,16,Sat,L 35-38,,5,53,5,42,10,95
7611,NYG,2008,2008-10-05,1:03,1:03,,SEA,5,4,Sun,W 44-6,,5,56,2,29,7,85
7612,NYG,2008,2008-10-13,8:41,8:41,@,CLE,6,5,Mon,L 14-35,,5,38,10,55,15,93
7613,NYG,2009,2009-09-27,1:00,1:00,@,TAM,3,3,Sun,W 24-0,,5,60,5,25,10,85
7614,NYG,2010,2010-11-07,4:05,1:05,@,SEA,9,8,Sun,W 41-7,,5,40,9,70,14,110
7615,NYG,2010,2010-12-05,1:02,1:02,,WAS,13,12,Sun,W 31-7,,5,35,5,35,10,70
7616,NYG,2010,2010-12-26,4:15,3:15,@,GNB,16,15,Sun,L 17-45,,5,45,3,31,8,76
7617,NYG,2011,2011-09-19,8:40,8:40,,STL,2,2,Mon,W 28-16,,5,55,7,62,12,117
7618,NYG,2011,2011-11-20,8:32,8:32,,PHI,11,10,Sun,L 10-17,,5,39,5,30,10,69
7619,NYG,2011,2011-12-24,1:03,1:03,@,NYJ,16,15,Sat,W 29-14,,5,45,10,95,15,140
7620,NYG,2012,2012-09-20,8:20,8:20,@,CAR,3,3,Thu,W 36-7,,5,38,3,22,8,60
7621,NYG,2012,2012-10-28,4:25,3:25,@,DAL,8,8,Sun,W 29-24,,5,45,2,10,7,55
7622,NYG,2013,2013-10-21,8:40,8:40,,MIN,7,7,Mon,W 23-7,,5,72,3,38,8,110
7623,NYG,2013,2013-12-15,1:03,1:03,,SEA,15,14,Sun,L 0-23,,5,38,8,50,13,88
7624,NYG,2013,2013-12-22,4:05,4:05,@,DET,16,15,Sun,W 23-20,OT,5,30,7,60,12,90
7625,NYG,2014,2014-11-23,8:30,8:30,,DAL,12,11,Sun,L 28-31,,5,30,7,63,12,93
7626,NYG,2015,2015-09-13,8:31,7:31,@,DAL,1,1,Sun,L 26-27,,5,44,3,35,8,79
7627,NYG,2016,2016-11-06,1:00,1:00,,PHI,9,8,Sun,W 28-23,,5,30,4,43,9,73
7628,NYG,2016,2016-12-18,1:00,1:00,,DET,15,14,Sun,W 17-6,,5,46,2,15,7,61
7629,NYG,2016,2016-12-22,8:25,8:25,@,PHI,16,15,Thu,L 19-24,,5,50,1,5,6,55
7630,NYG,2016,2017-01-01,4:25,4:25,@,WAS,17,16,Sun,W 19-10,,5,42,5,42,10,84
7631,NYG,2017,2017-10-15,8:30,6:30,@,DEN,6,6,Sun,W 23-10,,5,77,5,46,10,123
7632,NYG,2017,2017-11-19,1:00,1:00,,KAN,11,10,Sun,W 12-9,OT,5,48,9,87,14,135
7633,NYG,2017,2017-12-17,1:00,1:00,,PHI,15,14,Sun,L 29-34,,5,67,7,44,12,111
7634,NYG,2018,2018-10-11,8:20,8:20,,PHI,6,6,Thu,L 13-34,,5,61,4,25,9,86
7635,NYG,2019,2019-09-29,1:00,1:00,,WAS,4,4,Sun,W 24-3,,5,45,12,58,17,103
7636,NYG,2019,2019-10-06,1:00,1:00,,MIN,5,5,Sun,L 10-28,,5,45,12,112,17,157
7637,NYG,2019,2019-10-10,8:20,8:20,@,NWE,6,6,Thu,L 14-35,,5,40,3,20,8,60
7638,NYG,2019,2019-10-27,1:00,1:00,@,DET,8,8,Sun,L 26-31,,5,44,7,75,12,119
7639,NYG,2020,2020-09-27,1:00,1:00,,SFO,3,3,Sun,L 9-36,,5,28,6,45,11,73
7640,NYG,2020,2020-11-29,1:00,1:00,@,CIN,12,11,Sun,W 19-17,,5,51,3,27,8,78
7641,NYG,2020,2020-12-27,1:00,1:00,@,BAL,16,15,Sun,L 13-27,,5,35,10,65,15,100
7642,NYG,2021,2021-10-10,4:25,3:25,@,DAL,5,5,Sun,L 20-44,,5,48,8,58,13,106
7643,NYG,2021,2021-10-17,1:00,1:00,,LAR,6,6,Sun,L 11-38,,5,27,7,50,12,77
7644,NYJ,2000,2000-10-15,4:05,4:05,@,NWE,7,6,Sun,W 34-17,,5,68,4,30,9,98
7645,NYJ,2002,2002-11-10,8:35,8:35,,MIA,10,9,Sun,W 13-10,,5,36,6,30,11,66
7646,NYJ,2003,2003-10-26,4:13,4:13,@,PHI,8,7,Sun,L 17-24,,5,35,1,10,6,45
7647,NYJ,2004,2004-11-21,1:02,1:02,@,CLE,11,10,Sun,W 10-7,,5,50,7,40,12,90
7648,NYJ,2005,2005-09-18,4:16,4:16,,MIA,2,2,Sun,W 17-7,,5,40,10,88,15,128
7649,NYJ,2005,2005-10-02,4:05,4:05,@,BAL,4,4,Sun,L 3-13,,5,39,3,19,8,58
7650,NYJ,2005,2005-10-24,9:07,9:07,@,ATL,7,7,Mon,L 14-27,,5,44,4,30,9,74
7651,NYJ,2005,2005-11-06,1:02,1:02,,SDG,9,8,Sun,L 26-31,,5,35,12,124,17,159
7652,NYJ,2005,2005-11-13,4:05,4:05,@,CAR,10,9,Sun,L 3-30,,5,50,3,25,8,75
7653,NYJ,2005,2005-12-11,1:02,1:02,,OAK,14,13,Sun,W 26-10,,5,69,13,88,18,157
7654,NYJ,2005,2005-12-18,1:03,1:03,@,MIA,15,14,Sun,L 20-24,,5,39,8,92,13,131
7655,NYJ,2006,2006-10-01,1:02,1:02,,IND,4,4,Sun,L 28-31,,5,47,10,64,15,111
7656,NYJ,2007,2007-09-23,1:02,1:02,,MIA,3,3,Sun,W 31-28,,5,26,9,56,14,82
7657,NYJ,2007,2007-10-21,4:05,4:05,@,CIN,7,7,Sun,L 31-38,,5,62,9,70,14,132
7658,NYJ,2007,2007-11-04,1:02,1:02,,WAS,9,9,Sun,L 20-23,OT,5,40,5,50,10,90
7659,NYJ,2007,2007-12-30,4:15,4:15,,KAN,17,16,Sun,W 13-10,OT,5,40,8,62,13,102
7660,NYJ,2008,2008-11-02,1:02,1:02,@,BUF,9,8,Sun,W 26-17,,5,34,7,45,12,79
7661,NYJ,2008,2008-11-09,1:03,1:03,,STL,10,9,Sun,W 47-3,,5,24,4,25,9,49
7662,NYJ,2008,2008-12-28,4:17,4:17,,MIA,17,16,Sun,L 17-24,,5,36,6,30,11,66
7663,NYJ,2009,2009-11-22,4:15,4:15,@,NWE,11,10,Sun,L 14-31,,5,28,6,51,11,79
7664,NYJ,2009,2009-12-27,4:16,4:16,@,IND,16,15,Sun,W 29-15,,5,52,3,15,8,67
7665,NYJ,2011,2011-11-13,8:31,8:31,,NWE,10,9,Sun,L 16-37,,5,56,9,80,14,136
7666,NYJ,2012,2012-09-09,1:03,1:03,,BUF,1,1,Sun,W 48-28,,5,34,6,34,11,68
7667,NYJ,2012,2012-10-08,8:40,8:40,,HOU,5,5,Mon,L 17-23,,5,25,7,50,12,75
7668,NYJ,2012,2012-10-28,1:06,1:06,,MIA,8,8,Sun,L 9-30,,5,45,4,31,9,76
7669,NYJ,2012,2012-11-22,8:31,8:31,,NWE,12,11,Thu,L 19-49,,5,35,8,37,13,72
7670,NYJ,2013,2013-10-13,1:03,1:03,,PIT,6,6,Sun,L 6-19,,5,60,7,49,12,109
7671,NYJ,2013,2013-12-29,1:02,1:02,@,MIA,17,16,Sun,W 20-7,,5,36,5,38,10,74
7672,NYJ,2014,2014-11-02,1:03,12:03,@,KAN,9,9,Sun,L 10-24,,5,40,3,20,8,60
7673,NYJ,2014,2014-12-28,1:02,1:02,@,MIA,17,16,Sun,W 37-24,,5,40,5,40,10,80
7674,NYJ,2016,2016-10-30,1:02,1:02,@,CLE,8,8,Sun,W 31-28,,5,37,2,10,7,47
7675,NYJ,2017,2017-09-10,1:00,1:00,@,BUF,1,1,Sun,L 12-21,,5,62,6,50,11,112
7676,NYJ,2017,2017-09-17,4:05,1:05,@,OAK,2,2,Sun,L 20-45,,5,47,9,79,14,126
7677,NYJ,2017,2017-12-03,1:00,1:00,,KAN,13,12,Sun,W 38-31,,5,40,8,30,13,70
7678,NYJ,2017,2017-12-24,1:00,1:00,,LAC,16,15,Sun,L 7-14,,5,34,8,80,13,114
7679,NYJ,2018,2018-11-04,1:00,1:00,@,MIA,9,9,Sun,L 6-13,,5,45,5,55,10,100
7680,NYJ,2019,2019-09-22,1:00,1:00,@,NWE,3,3,Sun,L 14-30,,5,67,8,70,13,137
7681,NYJ,2019,2019-12-08,1:00,1:00,,MIA,14,13,Sun,W 22-21,,5,88,5,48,10,136
7682,NYJ,2020,2020-09-20,1:00,1:00,,SFO,2,2,Sun,L 13-31,,5,65,5,59,10,124
7683,NYJ,2021,2021-09-12,1:00,1:00,@,CAR,1,1,Sun,L 14-19,,5,30,6,38,11,68
7684,NYJ,2021,2021-10-24,1:00,1:00,@,NWE,7,6,Sun,L 13-54,,5,29,6,95,11,124
7685,NYJ,2021,2021-11-28,1:00,12:00,@,HOU,12,11,Sun,W 21-14,,5,40,4,32,9,72
7686,NYJ,2021,2021-12-12,1:00,1:00,,NOR,14,13,Sun,L 9-30,,5,45,4,42,9,87
7687,TEN,2000,2000-11-19,1:03,12:03,,CLE,12,11,Sun,W 24-10,,5,45,7,61,12,106
7688,TEN,2001,2001-10-21,1:00,1:00,@,DET,6,5,Sun,W 27-24,,5,45,8,77,13,122
7689,TEN,2002,2002-10-13,4:03,3:03,,JAX,6,6,Sun,W 23-14,,5,55,4,22,9,77
7690,TEN,2002,2002-11-03,1:00,1:00,@,IND,9,8,Sun,W 23-15,,5,45,6,48,11,93
7691,TEN,2002,2002-11-17,1:03,12:03,,PIT,11,10,Sun,W 31-23,,5,36,4,20,9,56
7692,TEN,2003,2003-10-19,1:02,1:02,@,CAR,7,7,Sun,W 37-17,,5,40,5,45,10,85
7693,TEN,2003,2003-11-09,1:02,12:02,,MIA,10,9,Sun,W 31-7,,5,25,4,30,9,55
7694,TEN,2003,2003-12-01,9:09,9:09,@,NYJ,13,12,Mon,L 17-24,,5,36,3,17,8,53
7695,TEN,2004,2004-11-28,1:05,12:05,@,HOU,12,11,Sun,L 21-31,,5,37,3,36,8,73
7696,TEN,2004,2004-12-19,4:15,1:15,@,OAK,15,14,Sun,L 35-40,,5,47,5,39,10,86
7697,TEN,2005,2005-09-18,1:03,12:03,,BAL,2,2,Sun,W 25-10,,5,47,10,73,15,120
7698,TEN,2005,2005-10-16,1:03,12:03,,CIN,6,6,Sun,L 23-31,,5,69,4,32,9,101
7699,TEN,2005,2005-12-24,1:03,1:03,@,MIA,16,15,Sat,L 10-24,,5,28,4,30,9,58
7700,TEN,2006,2006-10-01,1:04,12:04,,DAL,4,4,Sun,L 14-45,,5,55,5,61,10,116
7701,TEN,2006,2006-10-15,1:02,1:02,@,WAS,6,6,Sun,W 25-22,,5,51,6,46,11,97
7702,TEN,2006,2006-12-03,1:03,12:03,,IND,13,12,Sun,W 20-17,,5,34,8,59,13,93
7703,TEN,2007,2007-12-16,1:00,12:00,@,KAN,15,14,Sun,W 26-17,,5,35,8,61,13,96
7704,TEN,2007,2007-12-23,4:15,3:15,,NYJ,16,15,Sun,W 10-6,,5,39,4,35,9,74
7705,TEN,2008,2008-09-07,1:05,12:05,,JAX,1,1,Sun,W 17-10,,5,36,6,50,11,86
7706,TEN,2008,2008-09-14,1:02,1:02,@,CIN,2,2,Sun,W 24-7,,5,25,5,35,10,60
7707,TEN,2009,2009-09-10,8:41,8:41,@,PIT,1,1,Thu,L 10-13,OT,5,28,6,60,11,88
7708,TEN,2009,2009-11-23,8:40,7:40,@,HOU,11,10,Mon,W 20-17,,5,25,7,72,12,97
7709,TEN,2010,2010-11-14,1:02,1:02,@,MIA,10,9,Sun,L 17-29,,5,55,4,63,9,118
7710,TEN,2010,2010-12-09,8:29,7:29,,IND,14,13,Thu,L 28-30,,5,29,7,60,12,89
7711,TEN,2011,2011-10-02,1:03,1:03,@,CLE,4,4,Sun,W 31-13,,5,45,5,40,10,85
7712,TEN,2011,2011-11-27,1:02,12:02,,TAM,12,11,Sun,W 23-17,,5,50,4,30,9,80
7713,TEN,2012,2012-10-11,8:29,7:29,,PIT,6,6,Thu,W 26-23,,5,45,4,50,9,95
7714,TEN,2012,2012-12-23,1:02,12:02,@,GNB,16,15,Sun,L 7-55,,5,35,1,10,6,45
7715,TEN,2012,2012-12-30,1:02,12:02,,JAX,17,16,Sun,W 38-20,,5,43,7,35,12,78
7716,TEN,2014,2014-09-14,1:03,12:03,,DAL,2,2,Sun,L 10-26,,5,30,4,25,9,55
7717,TEN,2014,2014-10-12,1:02,12:02,,JAX,6,6,Sun,W 16-14,,5,48,6,35,11,83
7718,TEN,2014,2014-12-07,1:03,12:03,,NYG,14,13,Sun,L 7-36,,5,39,7,70,12,109
7719,TEN,2015,2015-10-25,1:02,12:02,,ATL,7,6,Sun,L 7-10,,5,45,6,53,11,98
7720,TEN,2016,2016-10-09,1:02,1:02,@,MIA,5,5,Sun,W 30-17,,5,40,8,83,13,123
7721,TEN,2016,2016-12-11,1:00,12:00,,DEN,14,13,Sun,W 13-10,,5,55,9,87,14,142
7722,TEN,2017,2017-09-10,1:00,12:00,,OAK,1,1,Sun,L 16-26,,5,49,5,49,10,98
7723,TEN,2017,2017-09-24,4:05,3:05,,SEA,3,3,Sun,W 33-27,,5,45,11,98,16,143
7724,TEN,2017,2017-10-22,1:00,1:00,@,CLE,7,7,Sun,W 12-9,OT,5,35,12,81,17,116
7725,TEN,2017,2017-11-12,1:00,12:00,,CIN,10,9,Sun,W 24-20,,5,55,12,84,17,139
7726,TEN,2017,2017-12-24,1:00,12:00,,LAR,16,15,Sun,L 23-27,,5,54,5,44,10,98
7727,TEN,2018,2018-09-09,1:00,1:00,@,MIA,1,1,Sun,L 20-27,,5,48,7,51,12,99
7728,TEN,2018,2018-10-07,1:00,1:00,@,BUF,5,5,Sun,L 12-13,,5,40,4,30,9,70
7729,TEN,2019,2019-09-15,1:00,12:00,,IND,2,2,Sun,L 17-19,,5,75,8,65,13,140
7730,TEN,2019,2019-09-29,1:00,1:00,@,ATL,4,4,Sun,W 24-10,,5,77,7,50,12,127
7731,TEN,2019,2019-12-29,4:25,3:25,@,HOU,17,16,Sun,W 35-14,,5,37,5,35,10,72
7732,TEN,2020,2020-09-14,10:10,8:10,@,DEN,1,1,Mon,W 16-14,,5,37,5,56,10,93
7733,TEN,2020,2020-12-06,1:00,12:00,,CLE,13,12,Sun,L 35-41,,5,52,13,92,18,144
7734,TEN,2021,2021-09-19,4:25,1:25,@,SEA,2,2,Sun,W 33-30,OT,5,45,10,100,15,145
7735,TEN,2021,2021-11-21,1:00,12:00,,HOU,11,11,Sun,L 13-22,,5,52,7,50,12,102
7736,TEN,2021,2021-11-28,1:00,1:00,@,NWE,12,12,Sun,L 13-36,,5,50,4,35,9,85
7737,TEN,2021,2022-01-09,1:00,12:00,@,HOU,18,17,Sun,W 28-25,,5,42,4,65,9,107
7738,PHI,2000,2000-09-10,1:02,1:02,,NYG,2,2,Sun,L 18-33,,5,40,4,35,9,75
7739,PHI,2000,2000-10-08,1:02,1:02,,WAS,6,6,Sun,L 14-17,,5,48,12,80,17,128
7740,PHI,2000,2000-11-19,1:02,1:02,,ARI,12,12,Sun,W 34-9,,5,35,9,114,14,149
7741,PHI,2001,2001-09-23,4:27,1:27,@,SEA,2,2,Sun,W 27-3,,5,30,7,62,12,92
7742,PHI,2001,2001-10-28,4:15,4:15,,OAK,7,6,Sun,L 10-20,,5,31,7,65,12,96
7743,PHI,2001,2001-11-29,8:30,7:30,@,KAN,12,11,Thu,W 23-10,,5,35,3,43,8,78
7744,PHI,2002,2002-11-25,9:00,6:00,@,SFO,12,11,Mon,W 38-17,,5,41,9,86,14,127
7745,PHI,2003,2003-12-21,4:15,4:15,,SFO,16,15,Sun,L 28-31,OT,5,35,8,70,13,105
7746,PHI,2004,2004-11-07,1:02,1:02,@,PIT,9,8,Sun,L 3-27,,5,25,4,20,9,45
7747,PHI,2004,2004-12-12,8:37,8:37,@,WAS,14,13,Sun,W 17-14,,5,41,12,137,17,178
7748,PHI,2004,2004-12-19,1:02,1:02,,DAL,15,14,Sun,W 12-7,,5,36,6,35,11,71
7749,PHI,2005,2005-11-06,8:37,8:37,@,WAS,9,8,Sun,L 10-17,,5,64,4,35,9,99
7750,PHI,2005,2006-01-01,4:16,4:16,,WAS,17,16,Sun,L 20-31,,5,45,7,60,12,105
7751,PHI,2006,2006-09-10,1:02,12:02,@,HOU,1,1,Sun,W 24-10,,5,51,3,20,8,71
7752,PHI,2006,2006-10-02,8:40,8:40,,GNB,4,4,Mon,W 31-9,,5,53,7,62,12,115
7753,PHI,2007,2007-09-23,1:02,1:02,,DET,3,3,Sun,W 56-21,,5,35,9,65,14,100
7754,PHI,2007,2007-10-21,4:14,4:14,,CHI,7,6,Sun,L 16-19,,5,32,7,51,12,83
7755,PHI,2007,2007-11-04,8:23,8:23,,DAL,9,8,Sun,L 17-38,,5,35,3,35,8,70
7756,PHI,2007,2007-11-11,1:03,1:03,@,WAS,10,9,Sun,W 33-25,,5,38,11,74,16,112
7757,PHI,2008,2008-09-15,8:40,7:40,@,DAL,2,2,Mon,L 37-41,,5,44,10,108,15,152
7758,PHI,2008,2008-11-09,8:23,8:23,,NYG,10,9,Sun,L 31-36,,5,45,4,30,9,75
7759,PHI,2009,2009-11-01,1:03,1:03,,NYG,8,7,Sun,W 40-17,,5,45,4,25,9,70
7760,PHI,2010,2010-10-10,8:30,5:30,@,SFO,5,5,Sun,W 27-24,,5,30,10,65,15,95
7761,PHI,2010,2010-12-19,1:03,1:03,@,NYG,15,14,Sun,W 38-31,,5,30,4,35,9,65
7762,PHI,2011,2011-10-02,1:03,1:03,,SFO,4,4,Sun,L 23-24,,5,55,5,40,10,95
7763,PHI,2011,2011-10-09,1:04,1:04,@,BUF,5,5,Sun,L 24-31,,5,46,4,40,9,86
7764,PHI,2011,2011-11-20,8:32,8:32,@,NYG,11,10,Sun,W 17-10,,5,30,5,39,10,69
7765,PHI,2011,2011-12-01,8:29,5:29,@,SEA,13,12,Thu,L 14-31,,5,28,5,30,10,58
7766,PHI,2011,2011-12-24,4:15,3:15,@,DAL,16,15,Sat,W 20-7,,5,47,6,47,11,94
7767,PHI,2012,2012-09-23,4:05,1:05,@,ARI,3,3,Sun,L 6-27,,5,65,5,45,10,110
7768,PHI,2012,2012-09-30,8:30,8:30,,NYG,4,4,Sun,W 19-17,,5,49,7,55,12,104
7769,PHI,2012,2012-10-07,1:02,1:02,@,PIT,5,5,Sun,L 14-16,,5,35,9,106,14,141
7770,PHI,2012,2012-11-26,8:32,8:32,,CAR,12,11,Mon,L 22-30,,5,30,6,101,11,131
7771,PHI,2013,2013-10-20,1:02,1:02,,DAL,7,7,Sun,L 3-17,,5,33,12,75,17,108
7772,PHI,2013,2013-11-10,1:02,12:02,@,GNB,10,10,Sun,W 27-13,,5,65,5,31,10,96
7773,PHI,2013,2013-12-01,1:02,1:02,,ARI,13,12,Sun,W 24-21,,5,48,6,55,11,103
7774,PHI,2014,2014-11-10,8:32,8:32,,CAR,10,9,Mon,W 45-21,,5,50,4,30,9,80
7775,PHI,2014,2014-12-28,1:02,1:02,@,NYG,17,16,Sun,W 34-26,,5,35,8,106,13,141
7776,PHI,2015,2015-09-27,1:03,1:03,@,NYJ,3,3,Sun,W 24-17,,5,21,6,53,11,74
7777,PHI,2015,2015-11-22,1:02,1:02,,TAM,11,10,Sun,L 17-45,,5,25,9,82,14,107
7778,PHI,2015,2015-12-13,1:01,1:01,,BUF,14,13,Sun,W 23-20,,5,55,15,101,20,156
7779,PHI,2015,2015-12-20,8:31,8:31,,ARI,15,14,Sun,L 17-40,,5,38,1,10,6,48
7780,PHI,2016,2016-09-19,8:30,7:30,@,CHI,2,2,Mon,W 29-14,,5,34,7,60,12,94
7781,PHI,2016,2016-10-30,8:31,7:31,@,DAL,8,7,Sun,L 23-29,OT,5,40,11,84,16,124
7782,PHI,2016,2016-12-11,1:00,1:00,,WAS,14,13,Sun,L 22-27,,5,54,5,86,10,140
7783,PHI,2017,2017-10-08,1:00,1:00,,ARI,5,5,Sun,W 34-7,,5,60,7,61,12,121
7784,PHI,2017,2017-11-05,1:00,1:00,,DEN,9,9,Sun,W 51-23,,5,35,14,105,19,140
7785,PHI,2018,2018-12-03,8:15,8:15,,WAS,13,12,Mon,W 28-13,,5,38,10,69,15,107
7786,PHI,2018,2018-12-09,4:25,3:25,@,DAL,14,13,Sun,L 23-29,OT,5,49,11,110,16,159
7787,PHI,2018,2018-12-30,4:25,1:00,@,WAS,17,16,Sun,W 24-0,,5,25,2,15,7,40
7788,PHI,2019,2019-10-20,8:20,7:20,@,DAL,7,7,Sun,L 10-37,,5,40,6,65,11,105
7789,PHI,2020,2020-09-20,1:00,1:00,,LAR,2,2,Sun,L 19-37,,5,30,4,24,9,54
7790,PHI,2020,2020-11-22,1:00,1:00,@,CLE,11,10,Sun,L 17-22,,5,33,3,53,8,86
7791,PIT,2000,2000-09-24,1:01,1:01,,TEN,4,3,Sun,L 20-23,,5,35,3,25,8,60
7792,PIT,2000,2000-10-22,4:05,4:05,,CLE,8,7,Sun,W 22-0,,5,47,8,77,13,124
7793,PIT,2000,2000-12-10,1:03,1:03,@,NYG,15,14,Sun,L 10-30,,5,42,6,91,11,133
7794,PIT,2002,2002-11-24,1:01,1:01,,CIN,12,11,Sun,W 29-21,,5,40,9,110,14,150
7795,PIT,2002,2002-12-23,9:05,9:05,@,TAM,16,15,Mon,W 17-7,,5,45,5,39,10,84
7796,PIT,2002,2002-12-29,1:02,1:02,,BAL,17,16,Sun,W 34-31,,5,41,9,82,14,123
7797,PIT,2003,2003-10-26,1:02,1:02,,STL,8,7,Sun,L 21-33,,5,37,8,45,13,82
7798,PIT,2004,2004-11-14,1:03,1:03,@,CLE,10,9,Sun,W 24-10,,5,38,3,11,8,49
7799,PIT,2005,2005-09-18,1:02,12:02,@,HOU,2,2,Sun,W 27-7,,5,40,7,58,12,98
7800,PIT,2005,2005-09-25,4:15,4:15,,NWE,3,3,Sun,L 20-23,,5,35,10,118,15,153
7801,PIT,2005,2005-10-23,1:02,1:02,@,CIN,7,6,Sun,W 27-13,,5,65,4,35,9,100
7802,PIT,2006,2006-10-15,4:15,4:15,,KAN,6,5,Sun,W 45-7,,5,41,6,50,11,91
7803,PIT,2006,2006-11-05,4:15,4:15,,DEN,9,8,Sun,L 20-31,,5,50,8,60,13,110
7804,PIT,2006,2006-11-12,4:15,4:15,,NOR,10,9,Sun,W 38-31,,5,34,3,25,8,59
7805,PIT,2006,2006-11-19,1:03,1:03,@,CLE,11,10,Sun,W 24-20,,5,50,7,57,12,107
7806,PIT,2006,2006-12-24,1:02,1:02,,BAL,16,15,Sun,L 7-31,,5,32,12,89,17,121
7807,PIT,2007,2007-11-05,8:38,8:38,,BAL,9,8,Mon,W 38-7,,5,49,11,85,16,134
7808,PIT,2007,2007-11-11,1:02,1:02,,CLE,10,9,Sun,W 31-28,,5,30,7,40,12,70
7809,PIT,2008,2008-09-29,8:40,8:40,,BAL,4,4,Mon,W 23-20,OT,5,29,8,72,13,101
7810,PIT,2008,2008-11-03,8:41,8:41,@,WAS,9,8,Mon,W 23-6,,5,46,5,78,10,124
7811,PIT,2009,2009-09-27,4:15,4:15,@,CIN,3,3,Sun,L 20-23,,5,51,4,30,9,81
7812,PIT,2009,2009-11-15,1:02,1:02,,CIN,10,9,Sun,L 12-18,,5,50,7,87,12,137
7813,PIT,2009,2009-11-29,8:30,8:30,@,BAL,12,11,Sun,L 17-20,OT,5,59,9,80,14,139
7814,PIT,2009,2010-01-03,1:02,1:02,@,MIA,17,16,Sun,W 30-24,,5,40,3,45,8,85
7815,PIT,2010,2010-09-19,1:02,12:02,@,TEN,2,2,Sun,W 19-11,,5,35,11,72,16,107
7816,PIT,2010,2010-10-24,1:02,1:02,@,MIA,7,6,Sun,W 23-22,,5,34,3,35,8,69
7817,PIT,2011,2011-10-02,1:03,12:03,@,HOU,4,4,Sun,L 10-17,,5,45,9,64,14,109
7818,PIT,2011,2011-10-09,1:02,1:02,,TEN,5,5,Sun,W 38-17,,5,51,9,70,14,121
7819,PIT,2012,2012-10-21,8:30,8:30,@,CIN,7,6,Sun,W 24-17,,5,50,2,20,7,70
7820,PIT,2012,2012-12-23,1:02,1:02,,CIN,16,15,Sun,L 10-13,,5,63,7,55,12,118
7821,PIT,2014,2014-11-30,1:02,1:02,,NOR,13,12,Sun,L 32-35,,5,28,11,77,16,105
7822,PIT,2015,2015-11-08,1:02,1:02,,OAK,9,9,Sun,W 38-35,,5,42,3,21,8,63
7823,PIT,2015,2015-11-15,1:04,1:04,,CLE,10,10,Sun,W 30-9,,5,50,12,188,17,238
7824,PIT,2015,2015-12-13,1:02,1:02,@,CIN,14,13,Sun,W 33-20,,5,82,4,27,9,109
7825,PIT,2016,2016-09-18,1:02,1:02,,CIN,2,2,Sun,W 24-16,,5,54,5,31,10,85
7826,PIT,2017,2017-10-08,1:00,1:00,,JAX,5,5,Sun,L 9-30,,5,37,4,19,9,56
7827,PIT,2017,2017-10-29,8:30,8:30,@,DET,8,8,Sun,W 20-15,,5,37,6,57,11,94
7828,PIT,2017,2017-11-26,8:30,8:30,,GNB,12,11,Sun,W 31-28,,5,45,3,27,8,72
7829,PIT,2018,2018-09-30,8:20,8:20,,BAL,4,4,Sun,L 14-26,,5,40,7,50,12,90
7830,PIT,2018,2018-11-25,4:25,2:25,@,DEN,12,11,Sun,L 17-24,,5,34,6,50,11,84
7831,PIT,2019,2019-09-15,1:00,1:00,,SEA,2,2,Sun,L 26-28,,5,78,10,93,15,171
7832,PIT,2019,2019-11-03,1:00,1:00,,IND,9,8,Sun,W 26-24,,5,70,7,89,12,159
7833,PIT,2020,2020-12-02,3:40,3:40,,BAL,12,11,Wed,W 19-14,,5,40,7,86,12,126
7834,PIT,2021,2021-09-12,1:00,1:00,@,BUF,1,1,Sun,W 23-16,,5,32,8,81,13,113
7835,PIT,2021,2021-09-19,1:00,1:00,,LVR,2,2,Sun,L 17-26,,5,43,5,40,10,83
7836,PIT,2021,2021-10-03,4:25,3:25,@,GNB,4,4,Sun,L 17-27,,5,34,3,25,8,59
7837,PIT,2021,2021-10-17,8:20,8:20,,SEA,6,6,Sun,W 23-20,OT,5,38,6,45,11,83
7838,PIT,2021,2021-11-08,8:15,8:15,,CHI,9,8,Mon,W 29-27,,5,30,12,115,17,145
7839,PIT,2021,2021-12-05,4:25,4:25,,BAL,13,12,Sun,W 20-19,,5,81,10,55,15,136
7840,PIT,2021,2021-12-19,1:00,1:00,,TEN,15,14,Sun,W 19-13,,5,30,7,68,12,98
7841,PIT,2021,2021-12-26,4:25,3:25,@,KAN,16,15,Sun,L 10-36,,5,40,5,41,10,81
7842,PIT,2021,2022-01-03,8:15,8:15,,CLE,17,16,Mon,W 26-14,,5,51,10,77,15,128
7843,OAK,2000,2000-09-10,1:00,12:00,@,IND,2,2,Sun,W 38-31,,5,35,7,41,12,76
7844,OAK,2000,2000-09-17,4:05,1:05,,DEN,3,3,Sun,L 24-33,,5,51,3,30,8,81
7845,OAK,2000,2000-09-24,4:17,1:17,,CLE,4,4,Sun,W 36-10,,5,40,8,46,13,86
7846,OAK,2000,2000-11-19,1:02,12:02,@,NOR,12,11,Sun,W 31-22,,5,32,12,93,17,125
7847,OAK,2001,2001-11-11,8:36,5:36,@,SEA,9,8,Sun,L 27-34,,5,25,3,20,8,45
7848,OAK,2001,2001-12-09,4:15,1:15,,KAN,13,12,Sun,W 28-26,,5,34,6,50,11,84
7849,OAK,2001,2001-12-15,5:15,2:15,@,SDG,14,13,Sat,W 13-6,,5,35,5,25,10,60
7850,OAK,2001,2002-01-06,4:15,1:15,,NYJ,17,16,Sun,L 22-24,,5,35,7,60,12,95
7851,OAK,2002,2002-09-08,4:17,1:17,,SEA,1,1,Sun,W 31-17,,5,45,13,105,18,150
7852,OAK,2002,2002-10-20,4:05,1:05,,SDG,7,6,Sun,L 21-27,OT,5,50,10,97,15,147
7853,OAK,2002,2002-11-11,9:09,7:09,@,DEN,10,9,Mon,W 34-10,,5,35,3,15,8,50
7854,OAK,2002,2002-12-22,4:15,1:15,,DEN,16,15,Sun,W 28-16,,5,40,7,48,12,88
7855,OAK,2003,2003-10-05,1:02,12:02,@,CHI,5,5,Sun,L 21-24,,5,45,11,97,16,142
7856,OAK,2003,2003-12-07,1:01,1:01,@,PIT,14,13,Sun,L 7-27,,5,50,9,85,14,135
7857,OAK,2003,2003-12-28,4:15,1:15,@,SDG,17,16,Sun,L 14-21,,5,38,7,50,12,88
7858,OAK,2004,2004-09-12,1:04,1:04,@,PIT,1,1,Sun,L 21-24,,5,31,3,20,8,51
7859,OAK,2004,2004-11-28,8:36,6:36,@,DEN,12,11,Sun,W 25-24,,5,38,5,31,10,69
7860,OAK,2004,2004-12-19,4:15,1:15,,TEN,15,14,Sun,W 40-35,,5,39,5,47,10,86
7861,OAK,2006,2006-10-08,4:05,1:05,@,SFO,5,4,Sun,L 20-34,,5,35,3,20,8,55
7862,OAK,2006,2006-10-29,4:15,1:15,,PIT,8,7,Sun,W 20-13,,5,45,6,70,11,115
7863,OAK,2007,2007-10-21,4:05,1:05,,KAN,7,6,Sun,L 10-12,,5,30,4,25,9,55
7864,OAK,2008,2008-10-12,1:02,12:02,@,NOR,6,5,Sun,L 3-34,,5,26,4,30,9,56
7865,OAK,2008,2008-11-30,4:15,1:15,,KAN,13,12,Sun,L 13-20,,5,39,6,57,11,96
7866,OAK,2009,2010-01-03,4:15,1:15,,BAL,17,16,Sun,L 13-21,,5,30,5,37,10,67
7867,OAK,2011,2011-10-16,4:05,1:05,,CLE,6,6,Sun,W 24-17,,5,35,5,34,10,69
7868,OAK,2012,2012-09-16,1:02,1:02,@,MIA,2,2,Sun,L 13-35,,5,42,3,21,8,63
7869,OAK,2012,2012-09-30,4:05,2:05,@,DEN,4,4,Sun,L 6-37,,5,41,4,30,9,71
7870,OAK,2012,2012-12-16,4:25,1:25,,KAN,15,14,Sun,W 15-0,,5,62,7,60,12,122
7871,OAK,2013,2013-09-15,4:25,1:25,,JAX,2,2,Sun,W 19-9,,5,30,10,70,15,100
7872,OAK,2014,2014-09-14,4:25,1:25,,HOU,2,2,Sun,L 14-30,,5,24,7,85,12,109
7873,OAK,2014,2014-11-02,4:26,1:26,@,SEA,9,8,Sun,L 24-30,,5,69,9,65,14,134
7874,OAK,2015,2015-09-13,4:25,1:25,,CIN,1,1,Sun,L 13-33,,5,32,6,50,11,82
7875,OAK,2015,2015-10-04,1:02,12:02,@,CHI,4,4,Sun,L 20-22,,5,47,7,48,12,95
7876,OAK,2017,2017-09-10,1:00,12:00,@,TEN,1,1,Sun,W 26-16,,5,49,5,49,10,98
7877,OAK,2017,2017-10-15,4:25,1:25,,LAC,6,6,Sun,L 16-17,,5,40,4,32,9,72
7878,OAK,2018,2018-10-14,1:00,6:00,,SEA,6,6,Sun,L 3-27,,5,38,8,64,13,102
7879,OAK,2019,2019-12-22,4:05,1:05,@,LAC,16,15,Sun,W 24-17,,5,47,2,15,7,62
7880,LVR,2020,2020-11-01,1:00,1:00,@,CLE,8,7,Sun,W 16-6,,5,25,7,59,12,84
7881,LVR,2021,2021-09-19,1:00,1:00,@,PIT,2,2,Sun,W 26-17,,5,40,5,43,10,83
7882,STL,2000,2000-09-04,9:07,8:07,,DEN,1,1,Mon,W 41-36,,5,56,5,27,10,83
7883,STL,2001,2001-11-18,8:35,8:35,@,NWE,10,9,Sun,W 24-17,,5,36,3,15,8,51
7884,STL,2001,2001-11-26,9:10,8:10,,TAM,11,10,Mon,L 17-24,,5,41,5,36,10,77
7885,STL,2002,2002-09-23,9:07,9:07,@,TAM,3,3,Mon,L 14-26,,5,33,8,50,13,83
7886,STL,2002,2002-12-01,4:15,4:15,@,PHI,13,12,Sun,L 3-10,,5,35,9,65,14,100
7887,STL,2002,2002-12-08,1:00,12:00,@,KAN,14,13,Sun,L 10-49,,5,40,2,15,7,55
7888,STL,2002,2002-12-30,9:07,8:07,,SFO,17,16,Mon,W 31-20,,5,33,6,48,11,81
7889,STL,2003,2003-09-07,1:05,1:05,@,NYG,1,1,Sun,L 13-23,,5,35,7,59,12,94
7890,STL,2003,2003-09-28,1:02,12:02,,ARI,4,4,Sun,W 37-13,,5,35,10,92,15,127
7891,STL,2003,2003-12-08,9:09,9:09,@,CLE,14,13,Mon,W 26-20,,5,40,4,30,9,70
7892,STL,2004,2004-10-03,8:38,5:38,@,SFO,4,4,Sun,W 24-14,,5,43,5,30,10,73
7893,STL,2004,2004-10-10,4:15,1:15,@,SEA,5,5,Sun,W 33-27,OT,5,45,5,40,10,85
7894,STL,2004,2004-12-12,4:15,4:15,@,CAR,14,13,Sun,L 7-20,,5,44,7,55,12,99
7895,STL,2006,2006-09-24,4:15,1:15,@,ARI,3,3,Sun,W 16-14,,5,25,5,52,10,77
7896,STL,2006,2006-11-26,1:02,12:02,,SFO,12,11,Sun,W 20-17,,5,35,5,34,10,69
7897,STL,2007,2007-11-11,1:02,12:02,@,NOR,10,9,Sun,W 37-29,,5,77,2,28,7,105
7898,STL,2007,2007-12-02,1:00,12:00,,ATL,13,12,Sun,W 28-16,,5,46,8,55,13,101
7899,STL,2008,2008-09-14,1:00,12:00,,NYG,2,2,Sun,L 13-41,,5,40,7,69,12,109
7900,STL,2008,2008-09-28,4:05,3:05,,BUF,4,4,Sun,L 14-31,,5,50,5,35,10,85
7901,STL,2008,2008-10-19,1:00,12:00,,DAL,7,6,Sun,W 34-14,,5,32,8,56,13,88
7902,STL,2008,2008-11-30,1:00,12:00,,MIA,13,12,Sun,L 12-16,,5,30,10,94,15,124
7903,STL,2009,2009-10-25,1:00,12:00,,IND,7,7,Sun,L 6-42,,5,73,6,51,11,124
7904,STL,2009,2009-11-01,1:03,1:03,@,DET,8,8,Sun,W 17-10,,5,27,8,67,13,94
7905,STL,2010,2010-09-12,4:15,3:15,,ARI,1,1,Sun,L 13-17,,5,40,10,72,15,112
7906,STL,2010,2010-10-03,1:00,12:00,,SEA,4,4,Sun,W 20-3,,5,41,6,49,11,90
7907,STL,2010,2010-12-26,1:00,12:00,,SFO,16,15,Sun,W 25-17,,5,41,8,87,13,128
7908,STL,2011,2011-11-20,4:05,3:05,,SEA,11,10,Sun,L 7-24,,5,50,13,100,18,150
7909,STL,2011,2011-12-04,4:15,1:15,@,SFO,13,12,Sun,L 0-26,,5,35,8,72,13,107
7910,STL,2011,2011-12-12,8:40,5:40,@,SEA,14,13,Mon,L 13-30,,5,30,9,61,14,91
7911,STL,2012,2012-11-18,1:00,12:00,,NYJ,11,10,Sun,L 13-27,,5,30,3,20,8,50
7912,STL,2013,2013-09-22,1:02,12:02,@,DAL,3,3,Sun,L 7-31,,5,41,6,72,11,113
7913,STL,2014,2014-09-14,4:05,4:05,@,TAM,2,2,Sun,W 19-17,,5,65,4,30,9,95
7914,STL,2015,2015-12-13,1:02,12:02,,DET,14,13,Sun,W 21-14,,5,48,5,45,10,93
7915,STL,2015,2015-12-17,8:25,7:25,,TAM,15,14,Thu,W 31-23,,5,35,9,56,14,91
7916,STL,2015,2015-12-27,4:26,1:26,@,SEA,16,15,Sun,W 23-17,,5,60,10,83,15,143
7917,LAR,2016,2016-12-24,4:25,1:25,,SFO,16,15,Sat,L 21-22,,5,45,11,100,16,145
7918,LAR,2017,2017-10-08,4:05,1:05,,SEA,5,5,Sun,L 10-16,,5,45,7,40,12,85
7919,LAR,2017,2017-12-24,1:00,12:00,@,TEN,16,15,Sun,W 27-23,,5,44,5,54,10,98
7920,LAR,2018,2018-09-16,4:05,1:05,,ARI,2,2,Sun,W 34-0,,5,49,9,47,14,96
7921,LAR,2018,2018-12-16,8:20,5:20,,PHI,15,14,Sun,L 23-30,,5,50,6,49,11,99
7922,LAR,2019,2019-09-08,1:00,1:00,@,CAR,1,1,Sun,W 30-27,,5,43,6,46,11,89
7923,LAR,2019,2019-10-20,1:00,1:00,@,ATL,7,7,Sun,W 37-10,,5,24,5,48,10,72
7924,LAR,2019,2019-12-15,4:25,3:25,@,DAL,15,14,Sun,L 21-44,,5,29,4,16,9,45
7925,LAR,2020,2020-09-13,8:20,5:20,,DAL,1,1,Sun,W 20-17,,5,34,7,50,12,84
7926,LAR,2020,2020-10-11,1:00,1:00,@,WAS,5,5,Sun,W 30-10,,5,60,3,40,8,100
7927,LAR,2020,2020-11-01,1:00,1:00,@,MIA,8,8,Sun,L 17-28,,5,45,3,30,8,75
7928,LAR,2020,2020-11-23,8:15,8:15,@,TAM,11,10,Mon,W 27-24,,5,65,2,7,7,72
7929,LAR,2020,2020-12-10,8:20,5:20,,NWE,14,13,Thu,W 24-3,,5,35,5,27,10,62
7930,LAR,2020,2020-12-20,4:05,1:05,,NYJ,15,14,Sun,L 20-23,,5,43,6,61,11,104
7931,LAR,2020,2020-12-27,4:25,1:25,@,SEA,16,15,Sun,L 9-20,,5,45,5,31,10,76
7932,LAR,2020,2021-01-03,4:25,1:25,,ARI,17,16,Sun,W 18-7,,5,38,6,38,11,76
7933,LAR,2021,2021-10-03,4:05,1:05,,ARI,4,4,Sun,L 20-37,,5,36,7,63,12,99
7934,LAR,2021,2021-10-07,8:20,5:20,@,SEA,5,5,Thu,W 26-17,,5,85,3,20,8,105
7935,LAR,2021,2021-11-15,8:15,5:15,@,SFO,10,10,Mon,L 10-31,,5,35,9,53,14,88
7936,LAR,2021,2021-12-13,8:15,6:15,@,ARI,14,13,Mon,W 30-23,,5,40,7,54,12,94
7937,BAL,2000,2000-10-08,8:35,8:35,@,JAX,6,6,Sun,W 15-10,,5,25,6,34,11,59
7938,BAL,2000,2000-12-24,1:02,1:02,,NYJ,17,16,Sun,W 34-20,,5,32,4,19,9,51
7939,BAL,2001,2001-10-07,1:02,1:02,,TEN,4,4,Sun,W 26-7,,5,30,9,107,14,137
7940,BAL,2001,2001-12-02,1:02,1:02,,IND,12,12,Sun,W 39-27,,5,30,6,83,11,113
7941,BAL,2002,2002-10-13,12:00,12:00,@,IND,6,5,Sun,L 20-22,,5,52,9,70,14,122
7942,BAL,2003,2003-12-21,1:03,1:03,@,CLE,16,15,Sun,W 35-0,,5,41,5,26,10,67
7943,BAL,2004,2004-10-10,8:36,8:36,@,WAS,5,5,Sun,W 17-10,,5,53,2,22,7,75
7944,BAL,2004,2004-11-14,1:02,1:02,@,NYJ,10,9,Sun,W 20-17,OT,5,39,6,55,11,94
7945,BAL,2006,2006-09-24,4:06,4:06,@,CLE,3,3,Sun,W 15-14,,5,30,2,17,7,47
7946,BAL,2006,2006-10-15,1:02,1:02,,CAR,6,6,Sun,L 21-23,,5,40,4,20,9,60
7947,BAL,2006,2006-12-31,4:16,4:16,,BUF,17,16,Sun,W 19-7,,5,24,3,19,8,43
7948,BAL,2007,2007-09-23,1:00,1:00,,ARI,3,3,Sun,W 26-23,,5,40,6,65,11,105
7949,BAL,2008,2008-09-21,4:16,4:16,,CLE,3,2,Sun,W 28-10,,5,40,9,65,14,105
7950,BAL,2008,2008-11-23,1:02,1:02,,PHI,12,11,Sun,W 36-7,,5,30,7,64,12,94
7951,BAL,2009,2009-12-13,1:02,1:02,,DET,14,13,Sun,W 48-3,,5,50,4,40,9,90
7952,BAL,2009,2010-01-03,4:15,1:15,@,OAK,17,16,Sun,W 21-13,,5,37,5,30,10,67
7953,BAL,2010,2010-09-13,7:26,7:26,@,NYJ,1,1,Mon,W 10-9,,5,38,14,125,19,163
7954,BAL,2010,2010-09-19,1:02,1:02,@,CIN,2,2,Sun,L 10-15,,5,45,9,56,14,101
7955,BAL,2010,2010-10-10,1:02,1:02,,DEN,5,5,Sun,W 31-17,,5,66,10,90,15,156
7956,BAL,2010,2010-11-07,1:02,1:02,,MIA,9,8,Sun,W 26-10,,5,40,4,23,9,63
7957,BAL,2011,2011-09-25,4:05,3:05,@,STL,3,3,Sun,W 37-7,,5,32,8,117,13,149
7958,BAL,2011,2011-10-16,4:06,4:06,,HOU,6,5,Sun,W 29-14,,5,25,5,15,10,40
7959,BAL,2011,2011-12-11,1:02,1:02,,IND,14,13,Sun,W 24-10,,5,40,3,15,8,55
7960,BAL,2011,2011-12-24,1:03,1:03,,CLE,16,15,Sat,W 20-14,,5,51,6,95,11,146
7961,BAL,2012,2012-10-07,1:02,12:02,@,KAN,5,5,Sun,W 9-6,,5,33,8,60,13,93
7962,BAL,2012,2012-10-21,1:02,12:02,@,HOU,7,7,Sun,L 13-43,,5,56,5,60,10,116
7963,BAL,2013,2013-11-17,1:02,12:02,@,CHI,11,10,Sun,L 20-23,OT,5,46,13,111,18,157
7964,BAL,2013,2013-11-24,1:02,1:02,,NYJ,12,11,Sun,W 19-3,,5,41,6,56,11,97
7965,BAL,2013,2013-12-08,1:03,1:03,,MIN,14,13,Sun,W 29-26,,5,45,6,90,11,135
7966,BAL,2014,2014-09-21,1:02,1:02,@,CLE,3,3,Sun,W 23-21,,5,32,12,94,17,126
7967,BAL,2014,2014-10-05,1:03,1:03,@,IND,5,5,Sun,L 13-20,,5,36,6,83,11,119
7968,BAL,2014,2014-11-09,1:03,1:03,,TEN,10,10,Sun,W 21-7,,5,40,9,67,14,107
7969,BAL,2015,2015-11-01,1:02,1:02,,SDG,8,8,Sun,W 29-26,,5,46,6,66,11,112
7970,BAL,2015,2015-12-06,1:03,1:03,@,MIA,13,12,Sun,L 13-15,,5,36,5,31,10,67
7971,BAL,2017,2017-10-26,8:25,8:25,,MIA,8,8,Thu,W 40-0,,5,40,7,43,12,83
7972,BAL,2017,2017-12-10,8:30,8:30,@,PIT,14,13,Sun,L 38-39,,5,35,6,101,11,136
7973,BAL,2017,2017-12-23,4:30,4:30,,IND,16,15,Sat,W 23-16,,5,25,2,19,7,44
7974,BAL,2017,2017-12-31,4:25,1:00,,CIN,17,16,Sun,L 27-31,,5,47,6,60,11,107
7975,BAL,2018,2018-10-21,4:05,4:05,,NOR,7,7,Sun,L 23-24,,5,54,6,52,11,106
7976,BAL,2018,2018-11-04,1:00,1:00,,PIT,9,9,Sun,L 16-23,,5,25,8,103,13,128
7977,BAL,2018,2018-11-18,1:00,1:00,,CIN,11,10,Sun,W 24-21,,5,31,7,58,12,89
7978,BAL,2019,2019-11-10,1:00,1:00,@,CIN,10,9,Sun,W 49-13,,5,35,1,5,6,40
7979,BAL,2020,2020-10-04,1:00,1:00,@,WAS,4,4,Sun,W 31-17,,5,30,2,20,7,50
7980,BAL,2020,2020-11-08,1:00,1:00,@,IND,9,8,Sun,W 24-10,,5,55,4,30,9,85
7981,BAL,2021,2021-09-13,8:15,5:15,@,LVR,1,1,Mon,L 27-33,OT,5,71,10,62,15,133
7982,BAL,2021,2021-10-24,1:00,1:00,,CIN,7,7,Sun,L 17-41,,5,46,1,5,6,51
7983,BAL,2021,2021-11-28,8:20,8:20,,CLE,12,11,Sun,W 16-10,,5,54,5,45,10,99
7984,SDG,2000,2000-11-26,4:15,1:15,,KAN,13,12,Sun,W 17-16,,5,43,11,90,16,133
7985,SDG,2001,2001-09-09,4:15,1:15,,WAS,1,1,Sun,W 30-3,,5,49,6,69,11,118
7986,SDG,2001,2001-10-21,1:05,1:05,,DEN,6,6,Sun,W 27-10,,5,34,8,61,13,95
7987,SDG,2001,2001-11-18,4:05,1:05,@,OAK,10,10,Sun,L 24-34,,5,47,2,25,7,72
7988,SDG,2001,2001-12-15,5:15,2:15,,OAK,14,14,Sat,L 6-13,,5,25,5,35,10,60
7989,SDG,2002,2002-10-06,4:05,2:05,@,DEN,5,5,Sun,L 9-26,,5,41,6,50,11,91
7990,SDG,2002,2002-11-17,4:05,1:05,,SFO,11,10,Sun,W 20-17,OT,5,36,8,71,13,107
7991,SDG,2002,2002-12-29,4:15,1:15,,SEA,17,16,Sun,L 28-31,OT,5,22,7,58,12,80
7992,SDG,2003,2003-11-30,4:15,1:15,,KAN,13,12,Sun,L 24-28,,5,55,6,55,11,110
7993,SDG,2004,2004-09-19,4:15,1:15,,NYJ,2,2,Sun,L 28-34,,5,44,4,22,9,66
7994,SDG,2004,2004-11-07,4:05,1:05,,NOR,9,9,Sun,W 43-17,,5,32,10,117,15,149
7995,SDG,2005,2005-10-16,4:15,1:15,@,OAK,6,6,Sun,W 27-14,,5,35,8,51,13,86
7996,SDG,2006,2006-11-19,8:21,6:21,@,DEN,11,10,Sun,W 35-27,,5,35,6,60,11,95
7997,SDG,2006,2006-11-26,4:05,1:05,,OAK,12,11,Sun,W 21-14,,5,49,8,56,13,105
7998,SDG,2006,2006-12-10,4:15,1:15,,DEN,14,13,Sun,W 48-20,,5,38,2,10,7,48
7999,SDG,2007,2007-12-16,4:15,1:15,,DET,15,14,Sun,W 51-14,,5,25,6,38,11,63
8000,SDG,2008,2008-10-19,1:02,1:02,@,BUF,7,7,Sun,L 14-23,,5,35,5,35,10,70
8001,SDG,2008,2008-11-09,4:15,1:15,,KAN,10,9,Sun,W 20-19,,5,37,3,16,8,53
8002,SDG,2008,2008-11-23,8:20,5:20,,IND,12,11,Sun,L 20-23,,5,37,3,15,8,52
8003,SDG,2009,2009-11-01,4:05,1:05,,OAK,8,7,Sun,W 24-16,,5,40,6,31,11,71
8004,SDG,2009,2009-12-13,4:15,3:15,@,DAL,14,13,Sun,W 20-17,,5,24,6,68,11,92
8005,SDG,2010,2010-09-13,10:20,9:20,@,KAN,1,1,Mon,L 14-21,,5,30,3,35,8,65
8006,SDG,2010,2010-10-03,4:15,1:15,,ARI,4,4,Sun,W 41-10,,5,44,5,34,10,78
8007,SDG,2010,2010-11-22,8:40,5:40,,DEN,11,10,Mon,W 35-14,,5,40,8,56,13,96
8008,SDG,2011,2011-12-11,4:15,1:15,,BUF,14,13,Sun,W 37-10,,5,50,1,5,6,55
8009,SDG,2012,2012-11-25,4:05,1:05,,BAL,12,11,Sun,L 13-16,OT,5,37,6,60,11,97
8010,SDG,2012,2012-12-23,1:03,1:03,@,NYJ,16,15,Sun,W 27-17,,5,53,6,40,11,93
8011,SDG,2013,2013-09-22,1:03,12:03,@,TEN,3,3,Sun,L 17-20,,5,45,11,116,16,161
8012,SDG,2013,2013-10-06,11:35,8:35,@,OAK,5,5,Sun,L 17-27,,5,30,8,85,13,115
8013,SDG,2013,2013-10-14,8:40,5:40,,IND,6,6,Mon,W 19-9,,5,25,5,28,10,53
8014,SDG,2013,2013-12-01,4:25,1:25,,CIN,13,12,Sun,L 10-17,,5,45,3,30,8,75
8015,SDG,2014,2014-10-05,4:25,1:25,,NYJ,5,5,Sun,W 31-0,,5,76,12,94,17,170
8016,SDG,2015,2015-09-13,4:05,1:05,,DET,1,1,Sun,W 33-28,,5,40,4,29,9,69
8017,SDG,2016,2016-09-11,1:05,12:05,@,KAN,1,1,Sun,L 27-33,OT,5,30,6,46,11,76
8018,SDG,2016,2016-10-02,4:25,1:25,,NOR,4,4,Sun,L 34-35,,5,46,6,34,11,80
8019,LAC,2017,2017-11-23,4:30,3:30,@,DAL,12,11,Thu,W 28-6,,5,56,7,60,12,116
8020,LAC,2017,2017-12-03,4:05,1:05,,CLE,13,12,Sun,W 19-10,,5,62,4,24,9,86
8021,LAC,2017,2017-12-10,4:05,1:05,,WAS,14,13,Sun,W 30-13,,5,40,4,48,9,88
8022,LAC,2018,2018-09-30,4:25,1:25,,SFO,4,4,Sun,W 29-27,,5,49,4,29,9,78
8023,LAC,2018,2018-12-02,8:20,1:00,@,PIT,13,12,Sun,W 33-30,,5,80,7,59,12,139
8024,LAC,2019,2019-11-03,4:25,1:25,,GNB,9,9,Sun,W 26-11,,5,45,8,45,13,90
8025,LAC,2019,2019-12-15,4:05,1:05,,MIN,15,14,Sun,L 10-39,,5,48,5,41,10,89
8026,LAC,2020,2020-11-08,4:05,1:05,,LVR,9,8,Sun,L 26-31,,5,45,2,10,7,55
8027,LAC,2020,2020-11-15,4:05,4:05,@,MIA,10,9,Sun,L 21-29,,5,31,3,15,8,46
8028,LAC,2020,2020-11-29,1:00,1:00,@,BUF,12,11,Sun,L 17-27,,5,91,9,85,14,176
8029,LAC,2020,2020-12-06,4:25,1:25,,NWE,13,12,Sun,L 0-45,,5,30,3,15,8,45
8030,LAC,2021,2021-10-31,4:05,1:05,,NWE,8,7,Sun,L 24-27,,5,40,4,30,9,70
8031,LAC,2021,2021-12-16,8:20,5:20,,KAN,15,14,Thu,L 28-34,OT,5,60,4,36,9,96
8032,LAC,2021,2021-12-26,1:00,12:00,@,HOU,16,15,Sun,L 29-41,,5,49,10,70,15,119
8033,SEA,2000,2000-09-24,4:15,1:15,@,SDG,4,4,Sun,W 20-12,,5,45,9,71,14,116
8034,SEA,2000,2000-10-15,4:05,1:05,,IND,7,7,Sun,L 24-37,,5,39,3,25,8,64
8035,SEA,2000,2000-11-05,4:15,1:15,,SDG,10,10,Sun,W 17-15,,5,34,9,53,14,87
8036,SEA,2000,2000-11-12,1:02,1:02,@,JAX,11,11,Sun,W 28-21,,5,50,7,55,12,105
8037,SEA,2000,2000-11-26,4:16,1:16,,DEN,13,12,Sun,L 31-38,,5,43,5,53,10,96
8038,SEA,2000,2000-12-03,1:05,1:05,@,ATL,14,13,Sun,W 30-10,,5,35,4,25,9,60
8039,SEA,2000,2000-12-16,4:06,1:06,,OAK,16,15,Sat,W 27-24,,5,55,7,45,12,100
8040,SEA,2001,2001-09-30,4:10,1:10,@,OAK,3,3,Sun,L 14-38,,5,50,12,89,17,139
8041,SEA,2001,2001-10-28,4:15,1:15,,MIA,7,6,Sun,L 20-24,,5,40,9,57,14,97
8042,SEA,2001,2001-12-09,8:35,6:35,@,DEN,13,12,Sun,L 7-20,,5,62,6,45,11,107
8043,SEA,2002,2002-11-03,4:15,1:15,,WAS,9,8,Sun,L 3-14,,5,52,6,68,11,120
8044,SEA,2002,2002-11-24,4:05,1:05,,KAN,12,11,Sun,W 39-32,,5,52,4,70,9,122
8045,SEA,2003,2003-10-19,4:15,1:15,,CHI,7,6,Sun,W 24-17,,5,45,6,64,11,109
8046,SEA,2003,2003-10-26,1:02,1:02,@,CIN,8,7,Sun,L 24-27,,5,30,7,60,12,90
8047,SEA,2003,2003-11-02,4:06,1:06,,PIT,9,8,Sun,W 23-16,,5,35,11,76,16,111
8048,SEA,2003,2003-11-30,4:15,1:15,,CLE,13,12,Sun,W 34-7,,5,45,4,35,9,80
8049,SEA,2004,2004-09-12,1:06,12:06,@,NOR,1,1,Sun,W 21-7,,5,45,8,68,13,113
8050,SEA,2004,2004-10-10,4:15,1:15,,STL,5,4,Sun,L 27-33,OT,5,40,5,45,10,85
8051,SEA,2004,2004-12-12,1:00,12:00,@,MIN,14,13,Sun,W 27-23,,5,79,5,42,10,121
8052,SEA,2005,2005-09-11,1:07,1:07,@,JAX,1,1,Sun,L 14-26,,5,29,6,31,11,60
8053,SEA,2005,2005-11-20,4:05,1:05,@,SFO,11,10,Sun,W 27-25,,5,75,6,34,11,109
8054,SEA,2005,2005-12-24,4:17,1:17,,IND,16,15,Sat,W 28-13,,5,30,4,30,9,60
8055,SEA,2005,2006-01-01,1:02,12:02,@,GNB,17,16,Sun,L 17-23,,5,58,7,50,12,108
8056,SEA,2006,2006-10-22,4:16,1:16,,MIN,7,6,Sun,L 13-31,,5,30,5,45,10,75
8057,SEA,2006,2006-11-19,4:05,1:05,@,SFO,11,10,Sun,L 14-20,,5,30,5,39,10,69
8058,SEA,2007,2007-12-09,4:06,1:06,,ARI,14,13,Sun,W 42-21,,5,23,7,55,12,78
8059,SEA,2008,2008-09-07,1:02,1:02,@,BUF,1,1,Sun,L 10-34,,5,30,1,14,6,44
8060,SEA,2008,2008-09-21,4:06,1:06,,STL,3,3,Sun,W 37-13,,5,55,7,51,12,106
8061,SEA,2008,2008-11-09,1:03,1:03,@,MIA,10,9,Sun,L 19-21,,5,25,4,29,9,54
8062,SEA,2008,2008-11-27,4:29,3:29,@,DAL,13,12,Thu,L 9-34,,5,46,5,38,10,84
8063,SEA,2008,2008-12-07,4:06,1:06,,NWE,14,13,Sun,L 21-24,,5,39,1,15,6,54
8064,SEA,2008,2008-12-14,1:00,12:00,@,STL,15,14,Sun,W 23-20,,5,35,6,40,11,75
8065,SEA,2008,2008-12-21,4:06,1:06,,NYJ,16,15,Sun,W 13-3,,5,28,6,45,11,73
8066,SEA,2009,2010-01-03,4:16,1:16,,TEN,17,16,Sun,L 13-17,,5,40,9,76,14,116
8067,SEA,2010,2010-09-12,4:16,1:16,,SFO,1,1,Sun,W 31-6,,5,35,8,60,13,95
8068,SEA,2010,2010-09-26,4:16,1:16,,SDG,3,3,Sun,W 27-20,,5,32,11,83,16,115
8069,SEA,2010,2010-10-17,1:02,12:02,@,CHI,6,5,Sun,W 23-20,,5,83,2,18,7,101
8070,SEA,2011,2011-12-01,8:29,5:29,,PHI,13,12,Thu,W 31-14,,5,30,5,28,10,58
8071,SEA,2012,2012-09-16,4:06,1:06,,DAL,2,2,Sun,W 27-7,,5,35,5,47,10,82
8072,SEA,2012,2012-09-30,1:00,12:00,@,STL,4,4,Sun,L 13-19,,5,55,6,37,11,92
8073,SEA,2015,2015-09-27,4:26,1:26,,CHI,3,3,Sun,W 26-0,,5,41,6,40,11,81
8074,SEA,2015,2015-10-05,8:31,5:31,,DET,4,4,Mon,W 13-10,,5,30,4,37,9,67
8075,SEA,2015,2015-11-01,4:25,3:25,@,DAL,8,8,Sun,W 13-12,,5,40,5,40,10,80
8076,SEA,2015,2015-12-20,4:06,1:06,,CLE,15,14,Sun,W 30-13,,5,30,4,40,9,70
8077,SEA,2016,2016-12-24,4:25,1:25,,ARI,16,15,Sat,L 31-34,,5,40,7,85,12,125
8078,SEA,2017,2017-12-03,8:30,5:30,,PHI,13,12,Sun,W 24-10,,5,46,7,64,12,110
8079,SEA,2018,2018-09-17,8:15,7:15,@,CHI,2,2,Mon,L 17-24,,5,37,7,55,12,92
8080,SEA,2019,2019-10-03,8:20,5:20,,LAR,5,5,Thu,W 30-29,,5,45,6,45,11,90
8081,SEA,2019,2019-12-15,1:00,1:00,@,CAR,15,14,Sun,W 30-24,,5,40,2,15,7,55
8082,SEA,2019,2019-12-29,8:20,5:20,,SFO,17,16,Sun,L 21-26,,5,29,8,57,13,86
8083,SEA,2020,2020-09-27,4:25,1:25,,DAL,3,3,Sun,W 38-31,,5,30,10,59,15,89
8084,SEA,2020,2020-12-27,4:25,1:25,,LAR,16,15,Sun,W 20-9,,5,31,5,45,10,76
8085,SEA,2021,2021-10-03,4:05,1:05,@,SFO,4,4,Sun,W 28-21,,5,27,8,78,13,105
8086,SEA,2021,2021-10-31,4:05,1:05,,JAX,8,8,Sun,W 31-7,,5,40,12,93,17,133
8087,SEA,2021,2021-11-14,4:25,3:25,@,GNB,10,9,Sun,L 0-17,,5,39,3,43,8,82
8088,SEA,2021,2022-01-02,4:25,1:25,,DET,17,16,Sun,W 51-29,,5,31,4,30,9,61
8089,SFO,2001,2001-11-11,4:15,1:15,,NOR,9,8,Sun,W 28-27,,5,55,8,65,13,120
8090,SFO,2001,2001-12-09,1:02,12:02,@,STL,13,12,Sun,L 14-27,,5,30,7,48,12,78
8091,SFO,2002,2002-09-05,8:38,8:38,@,NYG,1,1,Thu,W 16-13,,5,29,10,80,15,109
8092,SFO,2002,2002-09-22,4:15,1:15,,WAS,3,3,Sun,W 20-10,,5,50,4,35,9,85
8093,SFO,2002,2002-10-20,1:03,12:03,@,NOR,7,6,Sun,L 27-35,,5,42,4,35,9,77
8094,SFO,2003,2003-10-19,4:15,1:15,,TAM,7,7,Sun,W 24-7,,5,35,6,74,11,109
8095,SFO,2003,2003-12-07,4:05,1:05,,ARI,14,13,Sun,W 50-14,,5,54,1,13,6,67
8096,SFO,2004,2004-10-03,8:38,5:38,,STL,4,4,Sun,L 14-24,,5,30,5,43,10,73
8097,SFO,2004,2004-10-31,8:36,7:36,@,CHI,8,7,Sun,L 13-23,,5,30,8,58,13,88
8098,SFO,2004,2004-12-18,5:16,2:16,,WAS,15,14,Sat,L 16-26,,5,45,11,93,16,138
8099,SFO,2005,2005-09-11,4:15,1:15,,STL,1,1,Sun,W 28-25,,5,30,7,48,12,78
8100,SFO,2005,2005-10-23,1:03,1:03,@,WAS,7,6,Sun,L 17-52,,5,29,8,60,13,89
8101,SFO,2005,2006-01-01,4:05,1:05,,HOU,17,16,Sun,W 20-17,OT,5,32,8,74,13,106
8102,SFO,2006,2006-10-29,1:03,12:03,@,CHI,8,7,Sun,L 10-41,,5,38,5,49,10,87
8103,SFO,2006,2006-11-05,4:05,1:05,,MIN,9,8,Sun,W 9-3,,5,56,6,65,11,121
8104,SFO,2006,2006-11-12,1:03,1:03,@,DET,10,9,Sun,W 19-13,,5,51,5,40,10,91
8105,SFO,2006,2006-11-19,4:05,1:05,,SEA,11,10,Sun,W 20-14,,5,39,5,30,10,69
8106,SFO,2006,2006-11-26,1:02,12:02,@,STL,12,11,Sun,L 17-20,,5,34,5,35,10,69
8107,SFO,2008,2008-12-21,1:00,12:00,@,STL,16,15,Sun,W 17-16,,5,32,7,45,12,77
8108,SFO,2009,2009-11-08,4:15,1:15,,TEN,9,8,Sun,L 27-34,,5,25,8,58,13,83
8109,SFO,2010,2010-09-20,8:36,5:36,,NOR,2,2,Mon,L 22-25,,5,40,5,54,10,94
8110,SFO,2010,2010-12-16,8:20,5:20,@,SDG,15,14,Thu,L 7-34,,5,60,4,35,9,95
8111,SFO,2010,2011-01-02,4:15,1:15,,ARI,17,16,Sun,W 38-7,,5,25,8,43,13,68
8112,SFO,2011,2011-09-18,4:05,1:05,,DAL,2,2,Sun,L 24-27,OT,5,25,8,83,13,108
8113,SFO,2011,2011-10-02,1:03,1:03,@,PHI,4,4,Sun,W 24-23,,5,40,5,55,10,95
8114,SFO,2011,2011-10-30,4:15,1:15,,CLE,8,7,Sun,W 20-10,,5,40,5,39,10,79
8115,SFO,2011,2011-11-13,4:15,1:15,,NYG,10,9,Sun,W 27-20,,5,35,6,45,11,80
8116,SFO,2011,2011-12-11,4:05,2:05,@,ARI,14,13,Sun,L 19-21,,5,35,4,45,9,80
8117,SFO,2011,2012-01-01,1:00,12:00,@,STL,17,16,Sun,W 34-27,,5,80,6,50,11,130
8118,SFO,2012,2012-09-16,8:30,5:30,,DET,2,2,Sun,W 27-19,,5,62,8,67,13,129
8119,SFO,2012,2012-10-18,8:29,5:29,,SEA,7,7,Thu,W 13-6,,5,40,3,20,8,60
8120,SFO,2012,2012-11-19,8:40,5:40,,CHI,11,10,Mon,W 32-7,,5,50,6,55,11,105
8121,SFO,2013,2013-10-20,4:06,3:06,@,TEN,7,7,Sun,W 31-17,,5,42,10,100,15,142
8122,SFO,2013,2013-11-17,4:25,3:25,@,NOR,11,10,Sun,L 20-23,,5,45,4,48,9,93
8123,SFO,2014,2014-10-13,8:30,7:30,@,STL,6,6,Mon,W 31-17,,5,23,8,38,13,61
8124,SFO,2014,2014-11-23,4:25,1:25,,WAS,12,11,Sun,W 17-13,,5,47,7,53,12,100
8125,SFO,2015,2015-11-08,4:05,1:05,,ATL,9,9,Sun,W 17-16,,5,30,6,63,11,93
8126,SFO,2015,2015-11-22,4:27,1:27,@,SEA,11,10,Sun,L 13-29,,5,42,8,51,13,93
8127,SFO,2015,2015-12-13,1:02,1:02,@,CLE,14,13,Sun,L 10-24,,5,40,8,71,13,111
8128,SFO,2016,2016-10-02,4:25,1:25,,DAL,4,4,Sun,L 17-24,,5,32,6,45,11,77
8129,SFO,2018,2018-10-28,4:25,2:25,@,ARI,8,8,Sun,L 15-18,,5,59,9,62,14,121
8130,SFO,2018,2018-12-30,4:25,1:25,@,LAR,17,16,Sun,L 32-48,,5,41,6,57,11,98
8131,SFO,2019,2019-09-22,4:25,1:25,,PIT,3,3,Sun,W 24-20,,5,71,6,42,11,113
8132,SFO,2019,2019-11-11,8:15,5:15,,SEA,10,9,Mon,L 24-27,OT,5,40,9,75,14,115
8133,SFO,2020,2020-09-13,4:25,1:25,,ARI,1,1,Sun,L 20-24,,5,53,9,102,14,155
8134,SFO,2020,2020-09-20,1:00,1:00,@,NYJ,2,2,Sun,W 31-13,,5,59,5,65,10,124
8135,SFO,2020,2020-11-29,4:05,1:05,@,LAR,12,11,Sun,W 23-20,,5,40,3,27,8,67
8136,SFO,2020,2020-12-13,4:25,2:25,,WAS,14,13,Sun,L 15-23,,5,35,5,30,10,65
8137,SFO,2021,2021-09-19,1:00,1:00,@,PHI,2,2,Sun,W 17-11,,5,60,8,57,13,117
8138,SFO,2021,2021-11-28,4:25,1:25,,MIN,12,11,Sun,W 34-26,,5,57,5,38,10,95
8139,SFO,2021,2021-12-19,4:05,1:05,,ATL,15,14,Sun,W 31-13,,5,35,4,29,9,64
8140,SFO,2021,2021-12-23,8:20,7:20,@,TEN,16,15,Thu,L 17-20,,5,41,6,57,11,98
8141,TAM,2000,2000-09-17,1:06,1:06,@,DET,3,3,Sun,W 31-10,,5,45,10,51,15,96
8142,TAM,2000,2000-12-18,9:00,9:00,,STL,16,15,Mon,W 38-35,,5,40,2,20,7,60
8143,TAM,2001,2001-10-28,1:01,1:01,,MIN,7,6,Sun,W 41-14,,5,56,5,40,10,96
8144,TAM,2001,2001-11-11,1:03,1:03,@,DET,9,8,Sun,W 20-17,,5,44,4,30,9,74
8145,TAM,2001,2001-11-26,9:10,8:10,@,STL,11,10,Mon,W 24-17,,5,36,5,41,10,77
8146,TAM,2001,2001-12-16,1:02,12:02,@,CHI,14,13,Sun,L 3-27,,5,36,2,15,7,51
8147,TAM,2001,2001-12-23,1:01,1:01,,NOR,15,14,Sun,W 48-21,,5,40,3,23,8,63
8148,TAM,2002,2002-10-13,1:01,1:01,,CLE,6,6,Sun,W 17-3,,5,45,8,66,13,111
8149,TAM,2002,2002-11-17,4:05,4:05,,CAR,11,10,Sun,W 23-10,,5,34,2,10,7,44
8150,TAM,2002,2002-12-01,8:37,7:37,@,NOR,13,12,Sun,L 20-23,,5,40,6,57,11,97
8151,TAM,2002,2002-12-08,1:01,1:01,,ATL,14,13,Sun,W 34-10,,5,38,4,45,9,83
8152,TAM,2002,2002-12-23,9:05,9:05,,PIT,16,15,Mon,L 7-17,,5,39,5,45,10,84
8153,TAM,2003,2003-11-02,1:05,1:05,,NOR,9,8,Sun,L 14-17,,5,35,5,47,10,82
8154,TAM,2003,2003-11-24,9:10,9:10,,NYG,12,11,Mon,W 19-13,,5,45,9,71,14,116
8155,TAM,2004,2004-11-21,1:01,1:01,,SFO,11,10,Sun,W 35-3,,5,50,4,30,9,80
8156,TAM,2004,2004-12-19,4:05,4:05,,NOR,15,14,Sun,L 17-21,,5,45,8,69,13,114
8157,TAM,2005,2005-11-27,1:02,1:02,,CHI,12,11,Sun,L 10-13,,5,52,4,35,9,87
8158,TAM,2005,2005-12-04,1:05,12:05,@,NOR,13,12,Sun,W 10-3,,5,26,5,35,10,61
8159,TAM,2006,2006-11-23,4:25,3:25,@,DAL,12,11,Thu,L 10-38,,5,55,2,19,7,74
8160,TAM,2006,2006-12-03,4:15,4:15,@,PIT,13,12,Sun,L 3-20,,5,40,2,15,7,55
8161,TAM,2007,2007-09-09,4:15,1:15,@,SEA,1,1,Sun,L 6-20,,5,37,3,35,8,72
8162,TAM,2007,2007-09-23,1:02,1:02,,STL,3,3,Sun,W 24-3,,5,40,3,25,8,65
8163,TAM,2007,2007-12-16,1:03,1:03,,ATL,15,14,Sun,W 37-3,,5,44,5,48,10,92
8164,TAM,2008,2008-10-05,4:05,2:05,@,DEN,5,5,Sun,L 13-16,,5,30,6,55,11,85
8165,TAM,2008,2008-11-16,1:02,1:02,,MIN,11,10,Sun,W 19-13,,5,54,5,28,10,82
8166,TAM,2008,2008-12-08,8:36,8:36,@,CAR,14,13,Mon,L 23-38,,5,34,4,26,9,60
8167,TAM,2009,2009-09-27,1:00,1:00,,NYG,3,3,Sun,L 0-24,,5,25,5,60,10,85
8168,TAM,2009,2009-10-04,1:00,1:00,@,WAS,4,4,Sun,L 13-16,,5,40,4,40,9,80
8169,TAM,2009,2009-10-18,1:00,1:00,,CAR,6,6,Sun,L 21-28,,5,40,3,30,8,70
8170,TAM,2009,2009-12-06,1:03,1:03,@,CAR,13,12,Sun,L 6-16,,5,50,5,37,10,87
8171,TAM,2009,2010-01-03,1:03,1:03,,ATL,17,16,Sun,L 10-20,,5,51,3,15,8,66
8172,TAM,2010,2010-10-17,1:02,1:02,,NOR,6,5,Sun,L 6-31,,5,30,9,80,14,110
8173,TAM,2010,2010-11-07,1:02,1:02,@,ATL,9,8,Sun,L 21-27,,5,30,4,53,9,83
8174,TAM,2012,2012-09-16,1:03,1:03,@,NYG,2,2,Sun,L 34-41,,5,33,7,53,12,86
8175,TAM,2012,2012-11-25,1:02,1:02,,ATL,12,11,Sun,L 23-24,,5,24,2,15,7,39
8176,TAM,2014,2014-10-12,1:02,1:02,,BAL,6,6,Sun,L 17-48,,5,43,8,70,13,113
8177,TAM,2014,2014-12-07,1:02,1:02,@,DET,14,13,Sun,L 17-34,,5,50,9,122,14,172
8178,TAM,2015,2015-10-04,1:03,1:03,,CAR,4,4,Sun,L 23-37,,5,48,5,45,10,93
8179,TAM,2015,2016-01-03,4:25,4:25,@,CAR,17,16,Sun,L 10-38,,5,65,7,33,12,98
8180,TAM,2016,2016-09-18,1:05,1:05,@,ARI,2,2,Sun,L 7-40,,5,39,3,30,8,69
8181,TAM,2016,2016-10-10,8:04,8:04,@,CAR,5,5,Mon,W 17-14,,5,40,7,60,12,100
8182,TAM,2016,2017-01-01,1:00,1:00,,CAR,17,16,Sun,W 17-16,,5,30,4,45,9,75
8183,TAM,2017,2017-10-22,1:00,1:00,@,BUF,7,6,Sun,L 27-30,,5,55,4,35,9,90
8184,TAM,2018,2018-11-11,1:00,1:00,,WAS,10,9,Sun,L 3-16,,5,50,8,52,13,102
8185,TAM,2020,2020-09-20,1:00,1:00,,CAR,2,2,Sun,W 31-17,,5,37,9,77,14,114
8186,TAM,2020,2020-11-08,8:20,8:20,,NOR,9,9,Sun,L 3-38,,5,39,3,28,8,67
8187,TAM,2020,2020-12-13,1:00,1:00,,MIN,14,13,Sun,W 26-14,,5,34,5,71,10,105
8188,WAS,2001,2001-10-21,1:01,1:01,,CAR,6,6,Sun,W 17-14,OT,5,50,7,51,12,101
8189,WAS,2001,2001-11-25,1:03,1:03,@,PHI,11,10,Sun,W 13-3,,5,41,7,52,12,93
8190,WAS,2001,2001-12-02,4:15,4:15,,DAL,12,11,Sun,L 14-20,,5,36,7,45,12,81
8191,WAS,2002,2002-10-27,8:35,8:35,,IND,8,7,Sun,W 26-21,,5,30,6,40,11,70
8192,WAS,2003,2003-11-23,8:37,8:37,@,MIA,12,11,Sun,L 23-24,,5,38,7,45,12,83
8193,WAS,2004,2004-10-17,1:03,12:03,@,CHI,6,6,Sun,W 13-10,,5,39,7,65,12,104
8194,WAS,2005,2005-09-11,1:06,1:06,,CHI,1,1,Sun,W 9-7,,5,45,8,86,13,131
8195,WAS,2005,2005-10-16,1:00,12:00,@,KAN,6,5,Sun,L 21-28,,5,54,4,24,9,78
8196,WAS,2005,2005-12-11,4:05,2:05,@,ARI,14,13,Sun,W 17-13,,5,63,8,65,13,128
8197,WAS,2006,2006-10-08,1:03,1:03,@,NYG,5,5,Sun,L 3-19,,5,35,8,76,13,111
8198,WAS,2006,2006-11-05,1:02,1:02,,DAL,9,8,Sun,W 22-19,,5,41,11,153,16,194
8199,WAS,2007,2007-09-17,8:40,8:40,@,PHI,2,2,Mon,W 20-12,,5,25,2,15,7,40
8200,WAS,2007,2007-10-28,4:17,4:17,@,NWE,8,7,Sun,L 7-52,,5,40,6,40,11,80
8201,WAS,2007,2007-11-04,1:02,1:02,@,NYJ,9,8,Sun,W 23-20,OT,5,50,5,40,10,90
8202,WAS,2007,2007-12-30,4:15,4:15,,DAL,17,16,Sun,W 27-6,,5,37,5,37,10,74
8203,WAS,2008,2008-09-28,4:15,3:15,@,DAL,4,4,Sun,W 26-24,,5,30,3,15,8,45
8204,WAS,2008,2008-10-19,4:16,4:16,,CLE,7,7,Sun,W 14-11,,5,38,4,25,9,63
8205,WAS,2008,2008-11-03,8:41,8:41,,PIT,9,9,Mon,L 6-23,,5,78,5,46,10,124
8206,WAS,2009,2009-09-20,1:02,1:02,,STL,2,2,Sun,W 9-7,,5,35,6,45,11,80
8207,WAS,2009,2009-11-22,1:03,12:03,@,DAL,11,10,Sun,L 6-7,,5,27,6,35,11,62
8208,WAS,2010,2010-09-12,8:31,8:31,,DAL,1,1,Sun,W 13-7,,5,42,12,81,17,123
8209,WAS,2010,2010-10-03,4:15,4:15,@,PHI,4,4,Sun,W 17-12,,5,30,8,80,13,110
8210,WAS,2010,2010-12-05,1:02,1:02,@,NYG,13,12,Sun,L 7-31,,5,35,5,35,10,70
8211,WAS,2010,2010-12-26,1:03,1:03,@,JAX,16,15,Sun,W 20-17,OT,5,40,7,66,12,106
8212,WAS,2012,2012-11-22,4:41,3:41,@,DAL,12,11,Thu,W 38-31,,5,41,7,45,12,86
8213,WAS,2013,2013-10-20,1:05,1:05,,CHI,7,6,Sun,W 45-41,,5,47,5,30,10,77
8214,WAS,2014,2014-12-07,1:03,1:03,,STL,14,13,Sun,L 0-24,,5,51,11,98,16,149
8215,WAS,2015,2015-10-11,1:02,1:02,@,ATL,5,5,Sun,L 19-25,OT,5,51,4,62,9,113
8216,WAS,2015,2015-11-15,1:05,1:05,,NOR,10,9,Sun,W 47-14,,5,26,7,50,12,76
8217,WAS,2015,2015-12-20,1:03,1:03,,BUF,15,14,Sun,W 35-25,,5,6,8,56,13,62
8218,WAS,2016,2016-12-11,1:00,1:00,@,PHI,14,13,Sun,W 27-22,,5,86,5,54,10,140
8219,WAS,2016,2017-01-01,4:25,4:25,,NYG,17,16,Sun,L 10-19,,5,42,5,42,10,84
8220,WAS,2017,2017-10-15,1:00,1:00,,SFO,6,5,Sun,W 26-24,,5,43,7,40,12,83
8221,WAS,2017,2017-10-23,8:30,8:30,@,PHI,7,6,Mon,L 24-34,,5,55,9,55,14,110
8222,WAS,2017,2017-10-29,4:25,4:25,,DAL,8,7,Sun,L 19-33,,5,32,8,89,13,121
8223,WAS,2018,2018-10-14,1:00,1:00,,CAR,6,5,Sun,W 23-17,,5,43,8,55,13,98
8224,WAS,2018,2018-10-21,4:25,4:25,,DAL,7,6,Sun,W 20-17,,5,35,8,65,13,100
8225,WAS,2019,2019-12-15,1:00,1:00,,PHI,15,14,Sun,L 27-37,,5,60,7,54,12,114
8226,WAS,2020,2020-11-26,4:30,3:30,@,DAL,12,11,Thu,W 41-16,,5,53,5,45,10,98
8227,WAS,2020,2020-12-13,4:25,2:25,@,SFO,14,13,Sun,W 23-15,,5,30,5,35,10,65
8228,WAS,2020,2020-12-27,4:05,4:05,,CAR,16,15,Sun,L 13-20,,5,26,3,35,8,61
8229,WAS,2020,2021-01-03,8:20,8:20,@,PHI,17,16,Sun,W 20-14,,5,56,6,41,11,97
8230,WAS,2021,2021-09-26,1:00,1:00,@,BUF,3,3,Sun,L 21-43,,5,38,5,30,10,68
8231,WAS,2021,2021-10-10,1:00,1:00,,NOR,5,5,Sun,L 22-33,,5,37,6,45,11,82
8232,ATL,2000,2000-09-03,1:02,1:02,,SFO,1,1,Sun,W 36-28,,4,51,7,42,11,93
8233,ATL,2000,2000-12-03,1:05,1:05,,SEA,14,14,Sun,L 10-30,,4,25,5,35,9,60
8234,ATL,2000,2000-12-24,1:05,1:05,,KAN,17,16,Sun,W 29-13,,4,30,5,25,9,55
8235,ATL,2001,2001-10-14,1:04,1:04,,SFO,5,5,Sun,L 31-37,OT,4,30,8,70,12,100
8236,ATL,2001,2001-11-25,1:02,1:02,@,CAR,11,10,Sun,W 10-7,,4,30,6,30,10,60
8237,ATL,2002,2002-09-08,1:04,12:04,@,GNB,1,1,Sun,L 34-37,OT,4,82,3,15,7,97
8238,ATL,2002,2002-11-03,1:05,1:05,,BAL,9,8,Sun,W 20-17,,4,33,7,62,11,95
8239,ATL,2002,2002-12-08,1:01,1:01,@,TAM,14,13,Sun,L 10-34,,4,45,5,38,9,83
8240,ATL,2002,2002-12-29,1:02,1:02,@,CLE,17,16,Sun,L 16-24,,4,27,4,25,8,52
8241,ATL,2003,2003-09-07,4:19,3:19,@,DAL,1,1,Sun,W 27-13,,4,31,7,49,11,80
8242,ATL,2003,2003-12-20,1:32,1:32,@,TAM,16,15,Sat,W 30-28,,4,30,7,46,11,76
8243,ATL,2003,2003-12-28,1:03,1:03,,JAX,17,16,Sun,W 21-14,,4,35,9,48,13,83
8244,ATL,2004,2004-10-17,1:02,1:02,,SDG,6,6,Sun,W 21-20,,4,26,11,69,15,95
8245,ATL,2005,2005-10-24,9:07,9:07,,NYJ,7,7,Mon,W 27-14,,4,30,5,44,9,74
8246,ATL,2005,2005-11-06,1:03,1:03,@,MIA,9,8,Sun,W 17-10,,4,28,7,60,11,88
8247,ATL,2005,2005-12-04,1:03,1:03,@,CAR,13,12,Sun,L 6-24,,4,37,3,38,7,75
8248,ATL,2006,2006-10-15,1:04,1:04,,NYG,6,5,Sun,L 14-27,,4,40,5,45,9,85
8249,ATL,2006,2006-11-19,1:02,1:02,@,BAL,11,10,Sun,L 10-24,,4,47,7,56,11,103
8250,ATL,2006,2006-12-24,1:03,1:03,,CAR,16,15,Sun,L 3-10,,4,35,8,62,12,97
8251,ATL,2007,2007-12-10,8:40,8:40,,NOR,14,13,Mon,L 14-34,,4,40,3,20,7,60
8252,ATL,2008,2008-09-21,1:02,1:02,,KAN,3,3,Sun,W 38-14,,4,22,3,13,7,35
8253,ATL,2008,2008-11-02,4:15,1:15,@,OAK,9,8,Sun,W 24-0,,4,40,7,55,11,95
8254,ATL,2009,2009-09-13,1:05,1:05,,MIA,1,1,Sun,W 19-7,,4,35,4,27,8,62
8255,ATL,2009,2009-11-02,8:40,7:40,@,NOR,8,7,Mon,L 27-35,,4,25,7,65,11,90
8256,ATL,2009,2009-11-15,1:03,1:03,@,CAR,10,9,Sun,L 19-28,,4,26,5,48,9,74
8257,ATL,2009,2009-12-13,1:02,1:02,,NOR,14,13,Sun,L 23-26,,4,55,6,59,10,114
8258,ATL,2009,2009-12-20,1:03,1:03,@,NYJ,15,14,Sun,W 10-7,,4,25,6,65,10,90
8259,ATL,2010,2010-10-03,1:03,1:03,,SFO,4,4,Sun,W 16-14,,4,60,6,41,10,101
8260,ATL,2010,2010-11-07,1:02,1:02,,TAM,9,8,Sun,W 27-21,,4,53,5,30,9,83
8261,ATL,2010,2010-11-28,1:02,1:02,,GNB,12,11,Sun,W 20-17,,4,50,8,66,12,116
8262,ATL,2010,2010-12-19,4:06,1:06,@,SEA,15,14,Sun,W 34-18,,4,35,10,76,14,111
8263,ATL,2010,2011-01-02,1:03,1:03,,CAR,17,16,Sun,W 31-10,,4,20,10,97,14,117
8264,ATL,2011,2011-10-02,4:05,1:05,@,SEA,4,4,Sun,W 30-28,,4,35,6,40,10,75
8265,ATL,2011,2011-10-16,1:02,1:02,,CAR,6,6,Sun,W 31-17,,4,57,7,85,11,142
8266,ATL,2011,2011-11-27,1:02,1:02,,MIN,12,11,Sun,W 24-14,,4,30,6,49,10,79
8267,ATL,2011,2011-12-15,8:29,8:29,,JAX,15,14,Thu,W 41-14,,4,31,5,40,9,71
8268,ATL,2013,2013-10-07,8:40,8:40,,NYJ,5,5,Mon,L 28-30,,4,46,6,24,10,70
8269,ATL,2015,2015-10-11,1:02,1:02,,WAS,5,5,Sun,W 25-19,OT,4,62,5,51,9,113
8270,ATL,2015,2016-01-03,1:02,1:02,,NOR,17,16,Sun,L 17-20,,4,32,4,45,8,77
8271,ATL,2016,2016-09-26,8:30,7:30,@,NOR,3,3,Mon,W 45-32,,4,35,5,75,9,110
8272,ATL,2016,2016-11-27,1:00,1:00,,ARI,12,11,Sun,W 38-19,,4,23,8,60,12,83
8273,ATL,2016,2016-12-18,4:05,4:05,,SFO,15,14,Sun,W 41-13,,4,27,4,20,8,47
8274,ATL,2017,2017-10-01,1:00,1:00,,BUF,4,4,Sun,L 17-23,,4,45,9,55,13,100
8275,ATL,2017,2017-11-26,1:00,1:00,,TAM,12,11,Sun,W 34-20,,4,42,2,15,6,57
8276,ATL,2017,2017-12-07,8:25,8:25,,NOR,14,13,Thu,W 20-17,,4,35,11,87,15,122
8277,ATL,2018,2018-12-23,1:00,1:00,@,CAR,16,15,Sun,W 24-10,,4,41,10,86,14,127
8278,ATL,2019,2019-11-28,8:20,8:20,,NOR,13,12,Thu,L 18-26,,4,18,9,121,13,139
8279,ATL,2020,2020-12-13,4:25,1:25,@,LAC,14,13,Sun,L 17-20,,4,35,6,40,10,75
8280,ATL,2020,2021-01-03,1:00,1:00,@,TAM,17,16,Sun,L 27-44,,4,48,3,23,7,71
8281,ATL,2021,2021-09-26,1:00,1:00,@,NYG,3,3,Sun,W 17-14,,4,28,8,53,12,81
8282,ATL,2021,2021-10-10,9:30,2:30,,NYJ,5,5,Sun,W 27-20,,4,66,7,58,11,124
8283,ATL,2021,2021-12-19,4:05,1:05,@,SFO,15,14,Sun,L 13-31,,4,29,5,35,9,64
8284,ATL,2021,2022-01-02,1:00,1:00,@,BUF,17,16,Sun,L 15-29,,4,27,7,47,11,74
8285,BUF,2000,2000-12-03,1:02,1:02,,MIA,14,13,Sun,L 6-33,,4,30,10,86,14,116
8286,BUF,2001,2001-09-09,1:05,1:05,,NOR,1,1,Sun,L 6-24,,4,35,4,35,8,70
8287,BUF,2001,2001-11-04,1:01,1:01,,IND,8,7,Sun,L 14-30,,4,20,3,35,7,55
8288,BUF,2001,2001-11-18,1:02,1:02,,SEA,10,9,Sun,L 20-23,,4,23,7,57,11,80
8289,BUF,2001,2001-12-16,1:02,1:02,,NWE,14,13,Sun,L 9-12,OT,4,30,7,60,11,90
8290,BUF,2002,2002-10-20,1:03,1:03,@,MIA,7,7,Sun,W 23-10,,4,40,6,56,10,96
8291,BUF,2002,2002-12-08,1:02,1:02,@,NWE,14,13,Sun,L 17-27,,4,29,9,65,13,94
8292,BUF,2002,2002-12-15,1:02,1:02,,SDG,15,14,Sun,W 20-13,,4,60,9,121,13,181
8293,BUF,2004,2004-12-19,1:03,1:03,@,CIN,15,14,Sun,W 33-17,,4,37,7,62,11,99
8294,BUF,2005,2005-11-27,1:02,1:02,,CAR,12,11,Sun,L 9-13,,4,31,4,20,8,51
8295,BUF,2006,2006-09-17,1:03,1:03,@,MIA,2,2,Sun,W 16-6,,4,30,6,75,10,105
8296,BUF,2006,2006-11-26,1:02,1:02,,JAX,12,11,Sun,W 27-24,,4,55,10,108,14,163
8297,BUF,2008,2008-09-14,1:03,1:03,@,JAX,2,2,Sun,W 20-16,,4,40,5,35,9,75
8298,BUF,2008,2008-09-21,1:02,1:02,,OAK,3,3,Sun,W 24-23,,4,25,4,25,8,50
8299,BUF,2008,2008-12-14,1:02,1:02,@,NYJ,15,14,Sun,L 27-31,,4,33,3,25,7,58
8300,BUF,2008,2008-12-21,4:06,2:06,@,DEN,16,15,Sun,W 30-23,,4,26,6,62,10,88
8301,BUF,2009,2009-11-01,1:02,1:02,,HOU,8,8,Sun,L 10-31,,4,36,5,45,9,81
8302,BUF,2009,2010-01-03,1:02,1:02,,IND,17,16,Sun,W 30-7,,4,40,3,15,7,55
8303,BUF,2010,2010-09-19,1:02,12:02,@,GNB,2,2,Sun,L 7-34,,4,35,6,49,10,84
8304,BUF,2010,2010-11-07,1:02,1:02,,CHI,9,8,Sun,L 19-22,,4,33,7,45,11,78
8305,BUF,2010,2010-11-14,1:02,1:02,,DET,10,9,Sun,W 14-12,,4,30,11,60,15,90
8306,BUF,2010,2010-11-28,1:02,1:02,,PIT,12,11,Sun,L 16-19,OT,4,20,10,107,14,127
8307,BUF,2011,2011-10-02,1:03,1:03,@,CIN,4,4,Sun,L 20-23,,4,26,3,15,7,41
8308,BUF,2011,2011-10-09,1:04,1:04,,PHI,5,5,Sun,W 31-24,,4,40,5,46,9,86
8309,BUF,2012,2012-11-25,1:03,1:03,@,IND,12,11,Sun,L 13-20,,4,46,6,37,10,83
8310,BUF,2012,2012-12-16,4:05,4:05,,SEA,15,14,Sun,L 17-50,,4,20,4,32,8,52
8311,BUF,2012,2012-12-30,1:02,1:02,,NYJ,17,16,Sun,W 28-9,,4,24,4,45,8,69
8312,BUF,2013,2013-10-13,1:02,1:02,,CIN,6,6,Sun,L 24-27,OT,4,27,8,78,12,105
8313,BUF,2013,2013-11-10,1:02,1:02,@,PIT,10,10,Sun,L 10-23,,4,30,6,42,10,72
8314,BUF,2013,2013-12-22,1:02,1:02,,MIA,16,15,Sun,W 19-0,,4,31,6,37,10,68
8315,BUF,2014,2014-11-24,7:05,7:05,,NYJ,12,11,Mon,W 38-3,,4,24,9,60,13,84
8316,BUF,2015,2016-01-03,1:02,1:02,,NYJ,17,16,Sun,W 22-17,,4,45,6,41,10,86
8317,BUF,2017,2017-10-22,1:00,1:00,,TAM,7,6,Sun,W 30-27,,4,35,5,55,9,90
8318,BUF,2017,2017-12-24,1:00,1:00,@,NWE,16,15,Sun,L 16-37,,4,83,2,10,6,93
8319,BUF,2018,2018-10-07,1:00,1:00,,TEN,5,5,Sun,W 13-12,,4,30,5,40,9,70
8320,BUF,2018,2018-11-11,1:00,1:00,@,NYJ,10,10,Sun,W 41-10,,4,30,1,10,5,40
8321,BUF,2020,2020-10-19,5:00,5:00,,KAN,6,6,Mon,L 17-26,,4,39,8,68,12,107
8322,BUF,2020,2020-12-07,8:15,6:15,@,SFO,13,12,Mon,W 34-24,,4,50,7,43,11,93
8323,BUF,2021,2021-11-25,8:20,7:20,@,NOR,12,11,Thu,W 31-6,,4,35,4,24,8,59
8324,BUF,2021,2022-01-09,1:00,1:00,,NYJ,18,17,Sun,W 27-10,,4,40,4,27,8,67
8325,CAR,2000,2000-09-17,1:02,1:02,,ATL,3,3,Sun,L 10-15,,4,28,7,57,11,85
8326,CAR,2001,2001-10-14,1:02,1:02,,NOR,5,5,Sun,L 25-27,,4,19,6,55,10,74
8327,CAR,2001,2001-11-11,1:02,12:02,@,STL,9,9,Sun,L 14-48,,4,38,7,48,11,86
8328,CAR,2001,2001-12-23,1:02,1:02,,STL,15,14,Sun,L 32-38,,4,30,4,33,8,63
8329,CAR,2001,2002-01-06,1:02,1:02,,NWE,17,16,Sun,L 6-38,,4,37,6,70,10,107
8330,CAR,2002,2002-09-15,1:04,1:04,,DET,2,2,Sun,W 31-7,,4,55,11,100,15,155
8331,CAR,2002,2002-12-15,1:01,1:01,@,PIT,15,14,Sun,L 14-30,,4,35,1,5,5,40
8332,CAR,2002,2002-12-22,1:02,1:02,,CHI,16,15,Sun,W 24-14,,4,40,3,32,7,72
8333,CAR,2003,2003-09-28,4:15,4:15,,ATL,4,3,Sun,W 23-3,,4,40,9,84,13,124
8334,CAR,2003,2003-10-05,1:02,1:02,,NOR,5,4,Sun,W 19-13,,4,20,7,64,11,84
8335,CAR,2003,2003-11-02,1:02,12:02,@,HOU,9,8,Sun,L 10-14,,4,40,7,55,11,95
8336,CAR,2003,2003-11-16,1:03,1:03,,WAS,11,10,Sun,W 20-17,,4,69,0,0,4,69
8337,CAR,2003,2003-12-14,4:16,2:16,@,ARI,15,14,Sun,W 20-17,,4,35,5,50,9,85
8338,CAR,2005,2005-09-25,1:02,1:02,@,MIA,3,3,Sun,L 24-27,,4,39,13,138,17,177
8339,CAR,2005,2005-10-09,4:15,1:15,@,ARI,5,5,Sun,W 24-20,,4,30,8,55,12,85
8340,CAR,2005,2005-11-27,1:02,1:02,@,BUF,12,11,Sun,W 13-9,,4,20,4,31,8,51
8341,CAR,2006,2006-10-08,1:02,1:02,,CLE,5,5,Sun,W 20-12,,4,34,7,70,11,104
8342,CAR,2006,2006-10-15,1:02,1:02,@,BAL,6,6,Sun,W 23-21,,4,20,5,40,9,60
8343,CAR,2006,2006-11-26,1:03,1:03,@,WAS,12,11,Sun,L 13-17,,4,40,6,40,10,80
8344,CAR,2007,2007-11-18,1:02,12:02,@,GNB,11,10,Sun,L 17-31,,4,25,6,75,10,100
8345,CAR,2007,2007-12-30,1:02,1:02,@,TAM,17,16,Sun,W 31-23,,4,23,4,22,8,45
8346,CAR,2008,2008-10-12,1:02,1:02,@,TAM,6,6,Sun,L 3-27,,4,16,7,80,11,96
8347,CAR,2008,2008-11-09,4:05,1:05,@,OAK,10,9,Sun,W 17-6,,4,40,10,83,14,123
8348,CAR,2008,2008-12-08,8:36,8:36,,TAM,14,13,Mon,W 38-23,,4,26,5,34,9,60
8349,CAR,2009,2009-11-19,8:20,8:20,,MIA,11,10,Thu,L 17-24,,4,35,5,30,9,65
8350,CAR,2009,2009-12-27,1:03,1:03,@,NYG,16,15,Sun,W 41-9,,4,20,4,29,8,49
8351,CAR,2010,2010-09-19,1:03,1:03,,TAM,2,2,Sun,L 7-20,,4,48,4,30,8,78
8352,CAR,2010,2010-10-03,1:03,12:03,@,NOR,4,4,Sun,L 14-16,,4,66,4,36,8,102
8353,CAR,2010,2010-10-24,1:03,1:03,,SFO,7,6,Sun,W 23-20,,4,35,11,81,15,116
8354,CAR,2012,2012-09-16,1:03,1:03,,NOR,2,2,Sun,W 35-27,,4,34,2,23,6,57
8355,CAR,2012,2012-12-30,1:03,12:03,@,NOR,17,16,Sun,W 44-38,,4,36,5,55,9,91
8356,CAR,2013,2013-09-08,1:04,1:04,,SEA,1,1,Sun,L 7-12,,4,46,9,99,13,145
8357,CAR,2013,2013-09-22,1:03,1:03,,NYG,3,3,Sun,W 38-0,,4,32,6,45,10,77
8358,CAR,2013,2013-12-29,1:05,1:05,@,ATL,17,16,Sun,W 21-20,,4,38,5,56,9,94
8359,CAR,2014,2014-09-14,1:04,1:04,,DET,2,2,Sun,W 24-7,,4,45,5,33,9,78
8360,CAR,2014,2014-10-26,1:04,1:04,,SEA,8,8,Sun,L 9-13,,4,20,7,41,11,61
8361,CAR,2014,2014-11-10,8:32,8:32,@,PHI,10,10,Mon,L 21-45,,4,30,5,50,9,80
8362,CAR,2014,2014-11-30,1:02,12:02,@,MIN,13,12,Sun,L 13-31,,4,35,5,25,9,60
8363,CAR,2014,2014-12-14,1:03,1:03,,TAM,15,14,Sun,W 19-17,,4,25,4,29,8,54
8364,CAR,2015,2015-12-27,1:02,1:02,@,ATL,16,15,Sun,L 13-20,,4,40,3,20,7,60
8365,CAR,2016,2016-12-24,1:00,1:00,,ATL,16,15,Sat,L 16-33,,4,24,6,45,10,69
8366,CAR,2016,2017-01-01,1:00,1:00,@,TAM,17,16,Sun,L 16-17,,4,45,5,30,9,75
8367,CAR,2017,2017-10-22,1:00,12:00,@,CHI,7,7,Sun,L 3-17,,4,35,5,40,9,75
8368,CAR,2018,2018-10-07,1:00,1:00,,NYG,5,4,Sun,W 33-31,,4,22,8,62,12,84
8369,CAR,2018,2018-10-28,1:00,1:00,,BAL,8,7,Sun,W 36-21,,4,30,9,68,13,98
8370,CAR,2018,2018-12-17,8:15,8:15,,NOR,15,14,Mon,L 9-12,,4,48,9,80,13,128
8371,CAR,2020,2020-10-11,1:00,1:00,@,ATL,5,5,Sun,W 23-16,,4,25,3,40,7,65
8372,CHI,2000,2000-11-19,1:04,12:04,,TAM,12,11,Sun,W 13-10,,4,25,1,8,5,33
8373,CHI,2000,2000-12-17,4:00,1:00,@,SFO,16,15,Sun,L 0-17,,4,30,9,80,13,110
8374,CHI,2002,2002-09-08,1:04,12:04,,MIN,1,1,Sun,W 27-23,,4,33,8,52,12,85
8375,CHI,2003,2003-09-07,4:19,1:19,@,SFO,1,1,Sun,L 7-49,,4,30,4,25,8,55
8376,CHI,2003,2003-11-30,1:03,12:03,,ARI,13,12,Sun,W 28-3,,4,25,3,15,7,40
8377,CHI,2004,2004-10-03,1:05,12:05,,PHI,4,4,Sun,L 9-19,,4,36,10,73,14,109
8378,CHI,2004,2005-01-02,1:03,12:03,,GNB,17,16,Sun,L 14-31,,4,29,5,35,9,64
8379,CHI,2005,2005-11-27,1:02,1:02,@,TAM,12,11,Sun,W 13-10,,4,35,5,52,9,87
8380,CHI,2005,2005-12-04,1:05,12:05,,GNB,13,12,Sun,W 19-7,,4,61,9,70,13,131
8381,CHI,2006,2006-09-10,4:15,3:15,@,GNB,1,1,Sun,W 26-0,,4,25,5,45,9,70
8382,CHI,2006,2006-10-08,1:03,12:03,,BUF,5,5,Sun,W 40-7,,4,21,7,44,11,65
8383,CHI,2007,2007-09-09,4:15,1:15,@,SDG,1,1,Sun,L 3-14,,4,38,3,20,7,58
8384,CHI,2007,2007-10-14,1:02,12:02,,MIN,6,6,Sun,L 31-34,,4,28,2,10,6,38
8385,CHI,2008,2008-12-11,8:14,7:14,,NOR,15,14,Thu,W 27-24,OT,4,24,5,97,9,121
8386,CHI,2008,2008-12-22,8:40,7:40,,GNB,16,15,Mon,W 20-17,OT,4,35,6,50,10,85
8387,CHI,2009,2009-12-06,1:02,12:02,,STL,13,12,Sun,W 17-9,,4,35,6,85,10,120
8388,CHI,2010,2010-12-05,1:03,1:03,@,DET,13,12,Sun,W 24-20,,4,25,6,42,10,67
8389,CHI,2010,2010-12-12,4:16,3:16,,NWE,14,13,Sun,L 7-36,,4,30,4,43,8,73
8390,CHI,2011,2011-11-13,4:16,3:16,,DET,10,9,Sun,W 37-13,,4,37,4,53,8,90
8391,CHI,2011,2012-01-01,1:05,12:05,@,MIN,17,16,Sun,W 17-13,,4,20,5,38,9,58
8392,CHI,2012,2012-10-01,8:40,7:40,@,DAL,4,4,Mon,W 34-18,,4,25,2,10,6,35
8393,CHI,2013,2013-09-08,1:02,12:02,,CIN,1,1,Sun,W 24-21,,4,59,8,84,12,143
8394,CHI,2013,2013-09-15,1:03,12:03,,MIN,2,2,Sun,W 31-30,,4,35,3,25,7,60
8395,CHI,2013,2013-09-29,1:03,1:03,@,DET,4,4,Sun,L 32-40,,4,30,3,25,7,55
8396,CHI,2013,2013-11-04,8:40,7:40,@,GNB,9,8,Mon,W 27-20,,4,45,0,0,4,45
8397,CHI,2014,2014-09-07,1:00,12:00,,BUF,1,1,Sun,L 20-23,OT,4,43,9,108,13,151
8398,CHI,2015,2015-11-01,1:00,12:00,,MIN,8,7,Sun,L 20-23,,4,38,4,35,8,73
8399,CHI,2015,2015-11-15,1:00,12:00,@,STL,10,9,Sun,W 37-13,,4,44,8,57,12,101
8400,CHI,2016,2016-09-11,1:05,12:05,@,HOU,1,1,Sun,L 14-23,,4,30,6,69,10,99
8401,CHI,2016,2016-12-24,1:00,12:00,,WAS,16,15,Sat,L 21-41,,4,52,7,73,11,125
8402,CHI,2017,2017-09-10,1:00,12:00,,ATL,1,1,Sun,L 17-23,,4,40,8,73,12,113
8403,CHI,2017,2017-10-29,1:00,12:00,@,NOR,8,8,Sun,L 12-20,,4,31,7,51,11,82
8404,CHI,2017,2017-12-03,1:00,12:00,,SFO,13,12,Sun,L 14-15,,4,29,8,53,12,82
8405,CHI,2017,2017-12-24,1:00,12:00,,CLE,16,15,Sun,W 20-3,,4,25,8,60,12,85
8406,CHI,2018,2018-09-30,1:00,12:00,,TAM,4,4,Sun,W 48-10,,4,38,11,99,15,137
8407,CHI,2018,2018-12-16,1:00,12:00,,GNB,15,14,Sun,W 24-17,,4,24,7,48,11,72
8408,CHI,2018,2018-12-23,4:05,1:05,@,SFO,16,15,Sun,W 14-9,,4,30,6,45,10,75
8409,CHI,2019,2019-12-05,8:20,7:20,,DAL,14,13,Thu,W 31-24,,4,30,6,52,10,82
8410,CHI,2019,2019-12-15,1:00,12:00,@,GNB,15,14,Sun,L 13-21,,4,35,4,30,8,65
8411,CHI,2020,2020-12-20,1:00,3:00,@,MIN,15,14,Sun,W 33-27,,4,36,1,5,5,41
8412,CHI,2020,2020-12-27,1:00,1:00,@,JAX,16,15,Sun,W 41-17,,4,40,10,115,14,155
8413,CHI,2021,2021-10-24,4:25,4:25,@,TAM,7,7,Sun,L 3-38,,4,32,1,10,5,42
8414,CHI,2021,2021-10-31,1:00,12:00,,SFO,8,8,Sun,L 22-33,,4,30,7,55,11,85
8415,CIN,2000,2000-12-10,1:03,12:03,@,TEN,15,14,Sun,L 3-35,,4,34,7,39,11,73
8416,CIN,2002,2002-09-29,4:05,4:05,,TAM,4,4,Sun,L 7-35,,4,30,7,65,11,95
8417,CIN,2002,2002-10-13,1:02,1:02,,PIT,6,6,Sun,L 7-34,,4,30,7,50,11,80
8418,CIN,2002,2002-11-17,1:02,1:02,,CLE,11,10,Sun,L 20-27,,4,32,4,15,8,47
8419,CIN,2003,2003-09-07,1:06,1:06,,DEN,1,1,Sun,L 10-30,,4,25,5,58,9,83
8420,CIN,2003,2003-12-14,1:03,1:03,,SFO,15,14,Sun,W 41-38,,4,40,7,50,11,90
8421,CIN,2004,2004-11-07,1:02,1:02,,DAL,9,8,Sun,W 26-3,,4,20,7,46,11,66
8422,CIN,2004,2005-01-02,1:05,1:05,@,PHI,17,16,Sun,W 38-10,,4,35,7,50,11,85
8423,CIN,2005,2005-10-16,1:03,12:03,@,TEN,6,6,Sun,W 31-23,,4,32,5,69,9,101
8424,CIN,2005,2005-10-23,1:02,1:02,,PIT,7,7,Sun,L 13-27,,4,35,5,65,9,100
8425,CIN,2005,2005-12-04,1:02,1:02,@,PIT,13,12,Sun,W 38-31,,4,30,7,70,11,100
8426,CIN,2005,2005-12-18,4:05,4:05,@,DET,15,14,Sun,W 41-17,,4,40,4,30,8,70
8427,CIN,2006,2006-10-29,1:02,1:02,,ATL,8,7,Sun,L 27-29,,4,30,9,75,13,105
8428,CIN,2006,2006-11-05,1:02,1:02,@,BAL,9,8,Sun,L 20-26,,4,40,8,81,12,121
8429,CIN,2007,2007-11-25,1:02,1:02,,TEN,12,11,Sun,W 35-6,,4,35,6,55,10,90
8430,CIN,2007,2007-12-09,1:02,1:02,,STL,14,13,Sun,W 19-10,,4,20,4,53,8,73
8431,CIN,2007,2007-12-23,1:02,1:02,,CLE,16,15,Sun,W 19-14,,4,34,4,33,8,67
8432,CIN,2008,2008-10-12,1:02,1:02,@,NYJ,6,6,Sun,L 14-26,,4,23,4,25,8,48
8433,CIN,2008,2008-10-19,1:04,1:04,,PIT,7,7,Sun,L 10-38,,4,55,3,15,7,70
8434,CIN,2008,2008-11-16,1:03,1:03,,PHI,11,10,Sun,T 13-13,OT,4,35,8,60,12,95
8435,CIN,2008,2008-12-28,1:02,1:02,,KAN,17,16,Sun,W 16-6,,4,43,6,73,10,116
8436,CIN,2009,2009-09-13,1:02,1:02,,DEN,1,1,Sun,L 7-12,,4,27,6,39,10,66
8437,CIN,2009,2009-09-27,4:15,4:15,,PIT,3,3,Sun,W 23-20,,4,30,5,51,9,81
8438,CIN,2009,2009-10-18,1:02,1:02,,HOU,6,6,Sun,L 17-28,,4,45,7,60,11,105
8439,CIN,2010,2010-10-31,1:06,1:06,,MIA,8,7,Sun,L 14-22,,4,36,4,42,8,78
8440,CIN,2010,2010-11-14,1:02,1:02,@,IND,10,9,Sun,L 17-23,,4,38,5,45,9,83
8441,CIN,2010,2010-12-12,1:02,1:02,@,PIT,14,13,Sun,L 7-23,,4,25,9,89,13,114
8442,CIN,2010,2011-01-02,1:02,1:02,@,BAL,17,16,Sun,L 7-13,,4,49,7,45,11,94
8443,CIN,2011,2011-10-09,1:02,1:02,@,JAX,5,5,Sun,W 30-20,,4,33,2,15,6,48
8444,CIN,2011,2011-11-13,1:02,1:02,,PIT,10,9,Sun,L 17-24,,4,35,4,31,8,66
8445,CIN,2011,2012-01-01,4:16,4:16,,BAL,17,16,Sun,L 16-24,,4,35,7,59,11,94
8446,CIN,2012,2012-12-30,1:03,1:03,,BAL,17,16,Sun,W 23-17,,4,40,10,102,14,142
8447,CIN,2013,2013-10-27,4:06,4:06,,NYJ,8,8,Sun,W 49-9,,4,45,4,69,8,114
8448,CIN,2014,2014-09-07,1:02,1:02,@,BAL,1,1,Sun,W 23-16,,4,45,3,29,7,74
8449,CIN,2014,2014-10-05,8:43,8:43,@,NWE,5,4,Sun,L 17-43,,4,37,12,114,16,151
8450,CIN,2014,2014-10-19,1:02,1:02,@,IND,7,6,Sun,L 0-27,,4,20,8,57,12,77
8451,CIN,2014,2014-11-16,1:02,12:02,@,NOR,11,10,Sun,W 27-10,,4,33,5,34,9,67
8452,CIN,2015,2015-12-13,1:02,1:02,,PIT,14,13,Sun,L 20-33,,4,27,5,82,9,109
8453,CIN,2016,2016-11-20,1:00,1:00,,BUF,11,10,Sun,L 12-16,,4,25,9,75,13,100
8454,CIN,2017,2017-11-26,1:00,1:00,,CLE,12,11,Sun,W 30-16,,4,35,7,69,11,104
8455,CIN,2018,2018-09-23,1:00,1:00,@,CAR,3,3,Sun,L 21-31,,4,36,3,17,7,53
8456,CIN,2018,2018-10-28,1:00,1:00,,TAM,8,8,Sun,W 37-34,,4,46,11,75,15,121
8457,CIN,2018,2018-11-11,1:00,1:00,,NOR,10,9,Sun,L 14-51,,4,26,1,5,5,31
8458,CIN,2019,2019-10-13,1:00,1:00,@,BAL,6,6,Sun,L 17-23,,4,20,10,81,14,101
8459,CIN,2019,2019-11-17,4:25,1:25,@,OAK,11,10,Sun,L 10-17,,4,40,7,42,11,82
8460,CIN,2020,2020-09-17,8:20,8:20,@,CLE,2,2,Thu,L 30-35,,4,45,8,76,12,121
8461,CIN,2021,2021-09-19,1:00,12:00,@,CHI,2,2,Sun,L 17-20,,4,57,8,70,12,127
8462,CIN,2021,2021-10-17,1:00,1:00,@,DET,6,6,Sun,W 34-11,,4,31,9,77,13,108
8463,CIN,2021,2021-11-07,1:00,1:00,,CLE,9,9,Sun,L 16-41,,4,31,10,84,14,115
8464,CIN,2021,2022-01-09,1:00,1:00,@,CLE,18,17,Sun,L 16-21,,4,32,4,46,8,78
8465,CLE,2000,2000-09-17,1:02,1:02,,PIT,3,3,Sun,W 23-20,,4,26,4,35,8,61
8466,CLE,2000,2000-11-05,1:03,1:03,,NYG,10,10,Sun,L 3-24,,4,55,3,39,7,94
8467,CLE,2000,2000-11-12,1:03,1:03,,NWE,11,11,Sun,W 19-11,,4,25,5,40,9,65
8468,CLE,2001,2001-09-09,1:02,1:02,,SEA,1,1,Sun,L 6-9,,4,43,1,5,5,48
8469,CLE,2002,2002-09-08,1:04,1:04,,KAN,1,1,Sun,L 39-40,,4,38,9,87,13,125
8470,CLE,2002,2002-10-20,4:05,4:05,,HOU,7,7,Sun,W 34-17,,4,42,6,54,10,96
8471,CLE,2002,2002-11-17,1:02,1:02,@,CIN,11,10,Sun,W 27-20,,4,15,4,32,8,47
8472,CLE,2002,2002-11-24,1:02,12:02,@,NOR,12,11,Sun,W 24-15,,4,31,5,24,9,55
8473,CLE,2002,2002-12-29,1:02,1:02,,ATL,17,16,Sun,W 24-16,,4,25,4,27,8,52
8474,CLE,2003,2003-11-09,1:00,12:00,@,KAN,10,9,Sun,L 20-41,,4,38,5,70,9,108
8475,CLE,2003,2003-11-30,4:15,1:15,@,SEA,13,12,Sun,L 7-34,,4,35,5,45,9,80
8476,CLE,2003,2003-12-08,9:09,9:09,,STL,14,13,Mon,L 20-26,,4,30,5,40,9,70
8477,CLE,2005,2005-12-24,1:03,1:03,,PIT,16,15,Sat,L 0-41,,4,25,3,30,7,55
8478,CLE,2006,2006-09-10,1:04,1:04,,NOR,1,1,Sun,L 14-19,,4,35,6,44,10,79
8479,CLE,2006,2006-10-01,4:15,1:15,@,OAK,4,4,Sun,W 24-21,,4,37,6,47,10,84
8480,CLE,2007,2007-12-09,4:15,4:15,@,NYJ,14,13,Sun,W 24-18,,4,29,2,9,6,38
8481,CLE,2007,2007-12-23,1:02,1:02,@,CIN,16,15,Sun,L 14-19,,4,33,4,34,8,67
8482,CLE,2008,2008-10-19,4:16,4:16,@,WAS,7,6,Sun,L 11-14,,4,25,5,38,9,63
8483,CLE,2008,2008-11-30,1:02,1:02,,IND,13,12,Sun,L 6-10,,4,25,2,10,6,35
8484,CLE,2009,2009-09-20,4:15,2:15,@,DEN,2,2,Sun,L 6-27,,4,43,5,50,9,93
8485,CLE,2009,2009-10-18,1:01,1:01,@,PIT,6,6,Sun,L 14-27,,4,45,4,30,8,75
8486,CLE,2009,2009-11-29,1:02,1:02,@,CIN,12,11,Sun,L 7-16,,4,30,10,75,14,105
8487,CLE,2009,2009-12-06,4:05,4:05,,SDG,13,12,Sun,L 23-30,,4,30,1,5,5,35
8488,CLE,2010,2010-10-24,1:02,12:02,@,NOR,7,7,Sun,W 30-17,,4,30,7,98,11,128
8489,CLE,2010,2010-11-07,1:02,1:02,,NWE,9,8,Sun,W 34-14,,4,28,3,20,7,48
8490,CLE,2010,2010-11-14,1:02,1:02,,NYJ,10,9,Sun,L 20-26,OT,4,52,9,70,13,122
8491,CLE,2010,2010-12-05,1:02,1:02,@,MIA,13,12,Sun,W 13-10,,4,45,4,37,8,82
8492,CLE,2011,2011-11-06,1:03,12:03,@,HOU,9,8,Sun,L 12-30,,4,35,2,15,6,50
8493,CLE,2012,2012-10-28,1:06,1:06,,SDG,8,8,Sun,W 7-6,,4,35,3,15,7,50
8494,CLE,2012,2012-11-04,1:03,1:03,,BAL,9,9,Sun,L 15-25,,4,31,9,82,13,113
8495,CLE,2014,2014-09-14,1:03,1:03,,NOR,2,2,Sun,W 26-24,,4,30,5,39,9,69
8496,CLE,2015,2015-09-20,1:02,1:02,,TEN,2,2,Sun,W 28-14,,4,40,9,85,13,125
8497,CLE,2015,2015-11-05,8:25,8:25,@,CIN,9,9,Thu,L 10-31,,4,28,2,20,6,48
8498,CLE,2015,2015-12-20,4:06,1:06,@,SEA,15,14,Sun,L 13-30,,4,40,5,30,9,70
8499,CLE,2016,2016-09-11,1:05,1:05,@,PHI,1,1,Sun,L 10-29,,4,15,7,46,11,61
8500,CLE,2016,2016-12-18,1:00,1:00,@,BUF,15,14,Sun,L 13-33,,4,51,5,42,9,93
8501,CLE,2016,2016-12-24,1:00,1:00,,SDG,16,15,Sat,W 20-17,,4,44,9,92,13,136
8502,CLE,2017,2017-09-10,1:00,1:00,,PIT,1,1,Sun,L 18-21,,4,61,13,144,17,205
8503,CLE,2017,2017-10-01,1:00,1:00,,CIN,4,4,Sun,L 7-31,,4,28,8,66,12,94
8504,CLE,2017,2017-12-03,4:05,1:05,@,LAC,13,12,Sun,L 10-19,,4,24,5,62,9,86
8505,CLE,2018,2018-09-16,1:00,12:00,@,NOR,2,2,Sun,L 18-21,,4,43,4,53,8,96
8506,CLE,2018,2018-11-04,1:00,1:00,,KAN,9,9,Sun,L 21-37,,4,20,11,86,15,106
8507,CLE,2018,2018-12-30,4:25,1:00,@,BAL,17,16,Sun,L 24-26,,4,35,10,65,14,100
8508,CLE,2019,2019-11-10,1:00,1:00,,BUF,10,9,Sun,W 19-16,,4,70,7,40,11,110
8509,CLE,2019,2019-12-29,1:00,1:00,@,CIN,17,16,Sun,L 23-33,,4,33,3,20,7,53
8510,CLE,2020,2021-01-03,1:00,1:00,,PIT,17,16,Sun,W 24-22,,4,19,2,15,6,34
8511,CLE,2021,2021-12-12,1:00,1:00,,BAL,14,13,Sun,W 24-22,,4,42,10,129,14,171
8512,CLE,2021,2022-01-09,1:00,1:00,,CIN,18,17,Sun,W 21-16,,4,46,4,32,8,78
8513,IND,2000,2000-11-12,8:35,8:35,,NYJ,11,10,Sun,W 23-15,,4,64,6,65,10,129
8514,IND,2000,2000-12-17,4:16,4:16,@,MIA,16,15,Sun,W 20-13,,4,35,8,45,12,80
8515,IND,2001,2001-10-21,1:00,12:00,,NWE,6,5,Sun,L 17-38,,4,53,4,35,8,88
8516,IND,2001,2001-12-30,1:02,12:02,@,STL,16,15,Sun,L 17-42,,4,38,4,48,8,86
8517,IND,2002,2002-09-22,1:01,12:01,@,HOU,3,3,Sun,W 23-3,,4,45,9,67,13,112
8518,IND,2002,2002-11-24,8:36,6:36,@,DEN,12,11,Sun,W 23-20,OT,4,31,9,58,13,89
8519,IND,2003,2003-09-21,1:00,12:00,,JAX,3,3,Sun,W 23-13,,4,20,7,38,11,58
8520,IND,2003,2003-10-12,1:00,12:00,,CAR,6,6,Sun,L 20-23,OT,4,30,9,70,13,100
8521,IND,2003,2003-11-16,4:05,4:05,,NYJ,11,10,Sun,W 38-31,,4,30,8,56,12,86
8522,IND,2003,2003-11-30,1:00,1:00,,NWE,13,12,Sun,L 34-38,,4,31,6,52,10,83
8523,IND,2004,2005-01-02,4:15,2:15,@,DEN,17,16,Sun,L 14-33,,4,25,2,25,6,50
8524,IND,2005,2005-11-20,4:15,4:15,@,CIN,11,10,Sun,W 45-37,,4,30,9,85,13,115
8525,IND,2005,2005-12-24,4:17,1:17,@,SEA,16,15,Sat,L 13-28,,4,30,5,30,9,60
8526,IND,2006,2006-09-24,1:02,1:02,,JAX,3,3,Sun,W 21-14,,4,35,4,38,8,73
8527,IND,2006,2006-11-26,8:21,8:21,,PHI,12,11,Sun,W 45-21,,4,30,3,15,7,45
8528,IND,2007,2007-10-22,8:40,8:40,@,JAX,7,6,Mon,W 29-7,,4,27,2,20,6,47
8529,IND,2007,2007-11-04,4:18,4:18,,NWE,9,8,Sun,L 20-24,,4,25,10,146,14,171
8530,IND,2007,2007-11-11,8:15,5:15,@,SDG,10,9,Sun,L 21-23,,4,21,10,78,14,99
8531,IND,2009,2009-09-21,8:42,8:42,@,MIA,2,2,Mon,W 27-23,,4,20,4,20,8,40
8532,IND,2009,2009-11-08,1:02,1:02,,HOU,9,8,Sun,W 20-17,,4,40,13,103,17,143
8533,IND,2009,2009-12-13,1:02,1:02,,DEN,14,13,Sun,W 28-16,,4,20,7,65,11,85
8534,IND,2010,2010-09-26,4:16,2:16,@,DEN,3,3,Sun,W 27-13,,4,27,6,60,10,87
8535,IND,2010,2010-12-26,4:05,1:05,@,OAK,16,15,Sun,W 31-26,,4,42,10,116,14,158
8536,IND,2011,2011-09-18,1:02,1:02,,CLE,2,2,Sun,L 19-27,,4,21,3,49,7,70
8537,IND,2011,2011-10-09,1:02,1:02,,KAN,5,5,Sun,L 24-28,,4,40,5,39,9,79
8538,IND,2011,2011-12-18,1:03,1:03,,TEN,15,14,Sun,W 27-13,,4,25,7,70,11,95
8539,IND,2011,2011-12-22,8:29,8:29,,HOU,16,15,Thu,W 19-16,,4,35,11,84,15,119
8540,IND,2011,2012-01-01,1:03,1:03,@,JAX,17,16,Sun,L 13-19,,4,40,1,10,5,50
8541,IND,2012,2012-12-02,1:03,1:03,@,DET,13,12,Sun,W 35-33,,4,36,8,61,12,97
8542,IND,2012,2012-12-23,1:03,12:03,@,KAN,16,15,Sun,W 20-13,,4,48,9,75,13,123
8543,IND,2013,2013-12-15,1:02,1:02,,HOU,15,14,Sun,W 25-3,,4,36,14,114,18,150
8544,IND,2014,2014-09-15,8:31,8:31,,PHI,2,2,Mon,L 27-30,,4,70,11,90,15,160
8545,IND,2014,2014-11-03,8:31,8:31,@,NYG,9,9,Mon,W 40-24,,4,30,4,30,8,60
8546,IND,2014,2014-11-16,8:31,8:31,,NWE,11,10,Sun,L 20-42,,4,27,5,53,9,80
8547,IND,2014,2014-12-28,1:02,12:02,@,TEN,17,16,Sun,W 27-10,,4,20,4,20,8,40
8548,IND,2015,2015-10-04,1:02,1:02,,JAX,4,4,Sun,W 16-13,OT,4,45,13,92,17,137
8549,IND,2015,2015-11-08,4:25,4:25,,DEN,9,9,Sun,W 27-24,,4,30,8,56,12,86
8550,IND,2016,2016-11-06,4:25,3:25,@,GNB,9,9,Sun,W 31-26,,4,35,4,25,8,60
8551,IND,2016,2016-12-24,4:05,1:05,@,OAK,16,15,Sat,L 25-33,,4,22,10,93,14,115
8552,IND,2016,2017-01-01,1:00,1:00,,JAX,17,16,Sun,W 24-20,,4,35,8,54,12,89
8553,IND,2017,2017-09-10,4:05,1:05,@,LAR,1,1,Sun,L 9-46,,4,20,7,50,11,70
8554,IND,2017,2017-12-03,1:00,1:00,@,JAX,13,12,Sun,L 10-30,,4,31,6,55,10,86
8555,IND,2017,2017-12-14,8:25,8:25,,DEN,15,14,Thu,L 13-25,,4,39,12,80,16,119
8556,IND,2017,2017-12-31,1:00,1:00,,HOU,17,16,Sun,W 22-13,,4,20,7,34,11,54
8557,IND,2018,2018-10-04,8:20,8:20,@,NWE,5,5,Thu,L 24-38,,4,35,7,50,11,85
8558,IND,2018,2018-10-21,1:00,1:00,,BUF,7,7,Sun,W 37-5,,4,35,7,59,11,94
8559,IND,2019,2019-09-22,1:00,1:00,,ATL,3,3,Sun,W 27-24,,4,39,16,128,20,167
8560,IND,2019,2019-12-29,4:25,4:25,@,JAX,17,16,Sun,L 20-38,,4,36,3,27,7,63
8561,IND,2020,2020-09-27,4:05,4:05,,NYJ,3,3,Sun,W 36-7,,4,40,7,57,11,97
8562,IND,2020,2020-11-08,1:00,1:00,,BAL,9,8,Sun,L 10-24,,4,30,5,55,9,85
8563,IND,2020,2020-12-20,1:00,1:00,,HOU,15,14,Sun,W 27-20,,4,35,5,24,9,59
8564,IND,2021,2021-09-26,1:00,12:00,@,TEN,3,3,Sun,L 16-25,,4,66,4,24,8,90
8565,IND,2021,2022-01-09,1:00,1:00,@,JAX,18,17,Sun,L 11-26,,4,52,6,49,10,101
8566,ARI,2000,2000-10-01,4:15,1:15,@,SFO,5,4,Sun,L 20-27,,4,40,6,40,10,80
8567,ARI,2000,2000-10-29,4:05,2:05,,NOR,9,8,Sun,L 10-21,,4,27,5,55,9,82
8568,ARI,2000,2000-12-10,1:02,1:02,@,JAX,15,14,Sun,L 10-44,,4,53,2,15,6,68
8569,ARI,2001,2001-11-11,4:17,2:17,,NYG,9,8,Sun,L 10-17,,4,24,4,36,8,60
8570,ARI,2001,2001-12-02,4:15,1:15,@,OAK,12,11,Sun,W 34-31,OT,4,30,8,76,12,106
8571,ARI,2003,2003-09-14,4:06,1:06,,SEA,2,2,Sun,L 0-38,,4,40,8,64,12,104
8572,ARI,2004,2004-12-26,4:16,1:16,@,SEA,16,15,Sun,L 21-24,,4,25,6,51,10,76
8573,ARI,2005,2005-10-02,8:36,7:36,,SFO,4,4,Sun,W 31-14,,4,37,8,52,12,89
8574,ARI,2006,2006-10-01,1:03,1:03,@,ATL,4,4,Sun,L 10-32,,4,19,5,40,9,59
8575,ARI,2006,2006-10-22,4:15,1:15,@,OAK,7,7,Sun,L 9-22,,4,25,8,70,12,95
8576,ARI,2006,2006-11-19,4:05,2:05,,DET,11,10,Sun,W 17-10,,4,34,4,28,8,62
8577,ARI,2007,2007-12-23,4:05,2:05,,ATL,16,15,Sun,W 30-27,OT,4,57,10,74,14,131
8578,ARI,2008,2008-09-07,4:16,1:16,@,SFO,1,1,Sun,W 23-13,,4,40,3,20,7,60
8579,ARI,2008,2008-10-05,4:16,1:16,,BUF,5,5,Sun,W 41-17,,4,20,6,36,10,56
8580,ARI,2009,2009-11-29,4:15,3:15,@,TEN,12,11,Sun,L 17-20,,4,25,6,38,10,63
8581,ARI,2010,2010-12-19,1:04,1:04,@,CAR,15,14,Sun,L 12-19,,4,39,6,58,10,97
8582,ARI,2011,2011-11-27,1:00,12:00,@,STL,12,11,Sun,W 23-20,,4,30,8,49,12,79
8583,ARI,2011,2011-12-11,4:05,2:05,,SFO,14,13,Sun,W 21-19,,4,45,5,35,9,80
8584,ARI,2012,2012-12-02,1:03,1:03,@,NYJ,13,12,Sun,L 6-7,,4,30,3,20,7,50
8585,ARI,2012,2012-12-23,4:25,2:25,,CHI,16,15,Sun,L 13-28,,4,25,2,12,6,37
8586,ARI,2014,2014-11-16,4:25,2:25,,DET,11,10,Sun,W 14-6,,4,35,9,80,13,115
8587,ARI,2015,2015-09-27,4:05,1:05,,SFO,3,3,Sun,W 47-7,,4,24,6,45,10,69
8588,ARI,2015,2015-10-26,8:30,5:30,,BAL,7,7,Mon,W 26-18,,4,40,9,64,13,104
8589,ARI,2015,2015-12-10,8:25,6:25,,MIN,14,13,Thu,W 23-20,,4,30,3,25,7,55
8590,ARI,2016,2017-01-01,4:25,1:25,@,LAR,17,16,Sun,W 44-6,,4,51,9,61,13,112
8591,ARI,2017,2017-12-03,4:25,2:25,,LAR,13,12,Sun,L 16-32,,4,25,7,36,11,61
8592,ARI,2017,2017-12-31,4:25,1:25,@,SEA,17,16,Sun,W 26-24,,4,25,8,100,12,125
8593,ARI,2020,2020-12-13,1:00,1:00,@,NYG,14,13,Sun,W 26-7,,4,22,2,10,6,32
8594,ARI,2020,2020-12-26,4:30,2:30,,SFO,16,15,Sat,L 12-20,,4,20,4,27,8,47
8595,ARI,2021,2021-11-14,4:05,2:05,,CAR,10,10,Sun,L 10-34,,4,58,9,115,13,173
8596,DAL,2000,2000-09-18,9:01,9:01,@,WAS,3,3,Mon,W 27-21,,4,20,6,82,10,102
8597,DAL,2000,2000-10-01,1:02,1:02,@,CAR,5,5,Sun,W 16-13,OT,4,45,5,55,9,100
8598,DAL,2001,2001-09-09,12:03,12:03,,TAM,1,1,Sun,L 6-10,,4,32,6,61,10,93
8599,DAL,2001,2001-10-07,1:15,1:15,@,OAK,4,4,Sun,L 21-28,,4,29,8,70,12,99
8600,DAL,2001,2001-11-11,1:05,1:05,@,ATL,9,8,Sun,L 13-20,,4,41,2,10,6,51
8601,DAL,2002,2002-11-17,1:00,1:00,@,IND,11,10,Sun,L 3-20,,4,30,7,35,11,65
8602,DAL,2002,2002-12-08,1:02,12:02,,SFO,14,13,Sun,L 27-31,,4,35,9,69,13,104
8603,DAL,2004,2004-11-21,1:02,1:02,@,BAL,11,10,Sun,L 10-30,,4,20,4,30,8,50
8604,DAL,2005,2005-11-14,9:08,9:08,@,PHI,10,9,Mon,W 21-20,,4,31,14,95,18,126
8605,DAL,2006,2006-12-16,8:05,8:05,@,ATL,15,14,Sat,W 38-28,,4,32,8,68,12,100
8606,DAL,2006,2006-12-31,1:02,12:02,,DET,17,16,Sun,L 31-39,,4,45,7,65,11,110
8607,DAL,2007,2007-10-21,4:15,3:15,,MIN,7,7,Sun,W 24-14,,4,22,4,36,8,58
8608,DAL,2009,2009-09-13,1:03,1:03,@,TAM,1,1,Sun,W 34-21,,4,41,4,20,8,61
8609,DAL,2009,2009-09-20,8:20,7:20,,NYG,2,2,Sun,L 31-33,,4,50,4,40,8,90
8610,DAL,2009,2009-12-27,8:31,8:31,@,WAS,16,15,Sun,W 17-0,,4,21,4,33,8,54
8611,DAL,2010,2010-11-25,4:36,3:36,,NOR,12,11,Thu,L 27-30,,4,19,4,30,8,49
8612,DAL,2013,2013-12-09,8:40,7:40,@,CHI,14,13,Mon,L 28-45,,4,50,2,15,6,65
8613,DAL,2014,2014-09-14,1:03,12:03,@,TEN,2,2,Sun,W 26-10,,4,25,5,30,9,55
8614,DAL,2015,2016-01-03,1:03,12:03,,WAS,17,16,Sun,L 23-34,,4,44,3,20,7,64
8615,DAL,2016,2016-09-25,8:31,7:31,,CHI,3,3,Sun,W 31-17,,4,45,6,45,10,90
8616,DAL,2016,2016-11-06,1:00,1:00,@,CLE,9,8,Sun,W 35-10,,4,38,5,33,9,71
8617,DAL,2017,2017-10-01,1:00,12:00,,LAR,4,4,Sun,L 30-35,,4,45,7,41,11,86
8618,DAL,2018,2018-11-22,4:30,3:30,,WAS,12,11,Thu,W 31-23,,4,30,4,25,8,55
8619,DAL,2019,2019-12-15,4:25,3:25,,LAR,15,14,Sun,W 44-21,,4,16,5,29,9,45
8620,DAL,2020,2020-11-22,4:25,6:25,@,MIN,11,10,Sun,W 31-28,,4,30,8,80,12,110
8621,DAL,2021,2021-09-27,8:15,7:15,,PHI,3,3,Mon,W 41-21,,4,37,13,86,17,123
8622,DEN,2000,2000-12-03,1:02,12:02,@,NOR,14,13,Sun,W 38-23,,4,21,6,45,10,66
8623,DEN,2001,2001-09-23,8:37,5:37,@,ARI,2,2,Sun,W 38-17,,4,32,6,79,10,111
8624,DEN,2001,2001-09-30,4:15,2:15,,BAL,3,3,Sun,L 13-20,,4,52,7,74,11,126
8625,DEN,2001,2001-11-11,4:05,2:05,,SDG,9,9,Sun,W 26-16,,4,20,3,16,7,36
8626,DEN,2003,2003-11-03,9:09,7:09,,NWE,9,9,Mon,L 26-30,,4,30,14,85,18,115
8627,DEN,2003,2003-12-07,4:15,2:15,,KAN,14,13,Sun,W 45-27,,4,23,5,44,9,67
8628,DEN,2003,2003-12-28,4:15,3:15,@,GNB,17,16,Sun,L 3-31,,4,30,4,29,8,59
8629,DEN,2004,2004-09-12,8:39,6:39,,KAN,1,1,Sun,W 34-24,,4,35,9,70,13,105
8630,DEN,2004,2004-10-10,4:15,2:15,,CAR,5,5,Sun,W 20-17,,4,37,9,88,13,125
8631,DEN,2004,2004-11-07,4:15,2:15,,HOU,9,9,Sun,W 31-13,,4,50,9,109,13,159
8632,DEN,2005,2005-09-26,9:07,7:07,,KAN,3,3,Mon,W 30-10,,4,30,13,118,17,148
8633,DEN,2005,2005-11-13,4:05,1:05,@,OAK,10,9,Sun,W 31-17,,4,30,9,58,13,88
8634,DEN,2005,2005-12-11,4:15,2:15,,BAL,14,13,Sun,W 12-10,,4,31,3,20,7,51
8635,DEN,2005,2005-12-31,4:35,1:35,@,SDG,17,16,Sat,W 23-7,,4,22,8,70,12,92
8636,DEN,2006,2006-09-10,1:02,12:02,@,STL,1,1,Sun,L 10-18,,4,30,10,94,14,124
8637,DEN,2006,2006-11-12,4:05,1:05,@,OAK,10,9,Sun,W 17-13,,4,15,3,25,7,40
8638,DEN,2007,2007-09-30,4:15,4:15,@,IND,4,4,Sun,L 20-38,,4,32,2,10,6,42
8639,DEN,2007,2007-12-09,4:15,2:15,,KAN,14,13,Sun,W 41-7,,4,35,7,34,11,69
8640,DEN,2007,2007-12-24,8:10,5:10,@,SDG,16,15,Mon,L 3-23,,4,40,6,42,10,82
8641,DEN,2008,2008-10-12,4:05,2:05,,JAX,6,6,Sun,L 17-24,,4,52,6,45,10,97
8642,DEN,2008,2008-11-23,4:05,2:05,,OAK,12,11,Sun,L 10-31,,4,39,10,90,14,129
8643,DEN,2008,2008-12-28,8:23,5:23,@,SDG,17,16,Sun,L 21-52,,4,79,6,67,10,146
8644,DEN,2009,2009-10-19,8:40,5:40,@,SDG,6,6,Mon,W 34-23,,4,48,4,44,8,92
8645,DEN,2009,2009-11-15,1:02,1:02,@,WAS,10,9,Sun,L 17-27,,4,45,2,19,6,64
8646,DEN,2010,2010-12-05,1:03,12:03,@,KAN,13,12,Sun,L 6-10,,4,35,8,60,12,95
8647,DEN,2010,2010-12-26,4:06,2:06,,HOU,16,15,Sun,W 24-23,,4,27,3,24,7,51
8648,DEN,2011,2011-10-09,4:16,2:16,,SDG,5,5,Sun,L 24-29,,4,53,0,0,4,53
8649,DEN,2011,2011-12-11,4:05,2:05,,CHI,14,13,Sun,W 13-10,OT,4,29,8,69,12,98
8650,DEN,2012,2012-09-30,4:05,2:05,,OAK,4,4,Sun,W 37-6,,4,30,5,41,9,71
8651,DEN,2012,2012-10-07,4:25,4:25,@,NWE,5,5,Sun,L 21-31,,4,21,6,59,10,80
8652,DEN,2012,2012-11-18,4:25,2:25,,SDG,11,10,Sun,W 30-23,,4,30,10,65,14,95
8653,DEN,2012,2012-11-25,1:03,12:03,@,KAN,12,11,Sun,W 17-9,,4,35,7,50,11,85
8654,DEN,2013,2013-10-13,4:05,2:05,,JAX,6,6,Sun,W 35-19,,4,31,7,62,11,93
8655,DEN,2014,2014-09-21,4:25,1:25,@,SEA,3,3,Sun,L 20-26,OT,4,27,7,34,11,61
8656,DEN,2015,2015-12-13,4:05,2:05,,OAK,14,13,Sun,L 12-15,,4,27,10,70,14,97
8657,DEN,2016,2016-09-08,8:40,6:40,,CAR,1,1,Thu,W 21-20,,4,22,8,85,12,107
8658,DEN,2016,2016-12-04,1:00,1:00,@,JAX,13,12,Sun,W 20-10,,4,32,6,65,10,97
8659,DEN,2017,2017-12-31,4:25,2:25,,KAN,17,16,Sun,L 24-27,,4,30,4,40,8,70
8660,DEN,2019,2019-10-17,8:20,6:20,,KAN,7,7,Thu,L 6-30,,4,33,6,46,10,79
8661,DEN,2020,2020-09-20,1:00,1:00,@,PIT,2,2,Sun,L 21-26,,4,30,10,89,14,119
8662,DEN,2020,2020-09-27,4:25,2:25,,TAM,3,3,Sun,L 10-28,,4,30,9,71,13,101
8663,DEN,2020,2020-12-06,8:20,7:20,@,KAN,13,12,Sun,L 16-22,,4,31,5,44,9,75
8664,DEN,2020,2021-01-03,4:25,2:25,,LVR,17,16,Sun,L 31-32,,4,28,14,111,18,139
8665,DEN,2021,2021-10-03,4:25,2:25,,BAL,4,4,Sun,L 7-23,,4,25,6,55,10,80
8666,DEN,2021,2021-10-31,4:25,2:25,,WAS,8,8,Sun,W 17-10,,4,35,4,29,8,64
8667,DEN,2021,2021-11-14,4:25,2:25,,PHI,10,10,Sun,L 13-30,,4,29,7,89,11,118
8668,DET,2000,2000-12-17,1:02,1:02,@,NYJ,16,15,Sun,W 10-7,,4,25,7,45,11,70
8669,DET,2001,2001-09-09,12:02,12:02,@,GNB,1,1,Sun,L 6-28,,4,57,4,35,8,92
8670,DET,2001,2001-11-11,1:03,1:03,,TAM,9,8,Sun,L 17-20,,4,30,5,44,9,74
8671,DET,2001,2001-12-09,1:01,1:01,@,TAM,13,12,Sun,L 12-15,,4,28,4,59,8,87
8672,DET,2002,2002-09-22,4:17,4:17,,GNB,3,3,Sun,L 31-37,,4,24,12,88,16,112
8673,DET,2004,2004-11-07,1:04,1:04,,WAS,9,8,Sun,L 10-17,,4,40,7,75,11,115
8674,DET,2004,2004-12-19,1:03,1:03,,MIN,15,14,Sun,L 27-28,,4,25,9,70,13,95
8675,DET,2005,2005-09-11,4:19,4:19,,GNB,1,1,Sun,W 17-3,,4,38,14,100,18,138
8676,DET,2005,2005-12-18,4:05,4:05,,CIN,15,14,Sun,L 17-41,,4,30,4,40,8,70
8677,DET,2006,2006-10-01,4:05,3:05,@,STL,4,4,Sun,L 34-41,,4,70,8,66,12,136
8678,DET,2006,2006-11-19,4:05,2:05,@,ARI,11,10,Sun,L 10-17,,4,28,4,34,8,62
8679,DET,2007,2007-10-07,1:02,1:02,@,WAS,5,5,Sun,L 3-34,,4,20,4,50,8,70
8680,DET,2007,2007-10-21,1:03,1:03,,TAM,7,6,Sun,W 23-16,,4,23,7,60,11,83
8681,DET,2007,2007-12-23,1:02,1:02,,KAN,16,15,Sun,W 25-20,,4,20,6,46,10,66
8682,DET,2008,2008-10-19,4:05,3:05,@,HOU,7,6,Sun,L 21-28,,4,31,5,41,9,72
8683,DET,2008,2008-11-02,1:02,12:02,@,CHI,9,8,Sun,L 23-27,,4,36,3,25,7,61
8684,DET,2008,2008-12-07,1:03,1:03,,MIN,14,13,Sun,L 16-20,,4,32,6,35,10,67
8685,DET,2009,2009-11-15,1:05,12:05,@,MIN,10,9,Sun,L 10-27,,4,40,13,91,17,131
8686,DET,2009,2009-12-13,1:02,1:02,@,BAL,14,13,Sun,L 3-48,,4,40,5,50,9,90
8687,DET,2011,2011-09-18,1:02,1:02,,KAN,2,2,Sun,W 48-3,,4,35,8,70,12,105
8688,DET,2011,2011-10-30,4:10,2:10,@,DEN,8,8,Sun,W 45-10,,4,45,5,55,9,100
8689,DET,2011,2011-11-13,4:16,3:16,@,CHI,10,9,Sun,L 13-37,,4,53,4,37,8,90
8690,DET,2012,2012-12-30,1:03,1:03,,CHI,17,16,Sun,L 24-26,,4,29,3,35,7,64
8691,DET,2013,2013-10-20,1:02,1:02,,CIN,7,7,Sun,L 24-27,,4,30,6,50,10,80
8692,DET,2015,2015-09-13,4:05,1:05,@,SDG,1,1,Sun,L 28-33,,4,29,5,40,9,69
8693,DET,2015,2015-10-05,8:31,5:31,@,SEA,4,4,Mon,L 10-13,,4,37,5,30,9,67
8694,DET,2015,2015-11-26,12:35,12:35,,PHI,12,11,Thu,W 45-14,,4,29,2,30,6,59
8695,DET,2015,2016-01-03,1:02,12:02,@,CHI,17,16,Sun,W 24-20,,4,21,1,15,5,36
8696,DET,2016,2016-09-25,1:02,12:02,@,GNB,3,3,Sun,L 27-34,,4,86,4,45,8,131
8697,DET,2016,2016-10-23,1:02,1:02,,WAS,7,7,Sun,W 20-17,,4,30,4,20,8,50
8698,DET,2016,2016-11-24,12:30,12:30,,MIN,12,11,Thu,W 16-13,,4,16,5,40,9,56
8699,DET,2018,2018-10-28,1:00,1:00,,SEA,8,7,Sun,L 14-28,,4,32,7,111,11,143
8700,DET,2018,2018-12-16,1:00,1:00,@,BUF,15,14,Sun,L 13-14,,4,81,3,20,7,101
8701,DET,2019,2019-12-08,1:00,3:00,@,MIN,14,13,Sun,L 7-20,,4,28,8,55,12,83
8702,DET,2019,2019-12-29,1:00,1:00,,GNB,17,16,Sun,L 20-23,,4,50,9,97,13,147
8703,DET,2020,2020-11-01,1:00,1:00,,IND,8,7,Sun,L 21-41,,4,76,3,19,7,95
8704,DET,2020,2020-11-22,1:00,1:00,@,CAR,11,10,Sun,L 0-20,,4,20,7,45,11,65
8705,DET,2020,2020-11-26,12:30,12:30,,HOU,12,11,Thu,L 25-41,,4,44,10,74,14,118
8706,DET,2020,2020-12-13,4:25,4:25,,GNB,14,13,Sun,L 24-31,,4,30,12,68,16,98
8707,DET,2021,2021-10-03,1:00,12:00,@,CHI,4,4,Sun,L 14-24,,4,26,7,61,11,87
8708,DET,2021,2022-01-02,4:25,1:25,@,SEA,17,16,Sun,L 29-51,,4,30,5,31,9,61
8709,GNB,2000,2000-10-01,4:15,3:15,,CHI,5,5,Sun,L 24-27,,4,35,8,65,12,100
8710,GNB,2000,2000-10-08,1:01,1:01,@,DET,6,6,Sun,L 24-31,,4,29,6,50,10,79
8711,GNB,2000,2000-11-12,4:15,4:15,@,TAM,11,10,Sun,L 15-20,,4,35,6,37,10,72
8712,GNB,2001,2001-09-09,12:02,12:02,,DET,1,1,Sun,W 28-6,,4,35,4,57,8,92
8713,GNB,2001,2001-10-07,4:15,4:15,@,TAM,4,4,Sun,L 10-14,,4,26,7,60,11,86
8714,GNB,2001,2001-12-09,1:02,12:02,,CHI,13,12,Sun,W 17-7,,4,39,2,15,6,54
8715,GNB,2001,2001-12-16,4:15,3:15,@,TEN,14,13,Sun,L 20-26,,4,30,3,24,7,54
8716,GNB,2002,2002-12-08,8:35,7:35,,MIN,14,13,Sun,W 26-22,,4,25,6,62,10,87
8717,GNB,2002,2002-12-15,4:15,1:15,@,SFO,15,14,Sun,W 20-14,,4,20,3,18,7,38
8718,GNB,2003,2003-09-21,4:06,1:06,@,ARI,3,3,Sun,L 13-20,,4,48,7,57,11,105
8719,GNB,2003,2003-09-29,9:09,8:09,@,CHI,4,4,Mon,W 38-23,,4,38,6,62,10,100
8720,GNB,2003,2003-11-10,9:08,8:08,,PHI,10,9,Mon,L 14-17,,4,33,6,40,10,73
8721,GNB,2003,2003-11-23,1:02,12:02,,SFO,12,11,Sun,W 20-10,,4,40,6,45,10,85
8722,GNB,2003,2003-12-28,4:15,3:15,,DEN,17,16,Sun,W 31-3,,4,29,4,30,8,59
8723,GNB,2004,2004-11-14,4:15,3:15,,MIN,10,9,Sun,W 34-31,,4,25,6,37,10,62
8724,GNB,2004,2004-12-24,3:00,2:00,@,MIN,16,15,Fri,W 34-31,,4,25,9,78,13,103
8725,GNB,2005,2005-11-13,4:15,4:15,@,ATL,10,9,Sun,W 33-25,,4,58,8,58,12,116
8726,GNB,2006,2006-10-08,1:02,12:02,,STL,5,5,Sun,L 20-23,,4,41,10,78,14,119
8727,GNB,2006,2006-12-03,1:02,12:02,,NYJ,13,12,Sun,L 10-38,,4,29,3,20,7,49
8728,GNB,2006,2006-12-21,8:05,7:05,,MIN,16,15,Thu,W 9-7,,4,35,10,68,14,103
8729,GNB,2007,2007-10-14,1:02,12:02,,WAS,6,6,Sun,W 17-14,,4,35,7,53,11,88
8730,GNB,2007,2007-11-11,1:02,12:02,,MIN,10,9,Sun,W 34-0,,4,35,5,51,9,86
8731,GNB,2008,2008-11-02,1:02,12:02,@,TEN,9,8,Sun,L 16-19,OT,4,41,2,15,6,56
8732,GNB,2009,2009-12-13,1:02,12:02,@,CHI,14,13,Sun,W 21-14,,4,30,13,109,17,139
8733,GNB,2009,2010-01-03,4:15,2:15,@,ARI,17,16,Sun,W 33-7,,4,19,7,76,11,95
8734,GNB,2010,2011-01-02,4:15,3:15,,CHI,17,16,Sun,W 10-3,,4,30,6,46,10,76
8735,GNB,2011,2011-12-04,4:15,4:15,@,NYG,13,12,Sun,W 38-35,,4,30,6,55,10,85
8736,GNB,2012,2012-09-13,8:29,7:29,,CHI,2,2,Thu,W 23-10,,4,54,8,65,12,119
8737,GNB,2012,2012-10-14,8:30,7:30,@,HOU,6,6,Sun,W 42-24,,4,51,7,69,11,120
8738,GNB,2013,2013-09-15,1:02,12:02,,WAS,2,2,Sun,W 38-20,,4,40,7,78,11,118
8739,GNB,2013,2013-09-22,1:03,1:03,@,CIN,3,3,Sun,L 30-34,,4,55,5,43,9,98
8740,GNB,2014,2014-10-12,1:02,1:02,@,MIA,6,6,Sun,W 27-24,,4,44,5,25,9,69
8741,GNB,2014,2014-11-16,4:25,3:25,,PHI,11,10,Sun,W 53-20,,4,52,6,53,10,105
8742,GNB,2014,2014-11-30,4:25,3:25,,NWE,13,12,Sun,W 26-21,,4,22,4,25,8,47
8743,GNB,2015,2015-11-22,4:25,3:25,@,MIN,11,10,Sun,W 30-13,,4,19,8,110,12,129
8744,GNB,2016,2016-09-25,1:02,12:02,,DET,3,3,Sun,W 34-27,,4,45,4,86,8,131
8745,GNB,2016,2016-11-06,4:25,3:25,,IND,9,8,Sun,L 26-31,,4,25,4,35,8,60
8746,GNB,2016,2016-12-04,1:00,12:00,,HOU,13,12,Sun,W 21-13,,4,30,3,12,7,42
8747,GNB,2017,2017-09-24,4:25,3:25,,CIN,3,3,Sun,W 27-24,OT,4,33,7,68,11,101
8748,GNB,2018,2018-11-25,8:20,10:20,@,MIN,12,11,Sun,L 17-24,,4,20,6,55,10,75
8749,GNB,2019,2019-10-27,8:20,7:20,@,KAN,8,8,Sun,W 31-24,,4,25,3,30,7,55
8750,GNB,2019,2019-12-15,1:00,12:00,,CHI,15,14,Sun,W 21-13,,4,30,4,35,8,65
8751,GNB,2020,2020-11-15,1:00,12:00,,JAX,10,9,Sun,W 24-20,,4,35,7,86,11,121
8752,GNB,2020,2021-01-03,4:25,3:25,@,CHI,17,16,Sun,W 35-16,,4,30,1,16,5,46
8753,GNB,2021,2021-10-24,1:00,12:00,,WAS,7,7,Sun,W 24-10,,4,36,4,50,8,86
8754,GNB,2021,2021-11-07,4:25,3:25,@,KAN,9,9,Sun,L 7-13,,4,19,6,33,10,52
8755,HOU,2003,2003-09-28,1:05,12:05,,JAX,4,4,Sun,W 24-20,,4,43,9,48,13,91
8756,HOU,2004,2004-10-03,1:02,12:02,,OAK,4,4,Sun,W 30-17,,4,25,13,75,17,100
8757,HOU,2004,2004-10-17,1:02,12:02,@,TEN,6,6,Sun,W 20-10,,4,19,4,35,8,54
8758,HOU,2005,2005-11-06,1:01,1:01,@,JAX,9,8,Sun,L 14-21,,4,30,6,45,10,75
8759,HOU,2005,2005-11-13,1:03,1:03,@,IND,10,9,Sun,L 17-31,,4,35,6,50,10,85
8760,HOU,2005,2005-11-27,1:03,12:03,,STL,12,11,Sun,L 27-33,OT,4,54,9,65,13,119
8761,HOU,2006,2006-12-17,1:02,1:02,@,NWE,15,14,Sun,L 7-40,,4,66,2,10,6,76
8762,HOU,2006,2006-12-24,1:03,12:03,,IND,16,15,Sun,W 27-24,,4,25,2,15,6,40
8763,HOU,2006,2006-12-31,1:02,12:02,,CLE,17,16,Sun,W 14-6,,4,31,5,57,9,88
8764,HOU,2007,2007-10-21,1:02,12:02,,TEN,7,7,Sun,L 36-38,,4,37,6,45,10,82
8765,HOU,2008,2008-12-07,1:02,12:02,@,GNB,14,13,Sun,W 24-21,,4,30,6,65,10,95
8766,HOU,2009,2009-12-13,1:02,12:02,,SEA,14,13,Sun,W 34-7,,4,35,7,63,11,98
8767,HOU,2009,2009-12-20,1:00,12:00,@,STL,15,14,Sun,W 16-13,,4,30,3,15,7,45
8768,HOU,2010,2010-11-07,1:02,12:02,,SDG,9,8,Sun,L 23-29,,4,31,6,62,10,93
8769,HOU,2010,2010-12-02,8:30,8:30,@,PHI,13,12,Thu,L 24-34,,4,25,11,85,15,110
8770,HOU,2011,2011-09-11,1:05,12:05,,IND,1,1,Sun,W 34-7,,4,30,6,60,10,90
8771,HOU,2011,2011-09-18,4:15,4:15,@,MIA,2,2,Sun,W 23-13,,4,76,3,20,7,96
8772,HOU,2012,2012-09-09,1:03,12:03,,MIA,1,1,Sun,W 30-10,,4,35,7,78,11,113
8773,HOU,2013,2013-10-20,4:26,3:26,@,KAN,7,7,Sun,L 16-17,,4,40,5,24,9,64
8774,HOU,2013,2013-12-22,1:02,12:02,,DEN,16,15,Sun,L 13-37,,4,57,8,67,12,124
8775,HOU,2014,2014-10-20,8:30,8:30,@,PIT,7,7,Mon,L 23-30,,4,20,6,38,10,58
8776,HOU,2014,2014-10-26,1:03,12:03,@,TEN,8,8,Sun,W 30-16,,4,35,6,61,10,96
8777,HOU,2015,2015-12-13,8:31,7:31,,NWE,14,13,Sun,L 6-27,,4,36,6,46,10,82
8778,HOU,2015,2015-12-27,1:02,12:02,@,TEN,16,15,Sun,W 34-6,,4,28,4,43,8,71
8779,HOU,2016,2016-10-09,1:05,12:05,@,MIN,5,5,Sun,L 13-31,,4,15,9,97,13,112
8780,HOU,2016,2016-11-13,1:00,1:00,@,JAX,10,9,Sun,W 24-21,,4,89,4,48,8,137
8781,HOU,2017,2017-10-15,1:00,12:00,,CLE,6,6,Sun,W 33-17,,4,44,11,72,15,116
8782,HOU,2019,2019-11-21,8:20,7:20,,IND,12,11,Thu,W 20-17,,4,27,3,29,7,56
8783,HOU,2019,2019-12-21,1:00,1:00,@,TAM,16,15,Sat,W 23-20,,4,35,6,45,10,80
8784,HOU,2020,2020-09-20,4:25,3:25,,BAL,2,2,Sun,L 16-33,,4,22,3,21,7,43
8785,HOU,2020,2020-09-27,1:00,1:00,@,PIT,3,3,Sun,L 21-28,,4,49,2,14,6,63
8786,HOU,2020,2020-10-18,1:00,12:00,@,TEN,6,6,Sun,L 36-42,OT,4,46,7,73,11,119
8787,HOU,2021,2021-10-17,1:00,1:00,@,IND,6,6,Sun,L 3-31,,4,25,2,10,6,35
8788,HOU,2021,2021-11-28,1:00,12:00,,NYJ,12,11,Sun,L 14-21,,4,32,5,40,9,72
8789,HOU,2021,2021-12-05,1:00,12:00,,IND,13,12,Sun,L 0-31,,4,25,5,25,9,50
8790,HOU,2021,2022-01-09,1:00,12:00,,TEN,18,17,Sun,L 25-28,,4,65,5,42,9,107
8791,JAX,2000,2000-09-25,9:00,8:00,@,IND,4,4,Mon,L 14-43,,4,40,11,90,15,130
8792,JAX,2000,2000-11-26,4:15,4:15,,TEN,13,12,Sun,W 16-13,,4,25,4,40,8,65
8793,JAX,2001,2001-09-09,1:05,1:05,,PIT,1,1,Sun,W 21-3,,4,31,4,29,8,60
8794,JAX,2001,2001-10-07,4:05,1:05,@,SEA,4,4,Sun,L 15-24,,4,24,7,60,11,84
8795,JAX,2002,2002-10-06,4:14,4:14,,PHI,5,4,Sun,W 28-25,,4,21,10,75,14,96
8796,JAX,2002,2002-10-13,4:03,3:03,@,TEN,6,5,Sun,L 14-23,,4,22,5,55,9,77
8797,JAX,2005,2005-10-30,1:02,12:02,@,STL,8,7,Sun,L 21-24,,4,25,9,59,13,84
8798,JAX,2006,2006-09-24,1:02,1:02,@,IND,3,3,Sun,L 14-21,,4,38,4,35,8,73
8799,JAX,2006,2006-10-01,4:15,4:15,@,WAS,4,4,Sun,L 30-36,OT,4,35,4,40,8,75
8800,JAX,2006,2006-11-05,1:03,1:03,,TEN,9,8,Sun,W 37-7,,4,20,4,20,8,40
8801,JAX,2007,2007-09-09,1:04,1:04,,TEN,1,1,Sun,L 10-13,,4,45,4,29,8,74
8802,JAX,2007,2007-11-04,1:02,12:02,@,NOR,9,8,Sun,L 24-41,,4,38,2,20,6,58
8803,JAX,2007,2007-11-11,1:03,12:03,@,TEN,10,9,Sun,W 28-13,,4,35,9,56,13,91
8804,JAX,2008,2008-12-07,1:02,12:02,@,CHI,14,13,Sun,L 10-23,,4,21,1,5,5,26
8805,JAX,2009,2009-10-04,1:05,1:05,,TEN,4,4,Sun,W 37-17,,4,30,6,68,10,98
8806,JAX,2009,2009-12-06,1:03,1:03,,HOU,13,12,Sun,W 23-18,,4,45,6,37,10,82
8807,JAX,2009,2009-12-17,8:21,8:21,,IND,15,14,Thu,L 31-35,,4,22,5,40,9,62
8808,JAX,2010,2010-09-26,4:05,4:05,,PHI,3,3,Sun,L 3-28,,4,67,7,84,11,151
8809,JAX,2010,2010-12-05,1:03,12:03,@,TEN,13,12,Sun,W 17-6,,4,31,4,30,8,61
8810,JAX,2011,2011-09-18,1:02,1:02,@,NYJ,2,2,Sun,L 3-32,,4,50,7,60,11,110
8811,JAX,2011,2011-10-16,1:02,1:02,@,PIT,6,6,Sun,L 13-17,,4,22,8,65,12,87
8812,JAX,2011,2011-11-27,1:03,1:03,,HOU,12,11,Sun,L 13-20,,4,30,7,80,11,110
8813,JAX,2012,2012-09-09,1:05,12:05,@,MIN,1,1,Sun,L 23-26,OT,4,25,5,47,9,72
8814,JAX,2013,2013-09-22,4:26,1:26,@,SEA,3,3,Sun,L 17-45,,4,45,4,24,8,69
8815,JAX,2013,2013-10-06,1:00,12:00,@,STL,5,5,Sun,L 20-34,,4,45,6,53,10,98
8816,JAX,2013,2013-11-10,1:02,12:02,@,TEN,10,9,Sun,W 29-27,,4,19,6,45,10,64
8817,JAX,2013,2013-12-22,1:02,1:02,,TEN,16,15,Sun,L 16-20,,4,15,1,4,5,19
8818,JAX,2014,2014-10-05,1:02,1:02,,PIT,5,5,Sun,L 9-17,,4,34,7,50,11,84
8819,JAX,2014,2014-12-28,1:03,12:03,@,HOU,17,16,Sun,L 17-23,,4,25,6,55,10,80
8820,JAX,2015,2015-11-08,1:02,1:02,@,NYJ,9,8,Sun,L 23-28,,4,30,6,41,10,71
8821,JAX,2015,2015-11-15,1:05,1:05,@,BAL,10,9,Sun,W 22-20,,4,30,9,121,13,151
8822,JAX,2016,2016-11-13,1:00,1:00,,HOU,10,9,Sun,L 21-24,,4,48,4,89,8,137
8823,JAX,2016,2016-11-20,1:00,1:00,@,DET,11,10,Sun,L 19-26,,4,25,5,32,9,57
8824,JAX,2016,2016-12-24,1:00,1:00,,TEN,16,15,Sat,W 38-17,,4,45,6,49,10,94
8825,JAX,2017,2017-10-08,1:00,1:00,@,PIT,5,5,Sun,W 30-9,,4,19,5,37,9,56
8826,JAX,2017,2017-10-22,1:00,1:00,@,IND,7,7,Sun,W 27-0,,4,34,5,55,9,89
8827,JAX,2018,2018-10-14,4:25,3:25,@,DAL,6,6,Sun,L 7-40,,4,30,3,25,7,55
8828,JAX,2019,2019-09-19,8:20,8:20,,TEN,3,3,Thu,W 20-7,,4,30,9,101,13,131
8829,JAX,2019,2019-11-03,9:30,2:30,,HOU,9,9,Sun,L 3-26,,4,34,7,60,11,94
8830,JAX,2020,2020-10-11,1:00,12:00,@,HOU,5,5,Sun,L 14-30,,4,35,5,25,9,60
8831,JAX,2020,2020-11-08,1:00,1:00,,HOU,9,8,Sun,L 25-27,,4,78,3,18,7,96
8832,JAX,2021,2021-09-26,1:00,1:00,,ARI,3,3,Sun,L 19-31,,4,40,7,58,11,98
8833,JAX,2021,2021-10-10,1:00,1:00,,TEN,5,5,Sun,L 19-37,,4,33,7,44,11,77
8834,JAX,2021,2021-12-19,1:00,1:00,,HOU,15,14,Sun,L 16-30,,4,40,9,65,13,105
8835,KAN,2001,2001-09-09,12:01,12:01,,OAK,1,1,Sun,L 24-27,,4,25,10,106,14,131
8836,KAN,2002,2002-10-27,1:00,12:00,,OAK,8,8,Sun,W 20-10,,4,33,6,27,10,60
8837,KAN,2002,2002-11-10,4:15,1:15,@,SFO,10,9,Sun,L 13-17,,4,37,3,15,7,52
8838,KAN,2002,2002-11-24,4:05,1:05,@,SEA,12,11,Sun,L 32-39,,4,70,5,52,9,122
8839,KAN,2002,2002-12-01,1:00,12:00,,ARI,13,12,Sun,W 49-0,,4,51,6,50,10,101
8840,KAN,2003,2003-09-14,1:00,12:00,,PIT,2,2,Sun,W 41-20,,4,32,8,82,12,114
8841,KAN,2003,2003-09-21,1:02,12:02,@,HOU,3,3,Sun,W 42-14,,4,20,10,74,14,94
8842,KAN,2003,2003-09-28,4:05,4:05,@,BAL,4,4,Sun,W 17-10,,4,26,4,30,8,56
8843,KAN,2003,2003-11-16,1:03,1:03,@,CIN,11,10,Sun,L 19-24,,4,25,5,33,9,58
8844,KAN,2005,2005-09-11,1:00,12:00,,NYJ,1,1,Sun,W 27-7,,4,26,8,80,12,106
8845,KAN,2005,2005-10-16,1:00,12:00,,WAS,6,5,Sun,W 28-21,,4,24,5,54,9,78
8846,KAN,2006,2006-09-17,4:16,2:16,@,DEN,2,2,Sun,L 6-9,OT,4,26,0,0,4,26
8847,KAN,2006,2006-11-19,1:00,12:00,,OAK,11,10,Sun,W 17-13,,4,20,8,65,12,85
8848,KAN,2006,2006-11-23,8:12,7:12,,DEN,12,11,Thu,W 19-10,,4,25,7,44,11,69
8849,KAN,2006,2006-12-23,8:00,5:00,@,OAK,16,15,Sat,W 20-9,,4,40,6,45,10,85
8850,KAN,2007,2007-09-30,4:15,1:15,@,SDG,4,4,Sun,W 30-16,,4,28,4,21,8,49
8851,KAN,2007,2007-10-21,4:05,1:05,@,OAK,7,7,Sun,W 12-10,,4,25,5,30,9,55
8852,KAN,2007,2007-11-11,1:00,12:00,,DEN,10,9,Sun,L 11-27,,4,20,12,64,16,84
8853,KAN,2008,2008-10-05,1:04,1:04,@,CAR,5,5,Sun,L 0-34,,4,35,8,56,12,91
8854,KAN,2008,2008-10-26,1:05,1:05,@,NYJ,8,7,Sun,L 24-28,,4,39,4,20,8,59
8855,KAN,2008,2008-12-14,1:00,12:00,,SDG,15,14,Sun,L 21-22,,4,30,10,83,14,113
8856,KAN,2009,2009-10-18,1:03,1:03,@,WAS,6,6,Sun,W 14-6,,4,30,7,63,11,93
8857,KAN,2009,2009-11-22,1:00,12:00,,PIT,11,10,Sun,W 27-24,OT,4,28,8,81,12,109
8858,KAN,2010,2010-09-19,1:02,1:02,@,CLE,2,2,Sun,W 16-14,,4,30,9,78,13,108
8859,KAN,2010,2010-10-10,1:03,1:03,@,IND,5,4,Sun,L 9-19,,4,38,5,45,9,83
8860,KAN,2011,2011-11-13,1:03,12:03,,DEN,10,9,Sun,L 10-17,,4,40,8,65,12,105
8861,KAN,2011,2011-11-27,8:31,7:31,,PIT,12,11,Sun,L 9-13,,4,20,6,50,10,70
8862,KAN,2012,2012-09-16,1:02,1:02,@,BUF,2,2,Sun,L 17-35,,4,33,5,50,9,83
8863,KAN,2013,2013-10-13,1:02,12:02,,OAK,6,6,Sun,W 24-7,,4,20,11,68,15,88
8864,KAN,2014,2014-09-21,4:25,4:25,@,MIA,3,3,Sun,W 34-15,,4,23,6,65,10,88
8865,KAN,2014,2014-09-29,8:31,7:31,,NWE,4,4,Mon,W 41-14,,4,35,3,30,7,65
8866,KAN,2014,2014-10-05,4:25,1:25,@,SFO,5,5,Sun,L 17-22,,4,29,2,10,6,39
8867,KAN,2014,2014-12-21,1:02,1:02,@,PIT,16,15,Sun,L 12-20,,4,39,4,40,8,79
8868,KAN,2016,2016-10-23,1:03,12:03,,NOR,7,6,Sun,W 27-21,,4,30,10,75,14,105
8869,KAN,2016,2017-01-01,4:25,1:25,@,SDG,17,16,Sun,W 37-27,,4,19,10,50,14,69
8870,KAN,2017,2017-12-31,4:25,2:25,@,DEN,17,16,Sun,W 27-24,,4,40,4,30,8,70
8871,KAN,2018,2018-12-30,4:25,12:00,,OAK,17,16,Sun,W 35-3,,4,50,4,22,8,72
8872,KAN,2019,2019-09-22,1:00,12:00,,BAL,3,3,Sun,W 33-28,,4,31,7,60,11,91
8873,KAN,2019,2019-11-03,1:00,12:00,,MIN,9,9,Sun,W 26-23,,4,25,3,25,7,50
8874,KAN,2020,2020-10-05,7:05,6:05,,NWE,4,4,Mon,W 26-10,,4,38,4,43,8,81
8875,KAN,2021,2021-11-14,8:20,5:20,@,LVR,10,10,Sun,W 41-14,,4,34,9,68,13,102
8876,KAN,2021,2021-12-16,8:20,5:20,@,LAC,15,14,Thu,W 34-28,OT,4,36,5,60,9,96
8877,MIA,2000,2000-11-26,4:15,4:15,@,IND,13,12,Sun,W 17-14,,4,30,10,78,14,108
8878,MIA,2001,2001-11-18,1:02,1:02,,NYJ,10,9,Sun,L 0-24,,4,21,1,10,5,31
8879,MIA,2001,2001-12-10,9:08,9:08,,IND,13,12,Mon,W 41-6,,4,40,2,25,6,65
8880,MIA,2001,2001-12-16,4:07,1:07,@,SFO,14,13,Sun,L 0-21,,4,27,2,10,6,37
8881,MIA,2002,2002-09-08,1:04,1:04,,DET,1,1,Sun,W 49-21,,4,54,6,68,10,122
8882,MIA,2002,2002-12-15,1:02,1:02,,OAK,15,14,Sun,W 23-17,,4,30,9,55,13,85
8883,MIA,2003,2003-09-14,1:02,1:02,@,NYJ,2,2,Sun,W 21-10,,4,30,7,52,11,82
8884,MIA,2003,2003-09-21,8:36,8:36,,BUF,3,3,Sun,W 17-7,,4,35,11,84,15,119
8885,MIA,2003,2003-10-19,1:03,1:03,,NWE,7,6,Sun,L 13-19,OT,4,40,5,34,9,74
8886,MIA,2003,2003-11-09,1:02,12:02,@,TEN,10,9,Sun,L 7-31,,4,30,5,25,9,55
8887,MIA,2003,2003-12-07,4:15,4:15,@,NWE,14,13,Sun,L 0-12,,4,25,2,14,6,39
8888,MIA,2004,2004-10-03,4:15,4:15,,NYJ,4,4,Sun,L 9-17,,4,30,4,35,8,65
8889,MIA,2004,2004-10-24,1:02,1:02,,STL,7,7,Sun,W 31-14,,4,37,7,63,11,100
8890,MIA,2004,2004-12-12,4:05,2:05,@,DEN,14,13,Sun,L 17-20,,4,40,5,43,9,83
8891,MIA,2005,2005-10-21,7:05,7:05,,KAN,7,6,Fri,L 20-30,,4,30,7,63,11,93
8892,MIA,2005,2005-11-13,1:03,1:03,,NWE,10,9,Sun,L 16-23,,4,69,6,38,10,107
8893,MIA,2005,2005-12-24,1:03,1:03,,TEN,16,15,Sat,W 24-10,,4,30,5,28,9,58
8894,MIA,2007,2007-10-21,1:02,1:02,,NWE,7,7,Sun,L 28-49,,4,41,5,40,9,81
8895,MIA,2007,2007-11-26,8:55,8:55,@,PIT,12,11,Mon,L 0-3,,4,19,3,30,7,49
8896,MIA,2007,2007-12-02,1:03,1:03,,NYJ,13,12,Sun,L 13-40,,4,42,2,11,6,53
8897,MIA,2007,2007-12-16,1:03,1:03,,BAL,15,14,Sun,W 22-16,OT,4,25,1,5,5,30
8898,MIA,2007,2007-12-23,4:15,4:15,@,NWE,16,15,Sun,L 7-28,,4,32,2,18,6,50
8899,MIA,2008,2008-09-07,1:02,1:02,,NYJ,1,1,Sun,L 14-20,,4,59,7,40,11,99
8900,MIA,2008,2008-10-12,1:02,12:02,@,HOU,6,5,Sun,L 28-29,,4,30,1,5,5,35
8901,MIA,2008,2008-11-09,1:03,1:03,,SEA,10,9,Sun,W 21-19,,4,29,5,25,9,54
8902,MIA,2009,2009-09-13,1:05,1:05,@,ATL,1,1,Sun,L 7-19,,4,27,4,35,8,62
8903,MIA,2009,2009-09-21,8:42,8:42,,IND,2,2,Mon,L 23-27,,4,20,4,20,8,40
8904,MIA,2009,2009-11-01,1:02,1:02,@,NYJ,8,7,Sun,W 30-25,,4,25,6,40,10,65
8905,MIA,2009,2009-12-13,1:03,1:03,@,JAX,14,13,Sun,W 14-10,,4,27,2,10,6,37
8906,MIA,2009,2009-12-27,1:02,1:02,,HOU,16,15,Sun,L 20-27,,4,30,3,15,7,45
8907,MIA,2010,2010-10-17,1:02,12:02,@,GNB,6,5,Sun,W 23-20,OT,4,30,7,45,11,75
8908,MIA,2010,2010-10-31,1:06,1:06,@,CIN,8,7,Sun,W 22-14,,4,42,4,36,8,78
8909,MIA,2010,2010-11-07,1:02,1:02,@,BAL,9,8,Sun,L 10-26,,4,23,5,40,9,63
8910,MIA,2010,2010-11-14,1:02,1:02,,TEN,10,9,Sun,W 29-17,,4,63,5,55,9,118
8911,MIA,2010,2010-12-05,1:02,1:02,,CLE,13,12,Sun,L 10-13,,4,37,4,45,8,82
8912,MIA,2010,2010-12-19,1:02,1:02,,BUF,15,14,Sun,L 14-17,,4,35,5,44,9,79
8913,MIA,2011,2011-10-30,1:02,1:02,@,NYG,8,7,Sun,L 17-20,,4,30,7,46,11,76
8914,MIA,2011,2011-11-20,1:02,1:02,,BUF,11,10,Sun,W 35-8,,4,50,3,27,7,77
8915,MIA,2012,2012-09-30,4:05,1:05,@,ARI,4,4,Sun,L 21-24,OT,4,40,6,62,10,102
8916,MIA,2012,2012-10-28,1:06,1:06,@,NYJ,8,7,Sun,W 30-9,,4,31,5,45,9,76
8917,MIA,2013,2013-10-06,1:02,1:02,,BAL,5,5,Sun,L 23-26,,4,65,6,64,10,129
8918,MIA,2013,2013-10-20,1:02,1:02,,BUF,7,6,Sun,L 21-23,,4,32,6,53,10,85
8919,MIA,2013,2013-11-11,8:40,8:40,@,TAM,10,9,Mon,L 19-22,,4,70,9,70,13,140
8920,MIA,2013,2013-12-15,1:02,1:02,,NWE,15,14,Sun,W 24-20,,4,21,1,2,5,23
8921,MIA,2014,2014-09-07,1:03,1:03,,NWE,1,1,Sun,W 33-20,,4,26,9,100,13,126
8922,MIA,2014,2014-11-13,8:26,8:26,,BUF,11,10,Thu,W 22-9,,4,30,7,70,11,100
8923,MIA,2016,2016-09-11,4:08,1:08,@,SEA,1,1,Sun,L 10-12,,4,40,8,69,12,109
8924,MIA,2016,2016-11-27,1:00,1:00,,SFO,12,11,Sun,W 31-24,,4,42,7,65,11,107
8925,MIA,2017,2017-10-15,1:00,1:00,@,ATL,6,5,Sun,W 20-17,,4,42,6,73,10,115
8926,MIA,2018,2018-10-21,1:00,1:00,,DET,7,7,Sun,L 21-32,,4,50,6,43,10,93
8927,MIA,2018,2018-12-30,1:00,1:00,@,BUF,17,16,Sun,L 17-42,,4,35,3,24,7,59
8928,MIA,2019,2019-09-15,1:00,1:00,,NWE,2,2,Sun,L 0-43,,4,22,5,54,9,76
8929,MIA,2019,2019-11-10,4:05,4:05,@,IND,10,9,Sun,W 16-12,,4,30,3,25,7,55
8930,MIA,2019,2019-12-29,1:00,1:00,@,NWE,17,16,Sun,W 27-24,,4,35,6,54,10,89
8931,MIA,2020,2020-09-13,1:00,1:00,@,NWE,1,1,Sun,L 11-21,,4,35,3,47,7,82
8932,MIN,2000,2000-09-03,1:00,12:00,,CHI,1,1,Sun,W 30-27,,4,20,5,45,9,65
8933,MIN,2000,2000-10-09,9:10,8:10,,TAM,6,5,Mon,W 30-23,,4,44,7,58,11,102
8934,MIN,2000,2000-11-12,1:00,12:00,,ARI,11,10,Sun,W 31-14,,4,35,8,65,12,100
8935,MIN,2000,2000-11-23,4:08,3:08,@,DAL,13,12,Thu,W 27-15,,4,21,5,45,9,66
8936,MIN,2001,2002-01-07,9:07,9:07,@,BAL,17,16,Mon,L 3-19,,4,42,2,15,6,57
8937,MIN,2003,2003-09-28,1:03,12:03,,SFO,4,4,Sun,W 35-7,,4,29,9,55,13,84
8938,MIN,2003,2003-11-02,8:35,7:35,,GNB,9,8,Sun,L 27-30,,4,20,3,25,7,45
8939,MIN,2004,2004-11-28,1:00,12:00,,JAX,12,11,Sun,W 27-16,,4,35,6,45,10,80
8940,MIN,2005,2005-10-23,1:00,12:00,,GNB,7,6,Sun,W 23-20,,4,21,6,50,10,71
8941,MIN,2007,2007-09-09,1:00,12:00,,ATL,1,1,Sun,W 24-3,,4,35,6,40,10,75
8942,MIN,2007,2007-10-21,4:15,3:15,@,DAL,7,6,Sun,L 14-24,,4,36,4,22,8,58
8943,MIN,2007,2007-11-18,1:05,12:05,,OAK,11,10,Sun,W 29-22,,4,30,10,55,14,85
8944,MIN,2007,2007-11-25,1:03,1:03,@,NYG,12,11,Sun,W 41-17,,4,15,5,30,9,45
8945,MIN,2007,2007-12-02,1:05,12:05,,DET,13,12,Sun,W 42-10,,4,25,6,48,10,73
8946,MIN,2007,2007-12-17,8:40,7:40,,CHI,15,14,Mon,W 20-13,,4,30,11,95,15,125
8947,MIN,2007,2007-12-30,4:16,2:16,@,DEN,17,16,Sun,L 19-22,OT,4,30,5,40,9,70
8948,MIN,2008,2008-11-30,8:15,7:15,,CHI,13,12,Sun,W 34-14,,4,30,5,50,9,80
8949,MIN,2009,2009-12-28,8:40,7:40,@,CHI,16,15,Mon,L 30-36,OT,4,47,3,31,7,78
8950,MIN,2010,2010-12-05,1:05,12:05,,BUF,13,12,Sun,W 38-14,,4,20,6,54,10,74
8951,MIN,2011,2011-10-30,1:03,1:03,@,CAR,8,8,Sun,W 24-21,,4,43,6,60,10,103
8952,MIN,2011,2011-12-24,1:05,1:05,@,WAS,16,15,Sat,W 33-26,,4,40,8,64,12,104
8953,MIN,2013,2013-09-22,1:05,12:05,,CLE,3,3,Sun,L 27-31,,4,35,5,47,9,82
8954,MIN,2013,2013-11-03,1:03,12:03,@,DAL,9,8,Sun,L 23-27,,4,35,5,45,9,80
8955,MIN,2013,2013-11-17,4:26,1:26,@,SEA,11,10,Sun,L 20-41,,4,20,7,96,11,116
8956,MIN,2013,2013-12-29,1:05,12:05,,DET,17,16,Sun,W 14-13,,4,25,6,52,10,77
8957,MIN,2014,2014-12-28,1:02,12:02,,CHI,17,16,Sun,W 13-9,,4,25,8,50,12,75
8958,MIN,2015,2015-11-01,1:00,12:00,@,CHI,8,7,Sun,W 23-20,,4,35,4,38,8,73
8959,MIN,2015,2015-12-20,1:02,12:02,,CHI,15,14,Sun,W 38-17,,4,45,6,39,10,84
8960,MIN,2016,2016-11-13,1:00,1:00,@,WAS,10,9,Sun,L 20-26,,4,35,4,35,8,70
8961,MIN,2017,2017-10-22,1:00,3:00,,BAL,7,7,Sun,W 24-16,,4,47,3,15,7,62
8962,MIN,2018,2018-09-27,8:20,5:20,@,LAR,4,4,Thu,L 31-38,,4,35,2,15,6,50
8963,MIN,2018,2018-10-07,4:25,4:25,@,PHI,5,5,Sun,W 23-21,,4,23,8,52,12,75
8964,MIN,2018,2018-11-18,8:20,12:00,@,CHI,11,10,Sun,L 20-25,,4,50,5,46,9,96
8965,MIN,2018,2018-12-10,8:15,5:15,@,SEA,14,13,Mon,L 7-21,,4,51,4,45,8,96
8966,MIN,2019,2019-10-13,1:00,3:00,,PHI,6,6,Sun,W 38-20,,4,30,7,49,11,79
8967,MIN,2020,2020-10-04,1:00,12:00,@,HOU,4,4,Sun,W 31-23,,4,36,2,15,6,51
8968,MIN,2020,2020-11-16,8:15,7:15,@,CHI,10,9,Mon,W 19-13,,4,35,1,5,5,40
8969,MIN,2020,2021-01-03,1:00,1:00,@,DET,17,16,Sun,W 37-35,,4,35,7,51,11,86
8970,MIN,2021,2021-09-26,4:25,2:25,,SEA,3,3,Sun,W 30-17,,4,40,4,35,8,75
8971,MIN,2021,2022-01-09,1:00,11:00,,CHI,18,17,Sun,W 31-17,,4,47,2,10,6,57
8972,NOR,2000,2000-09-17,4:15,1:15,@,SEA,3,3,Sun,L 10-20,,4,40,4,32,8,72
8973,NOR,2001,2001-09-09,1:05,1:05,@,BUF,1,1,Sun,W 24-6,,4,35,4,35,8,70
8974,NOR,2002,2002-10-20,1:03,12:03,,SFO,7,7,Sun,W 35-27,,4,35,5,42,9,77
8975,NOR,2002,2002-12-08,4:05,4:05,@,BAL,14,13,Sun,W 37-25,,4,35,8,69,12,104
8976,NOR,2002,2002-12-22,1:02,1:02,@,CIN,16,15,Sun,L 13-20,,4,30,6,40,10,70
8977,NOR,2002,2002-12-29,1:02,12:02,,CAR,17,16,Sun,L 6-10,,4,27,3,19,7,46
8978,NOR,2003,2003-10-26,1:03,12:03,,CAR,8,8,Sun,L 20-23,OT,4,43,6,50,10,93
8979,NOR,2003,2003-12-07,1:03,12:03,,TAM,14,13,Sun,L 7-14,,4,44,9,85,13,129
8980,NOR,2003,2003-12-21,1:02,1:02,@,JAX,16,15,Sun,L 19-20,,4,30,7,69,11,99
8981,NOR,2004,2004-10-17,8:36,7:36,,MIN,6,6,Sun,L 31-38,,4,21,5,35,9,56
8982,NOR,2005,2005-10-02,1:03,12:03,,BUF,4,4,Sun,W 19-7,,4,26,12,79,16,105
8983,NOR,2005,2005-12-24,1:06,12:06,,DET,16,15,Sat,L 12-13,,4,17,11,65,15,82
8984,NOR,2006,2006-09-25,8:48,7:48,,ATL,3,3,Mon,W 23-3,,4,40,5,43,9,83
8985,NOR,2006,2006-11-05,1:02,1:02,@,TAM,9,8,Sun,W 31-14,,4,25,4,25,8,50
8986,NOR,2006,2006-11-19,1:02,12:02,,CIN,11,10,Sun,L 16-31,,4,25,2,10,6,35
8987,NOR,2006,2006-12-17,1:04,12:04,,WAS,15,14,Sun,L 10-16,,4,16,3,15,7,31
8988,NOR,2006,2006-12-31,1:03,12:03,,CAR,17,16,Sun,L 21-31,,4,38,2,19,6,57
8989,NOR,2007,2007-09-06,8:39,8:39,@,IND,1,1,Thu,L 10-41,,4,20,6,30,10,50
8990,NOR,2007,2007-10-28,4:17,1:17,@,SFO,8,7,Sun,W 31-10,,4,25,7,66,11,91
8991,NOR,2007,2007-11-18,1:02,12:02,@,HOU,11,10,Sun,L 10-23,,4,30,3,22,7,52
8992,NOR,2008,2008-09-21,4:06,2:06,@,DEN,3,3,Sun,L 32-34,,4,51,3,20,7,71
8993,NOR,2008,2008-10-12,1:02,12:02,,OAK,6,6,Sun,W 34-3,,4,30,5,26,9,56
8994,NOR,2009,2009-11-22,1:00,1:00,@,TAM,11,10,Sun,W 38-7,,4,55,3,18,7,73
8995,NOR,2009,2009-11-30,8:40,7:40,,NWE,12,11,Mon,W 38-17,,4,36,0,0,4,36
8996,NOR,2009,2009-12-19,8:22,7:22,,DAL,15,14,Sat,L 17-24,,4,30,6,49,10,79
8997,NOR,2009,2010-01-03,1:04,1:04,@,CAR,17,16,Sun,L 10-23,,4,35,3,29,7,64
8998,NOR,2010,2010-09-26,1:03,12:03,,ATL,3,3,Sun,L 24-27,OT,4,38,6,40,10,78
8999,NOR,2010,2010-10-03,1:03,12:03,,CAR,4,4,Sun,W 16-14,,4,36,4,66,8,102
9000,NOR,2010,2010-11-25,4:36,3:36,@,DAL,12,11,Thu,W 30-27,,4,30,4,19,8,49
9001,NOR,2011,2011-09-25,1:02,12:02,,HOU,3,3,Sun,W 40-33,,4,26,7,56,11,82
9002,NOR,2011,2011-12-26,8:40,7:40,,ATL,16,15,Mon,W 45-16,,4,46,7,57,11,103
9003,NOR,2012,2012-09-23,1:02,12:02,,KAN,3,3,Sun,L 24-27,OT,4,45,6,40,10,85
9004,NOR,2012,2012-11-05,8:40,7:40,,PHI,9,8,Mon,W 28-13,,4,35,7,58,11,93
9005,NOR,2012,2012-11-25,4:25,3:25,,SFO,12,11,Sun,L 21-31,,4,53,10,68,14,121
9006,NOR,2013,2013-09-22,1:03,12:03,,ARI,3,3,Sun,W 31-7,,4,30,3,18,7,48
9007,NOR,2013,2013-11-17,4:25,3:25,,SFO,11,10,Sun,W 23-20,,4,48,5,45,9,93
9008,NOR,2013,2013-12-22,1:04,1:04,@,CAR,16,15,Sun,L 13-17,,4,40,3,26,7,66
9009,NOR,2014,2014-09-21,1:03,12:03,,MIN,3,3,Sun,W 20-9,,4,30,5,44,9,74
9010,NOR,2014,2014-10-26,8:30,7:30,,GNB,8,7,Sun,W 44-23,,4,35,8,84,12,119
9011,NOR,2014,2014-10-30,8:30,8:30,@,CAR,9,8,Thu,W 28-10,,4,36,6,67,10,103
9012,NOR,2014,2014-12-07,1:03,12:03,,CAR,14,13,Sun,L 10-41,,4,30,6,55,10,85
9013,NOR,2015,2016-01-03,1:02,1:02,@,ATL,17,16,Sun,W 20-17,,4,45,4,32,8,77
9014,NOR,2016,2016-11-06,4:05,1:05,@,SFO,9,8,Sun,W 41-23,,4,40,9,78,13,118
9015,NOR,2017,2017-11-05,1:00,12:00,,TAM,9,8,Sun,W 30-10,,4,28,7,50,11,78
9016,NOR,2017,2017-11-12,1:00,1:00,@,BUF,10,9,Sun,W 47-10,,4,41,8,56,12,97
9017,NOR,2018,2018-09-16,1:00,12:00,,CLE,2,2,Sun,W 21-18,,4,53,4,43,8,96
9018,NOR,2018,2018-10-08,8:15,7:15,,WAS,5,5,Mon,W 43-19,,4,45,6,38,10,83
9019,NOR,2019,2019-10-20,4:25,3:25,@,CHI,7,7,Sun,W 36-25,,4,35,3,10,7,45
9020,NOR,2020,2020-10-04,1:00,1:00,@,DET,4,4,Sun,W 35-29,,4,67,5,49,9,116
9021,NOR,2020,2020-12-25,4:30,3:30,,MIN,16,15,Fri,W 52-33,,4,38,3,20,7,58
9022,NOR,2020,2021-01-03,4:25,4:25,@,CAR,17,16,Sun,W 33-7,,4,31,1,5,5,36
9023,NOR,2021,2021-11-25,8:20,7:20,,BUF,12,11,Thu,L 6-31,,4,24,4,35,8,59
9024,NOR,2021,2021-12-12,1:00,1:00,@,NYJ,14,13,Sun,W 30-9,,4,42,5,45,9,87
9025,NOR,2021,2022-01-09,1:00,1:00,@,ATL,18,17,Sun,W 30-20,,4,40,5,46,9,86
9026,NWE,2000,2000-10-15,4:05,4:05,,NYJ,7,7,Sun,L 17-34,,4,30,5,68,9,98
9027,NWE,2001,2001-10-21,1:00,12:00,@,IND,6,6,Sun,W 38-17,,4,35,4,53,8,88
9028,NWE,2001,2001-12-02,1:02,1:02,@,NYJ,12,12,Sun,W 17-16,,4,28,2,5,6,33
9029,NWE,2002,2002-12-22,8:36,8:36,,NYJ,16,15,Sun,L 17-30,,4,30,7,60,11,90
9030,NWE,2002,2002-12-29,1:02,1:02,,MIA,17,16,Sun,W 27-24,OT,4,20,6,83,10,103
9031,NWE,2003,2003-12-14,1:02,1:02,,JAX,15,14,Sun,W 27-13,,4,55,8,60,12,115
9032,NWE,2003,2003-12-27,1:35,1:35,,BUF,17,16,Sat,W 31-0,,4,34,10,71,14,105
9033,NWE,2004,2004-11-22,9:00,8:00,@,KAN,11,10,Mon,W 27-19,,4,25,7,50,11,75
9034,NWE,2004,2004-12-20,9:09,9:09,@,MIA,15,14,Mon,L 28-29,,4,53,9,67,13,120
9035,NWE,2004,2005-01-02,1:02,1:02,,SFO,17,16,Sun,W 21-7,,4,37,7,64,11,101
9036,NWE,2005,2005-10-02,1:02,1:02,,SDG,4,4,Sun,L 17-41,,4,62,7,50,11,112
9037,NWE,2005,2005-11-07,9:08,9:08,,IND,9,8,Mon,L 21-40,,4,24,7,32,11,56
9038,NWE,2005,2005-12-26,9:09,9:09,@,NYJ,16,15,Mon,W 31-21,,4,30,9,69,13,99
9039,NWE,2006,2006-11-12,1:02,1:02,,NYJ,10,9,Sun,L 14-17,,4,30,4,28,8,58
9040,NWE,2006,2006-11-26,4:15,4:15,,CHI,12,11,Sun,W 17-13,,4,81,5,31,9,112
9041,NWE,2007,2007-09-09,1:03,1:03,@,NYJ,1,1,Sun,W 38-14,,4,16,2,20,6,36
9042,NWE,2007,2007-11-18,8:24,8:24,@,BUF,11,10,Sun,W 56-10,,4,37,5,34,9,71
9043,NWE,2007,2007-12-03,8:41,8:41,@,BAL,13,12,Mon,W 27-24,,4,30,13,100,17,130
9044,NWE,2008,2008-10-05,4:15,1:15,@,SFO,5,4,Sun,W 30-21,,4,56,6,37,10,93
9045,NWE,2008,2008-12-14,4:15,1:15,@,OAK,15,14,Sun,W 49-26,,4,20,7,45,11,65
9046,NWE,2009,2009-10-11,4:16,2:16,@,DEN,5,5,Sun,L 17-20,OT,4,46,3,20,7,66
9047,NWE,2009,2009-11-15,8:31,8:31,@,IND,10,9,Sun,L 34-35,,4,72,3,20,7,92
9048,NWE,2009,2009-12-13,1:02,1:02,,CAR,14,13,Sun,W 20-10,,4,25,9,92,13,117
9049,NWE,2009,2010-01-03,1:02,12:02,@,HOU,17,16,Sun,L 27-34,,4,55,5,35,9,90
9050,NWE,2010,2010-09-26,1:02,1:02,,BUF,3,3,Sun,W 38-30,,4,35,6,45,10,80
9051,NWE,2010,2010-12-12,4:16,3:16,@,CHI,14,13,Sun,W 36-7,,4,43,4,30,8,73
9052,NWE,2011,2011-12-11,1:03,1:03,@,WAS,14,13,Sun,W 34-27,,4,47,8,73,12,120
9053,NWE,2011,2011-12-18,4:16,2:16,@,DEN,15,14,Sun,W 41-23,,4,30,7,39,11,69
9054,NWE,2011,2012-01-01,1:02,1:02,,BUF,17,16,Sun,W 49-21,,4,77,5,45,9,122
9055,NWE,2012,2012-11-18,4:25,4:25,,IND,11,10,Sun,W 59-24,,4,70,1,5,5,75
9056,NWE,2012,2012-12-23,1:02,1:02,@,JAX,16,15,Sun,W 23-16,,4,39,5,47,9,86
9057,NWE,2013,2013-09-08,1:02,1:02,@,BUF,1,1,Sun,W 23-21,,4,36,10,75,14,111
9058,NWE,2013,2013-10-13,4:25,4:25,,NOR,6,6,Sun,W 30-27,,4,33,7,56,11,89
9059,NWE,2013,2013-12-29,4:25,4:25,,BUF,17,16,Sun,W 34-20,,4,31,6,54,10,85
9060,NWE,2014,2014-11-30,4:25,3:25,@,GNB,13,12,Sun,L 21-26,,4,25,4,22,8,47
9061,NWE,2015,2015-09-27,1:06,1:06,,JAX,3,3,Sun,W 51-17,,4,30,7,114,11,144
9062,NWE,2015,2015-10-25,1:02,1:02,,NYJ,7,6,Sun,W 30-23,,4,38,4,29,8,67
9063,NWE,2016,2016-10-23,4:25,4:25,@,PIT,7,7,Sun,W 27-16,,4,40,10,85,14,125
9064,NWE,2016,2016-12-18,4:25,2:25,@,DEN,15,14,Sun,W 16-3,,4,30,5,49,9,79
9065,NWE,2017,2017-12-31,1:00,1:00,,NYJ,17,16,Sun,W 26-6,,4,49,9,84,13,133
9066,NWE,2018,2018-11-11,1:00,12:00,@,TEN,10,10,Sun,L 10-34,,4,31,4,35,8,66
9067,NWE,2018,2018-12-30,1:00,1:00,,NYJ,17,16,Sun,W 38-3,,4,30,4,30,8,60
9068,NWE,2019,2019-10-27,4:25,4:25,,CLE,8,8,Sun,W 27-13,,4,32,13,85,17,117
9069,NWE,2019,2019-12-15,1:00,1:00,@,CIN,15,14,Sun,W 34-13,,4,30,5,25,9,55
9070,NWE,2020,2020-10-05,7:05,6:05,@,KAN,4,4,Mon,L 10-26,,4,43,4,38,8,81
9071,NWE,2020,2020-12-28,8:15,8:15,,BUF,16,15,Mon,L 9-38,,4,25,3,27,7,52
9072,NWE,2021,2021-09-26,1:00,1:00,,NOR,3,3,Sun,L 13-28,,4,30,2,15,6,45
9073,NWE,2021,2021-10-31,4:05,1:05,@,LAC,8,8,Sun,W 27-24,,4,30,5,40,9,70
9074,NWE,2021,2021-11-28,1:00,1:00,,TEN,12,12,Sun,W 36-13,,4,35,5,50,9,85
9075,NYG,2000,2000-09-10,1:02,1:02,@,PHI,2,2,Sun,W 33-18,,4,35,5,40,9,75
9076,NYG,2000,2000-11-26,8:35,6:35,@,ARI,13,12,Sun,W 31-7,,4,45,12,99,16,144
9077,NYG,2001,2001-11-04,1:04,1:04,,DAL,8,8,Sun,W 27-24,OT,4,43,5,40,9,83
9078,NYG,2001,2001-11-11,4:17,2:17,@,ARI,9,9,Sun,W 17-10,,4,36,4,24,8,60
9079,NYG,2002,2002-09-15,3:05,3:05,@,STL,2,2,Sun,W 26-21,,4,30,8,40,12,70
9080,NYG,2003,2003-12-21,1:02,12:02,@,DAL,16,15,Sun,L 3-19,,4,20,3,35,7,55
9081,NYG,2004,2004-10-24,1:03,1:03,,DET,7,6,Sun,L 13-28,,4,25,7,65,11,90
9082,NYG,2006,2006-10-29,1:04,1:04,,TAM,8,7,Sun,W 17-3,,4,40,3,30,7,70
9083,NYG,2007,2007-09-09,8:25,7:25,@,DAL,1,1,Sun,L 35-45,,4,45,7,55,11,100
9084,NYG,2007,2007-09-30,8:23,8:23,,PHI,4,4,Sun,W 16-3,,4,27,15,132,19,159
9085,NYG,2007,2007-12-23,1:02,1:02,@,BUF,16,15,Sun,W 38-21,,4,25,6,45,10,70
9086,NYG,2008,2008-11-09,8:23,8:23,@,PHI,10,9,Sun,W 36-31,,4,30,5,45,9,75
9087,NYG,2009,2009-09-13,4:15,4:15,,WAS,1,1,Sun,W 23-17,,4,30,4,32,8,62
9088,NYG,2009,2009-09-20,8:20,7:20,@,DAL,2,2,Sun,W 33-31,,4,40,4,50,8,90
9089,NYG,2009,2009-10-11,1:02,1:02,,OAK,5,5,Sun,W 44-7,,4,37,7,67,11,104
9090,NYG,2009,2009-11-01,1:03,1:03,@,PHI,8,8,Sun,L 17-40,,4,25,5,45,9,70
9091,NYG,2009,2009-11-26,8:21,6:21,@,DEN,12,11,Thu,L 6-26,,4,45,8,61,12,106
9092,NYG,2009,2009-12-27,1:03,1:03,,CAR,16,15,Sun,L 9-41,,4,29,4,20,8,49
9093,NYG,2010,2010-11-28,1:02,1:02,,JAX,12,11,Sun,W 24-20,,4,25,3,20,7,45
9094,NYG,2010,2010-12-19,1:03,1:03,,PHI,15,14,Sun,L 31-38,,4,35,5,30,9,65
9095,NYG,2011,2011-09-25,1:03,1:03,@,PHI,3,3,Sun,W 29-16,,4,21,7,36,11,57
9096,NYG,2011,2011-11-28,8:40,7:40,@,NOR,12,11,Mon,L 24-49,,4,32,11,104,15,136
9097,NYG,2012,2012-09-05,8:41,8:41,,DAL,1,1,Wed,L 17-24,,4,33,13,86,17,119
9098,NYG,2012,2012-11-25,8:30,8:30,,GNB,12,11,Sun,W 38-10,,4,24,8,49,12,73
9099,NYG,2013,2013-09-15,4:25,4:25,,DEN,2,2,Sun,L 23-41,,4,16,13,132,17,148
9100,NYG,2013,2013-10-10,8:29,7:29,@,CHI,6,6,Thu,L 21-27,,4,31,5,51,9,82
9101,NYG,2014,2014-09-08,7:11,7:11,@,DET,1,1,Mon,L 14-35,,4,25,8,85,12,110
9102,NYG,2014,2014-09-21,1:02,1:02,,HOU,3,3,Sun,W 30-17,,4,31,5,40,9,71
9103,NYG,2014,2014-11-03,8:31,8:31,,IND,9,8,Mon,L 24-40,,4,30,4,30,8,60
9104,NYG,2014,2014-11-09,4:26,1:26,@,SEA,10,9,Sun,L 17-38,,4,35,6,50,10,85
9105,NYG,2015,2015-11-29,1:03,1:03,@,WAS,12,11,Sun,L 14-20,,4,35,7,80,11,115
9106,NYG,2016,2016-09-11,4:27,3:27,@,DAL,1,1,Sun,W 20-19,,4,40,6,50,10,90
9107,NYG,2016,2016-11-20,1:00,1:00,,CHI,11,10,Sun,W 22-16,,4,35,5,40,9,75
9108,NYG,2016,2016-12-04,4:25,4:25,@,PIT,13,12,Sun,L 14-24,,4,24,12,115,16,139
9109,NYG,2017,2017-11-05,1:00,1:00,,LAR,9,8,Sun,L 17-51,,4,52,6,55,10,107
9110,NYG,2017,2017-11-12,4:25,1:25,@,SFO,10,9,Sun,L 21-31,,4,35,6,44,10,79
9111,NYG,2018,2018-10-22,8:15,8:15,@,ATL,7,7,Mon,L 20-23,,4,58,5,29,9,87
9112,NYG,2019,2019-12-01,1:00,1:00,,GNB,13,12,Sun,L 13-31,,4,31,7,54,11,85
9113,NYG,2019,2019-12-15,1:00,1:00,,MIA,15,14,Sun,W 36-20,,4,32,7,42,11,74
9114,NYG,2019,2019-12-22,1:00,1:00,@,WAS,16,15,Sun,W 41-35,OT,4,33,6,51,10,84
9115,NYG,2019,2019-12-29,4:25,4:25,,PHI,17,16,Sun,L 17-34,,4,48,7,55,11,103
9116,NYG,2020,2020-09-14,7:15,7:15,,PIT,1,1,Mon,L 16-26,,4,25,3,21,7,46
9117,NYG,2020,2020-10-04,4:05,1:05,@,LAR,4,4,Sun,L 9-17,,4,20,1,5,5,25
9118,NYG,2020,2020-10-18,1:00,1:00,,WAS,6,6,Sun,W 20-19,,4,30,8,50,12,80
9119,NYG,2020,2020-11-08,1:00,1:00,@,WAS,9,9,Sun,W 23-20,,4,40,6,45,10,85
9120,NYG,2021,2021-09-12,4:25,4:25,,DEN,1,1,Sun,L 13-27,,4,48,5,51,9,99
9121,NYG,2021,2021-11-07,1:00,1:00,,LVR,9,9,Sun,W 23-16,,4,35,6,65,10,100
9122,NYG,2021,2021-11-22,8:15,8:15,@,TAM,11,10,Mon,L 10-30,,4,30,6,39,10,69
9123,NYJ,2000,2000-09-24,4:15,4:15,@,TAM,4,4,Sun,W 21-17,,4,25,8,75,12,100
9124,NYJ,2000,2000-11-19,4:05,4:05,@,MIA,12,11,Sun,W 20-3,,4,29,10,88,14,117
9125,NYJ,2000,2000-11-26,1:02,1:02,,CHI,13,12,Sun,W 17-10,,4,35,5,29,9,64
9126,NYJ,2000,2000-12-03,4:15,4:15,,IND,14,13,Sun,W 27-17,,4,54,2,20,6,74
9127,NYJ,2000,2000-12-24,1:02,1:02,@,BAL,17,16,Sun,L 20-34,,4,19,5,32,9,51
9128,NYJ,2002,2002-09-29,1:02,1:02,@,JAX,4,4,Sun,L 3-28,,4,25,3,15,7,40
9129,NYJ,2002,2002-10-06,4:06,4:06,,KAN,5,5,Sun,L 25-29,,4,25,7,65,11,90
9130,NYJ,2002,2002-10-20,1:02,1:02,,MIN,7,6,Sun,W 20-7,,4,45,6,60,10,105
9131,NYJ,2002,2002-11-17,4:16,4:16,@,DET,11,10,Sun,W 31-14,,4,45,5,47,9,92
9132,NYJ,2003,2003-09-28,4:15,4:15,,DAL,4,4,Sun,L 6-17,,4,40,5,38,9,78
9133,NYJ,2003,2003-12-14,1:03,1:03,,PIT,15,14,Sun,W 6-0,,4,40,4,19,8,59
9134,NYJ,2003,2003-12-20,8:37,8:37,,NWE,16,15,Sat,L 16-21,,4,25,5,31,9,56
9135,NYJ,2003,2003-12-28,1:03,1:03,@,MIA,17,16,Sun,L 21-23,,4,40,5,30,9,70
9136,NYJ,2004,2004-09-19,4:15,1:15,@,SDG,2,2,Sun,W 34-28,,4,22,5,44,9,66
9137,NYJ,2004,2004-10-03,4:15,4:15,@,MIA,4,3,Sun,W 17-9,,4,35,4,30,8,65
9138,NYJ,2004,2004-10-17,1:03,1:03,,SFO,6,5,Sun,W 22-14,,4,29,7,61,11,90
9139,NYJ,2004,2004-12-26,4:05,4:05,,NWE,16,15,Sun,L 7-23,,4,20,3,25,7,45
9140,NYJ,2006,2006-09-17,4:15,4:15,,NWE,2,2,Sun,L 17-24,,4,48,6,64,10,112
9141,NYJ,2006,2006-11-12,1:02,1:02,@,NWE,10,9,Sun,W 17-14,,4,28,4,30,8,58
9142,NYJ,2007,2007-11-18,4:05,4:05,,PIT,11,10,Sun,W 19-16,OT,4,30,8,100,12,130
9143,NYJ,2007,2007-11-22,4:20,3:20,@,DAL,12,11,Thu,L 3-34,,4,30,2,10,6,40
9144,NYJ,2007,2007-12-23,4:15,3:15,@,TEN,16,15,Sun,L 6-10,,4,35,5,39,9,74
9145,NYJ,2008,2008-09-28,1:02,1:02,,ARI,4,4,Sun,W 56-35,,4,61,11,71,15,132
9146,NYJ,2008,2008-10-12,1:02,1:02,,CIN,6,5,Sun,W 26-14,,4,25,4,23,8,48
9147,NYJ,2008,2008-10-26,1:05,1:05,,KAN,8,7,Sun,W 28-24,,4,20,4,39,8,59
9148,NYJ,2008,2008-11-13,8:15,8:15,@,NWE,11,10,Thu,W 34-31,OT,4,25,5,29,9,54
9149,NYJ,2008,2008-11-30,4:15,4:15,,DEN,13,12,Sun,L 17-34,,4,25,6,64,10,89
9150,NYJ,2009,2009-11-15,1:02,1:02,,JAX,10,9,Sun,L 22-24,,4,26,5,40,9,66
9151,NYJ,2009,2010-01-03,8:31,8:31,,CIN,17,16,Sun,W 37-0,,4,20,7,44,11,64
9152,NYJ,2010,2010-10-03,1:02,1:02,@,BUF,4,4,Sun,W 38-14,,4,30,3,32,7,62
9153,NYJ,2010,2010-11-21,1:03,1:03,,HOU,11,10,Sun,W 30-27,,4,39,3,25,7,64
9154,NYJ,2010,2010-12-06,8:40,8:40,@,NWE,13,12,Mon,L 3-45,,4,56,1,10,5,66
9155,NYJ,2011,2011-11-27,1:02,1:02,,BUF,12,11,Sun,W 28-24,,4,40,9,85,13,125
9156,NYJ,2011,2011-12-11,1:02,1:02,,KAN,14,13,Sun,W 37-10,,4,22,11,128,15,150
9157,NYJ,2012,2012-09-30,1:03,1:03,,SFO,4,4,Sun,L 0-34,,4,30,8,67,12,97
9158,NYJ,2012,2012-12-17,8:40,7:40,@,TEN,15,14,Mon,L 10-14,,4,23,14,111,18,134
9159,NYJ,2012,2012-12-30,1:02,1:02,@,BUF,17,16,Sun,L 9-28,,4,45,4,24,8,69
9160,NYJ,2013,2013-10-27,4:06,4:06,@,CIN,8,8,Sun,L 9-49,,4,69,4,45,8,114
9161,NYJ,2013,2013-11-17,1:02,1:02,@,BUF,11,10,Sun,L 14-37,,4,24,8,64,12,88
9162,NYJ,2013,2013-12-01,1:02,1:02,,MIA,13,12,Sun,L 3-23,,4,25,3,28,7,53
9163,NYJ,2013,2013-12-08,1:02,1:02,,OAK,14,13,Sun,W 37-27,,4,36,4,31,8,67
9164,NYJ,2014,2014-12-07,1:02,12:02,@,MIN,14,13,Sun,L 24-30,OT,4,40,6,70,10,110
9165,NYJ,2015,2015-09-13,1:04,1:04,,CLE,1,1,Sun,W 31-10,,4,30,12,109,16,139
9166,NYJ,2015,2015-10-25,1:02,1:02,@,NWE,7,6,Sun,L 23-30,,4,29,4,38,8,67
9167,NYJ,2016,2016-10-09,1:02,1:02,@,PIT,5,5,Sun,L 13-31,,4,18,1,10,5,28
9168,NYJ,2016,2016-10-23,1:04,1:04,,BAL,7,7,Sun,W 24-16,,4,25,4,35,8,60
9169,NYJ,2016,2016-11-13,1:00,1:00,,LAR,10,10,Sun,L 6-9,,4,31,7,55,11,86
9170,NYJ,2017,2017-12-10,4:05,2:05,@,DEN,14,13,Sun,L 0-23,,4,20,3,21,7,41
9171,NYJ,2018,2018-10-07,1:00,1:00,,DEN,5,5,Sun,W 34-16,,4,33,6,45,10,78
9172,NYJ,2018,2018-12-30,1:00,1:00,@,NWE,17,16,Sun,L 3-38,,4,30,4,30,8,60
9173,NYJ,2019,2019-11-24,1:00,1:00,,OAK,12,11,Sun,W 34-3,,4,37,4,35,8,72
9174,NYJ,2020,2020-11-09,8:15,8:15,,NWE,9,9,Mon,L 27-30,,4,32,6,81,10,113
9175,NYJ,2021,2022-01-09,1:00,1:00,@,BUF,18,17,Sun,L 10-27,,4,27,4,40,8,67
9176,TEN,2000,2000-10-22,1:02,1:02,@,BAL,8,7,Sun,W 14-6,,4,20,8,52,12,72
9177,TEN,2000,2000-11-26,4:15,4:15,@,JAX,13,12,Sun,L 13-16,,4,40,4,25,8,65
9178,TEN,2001,2001-10-29,9:05,9:05,@,PIT,7,6,Mon,L 7-34,,4,41,4,20,8,61
9179,TEN,2002,2002-12-08,1:03,12:03,,IND,14,13,Sun,W 27-17,,4,19,6,48,10,67
9180,TEN,2002,2002-12-22,1:03,1:03,@,JAX,16,15,Sun,W 28-10,,4,30,8,51,12,81
9181,TEN,2003,2003-12-28,1:03,12:03,,TAM,17,16,Sun,W 33-13,,4,50,4,31,8,81
9182,TEN,2004,2004-10-03,4:15,1:15,@,SDG,4,4,Sun,L 17-38,,4,25,7,41,11,66
9183,TEN,2004,2004-10-17,1:02,12:02,,HOU,6,6,Sun,L 10-20,,4,35,4,19,8,54
9184,TEN,2004,2004-11-14,1:03,12:03,,CHI,10,9,Sun,L 17-19,OT,4,25,6,50,10,75
9185,TEN,2004,2004-11-21,1:02,1:02,@,JAX,11,10,Sun,W 18-15,,4,49,3,22,7,71
9186,TEN,2005,2005-12-11,1:03,12:03,,HOU,14,13,Sun,W 13-10,,4,56,8,72,12,128
9187,TEN,2005,2005-12-18,1:03,12:03,,SEA,15,14,Sun,L 24-28,,4,30,4,38,8,68
9188,TEN,2006,2006-11-05,1:03,1:03,@,JAX,9,8,Sun,L 7-37,,4,20,4,20,8,40
9189,TEN,2006,2006-12-17,1:03,12:03,,JAX,15,14,Sun,W 24-17,,4,40,2,25,6,65
9190,TEN,2007,2007-09-09,1:04,1:04,@,JAX,1,1,Sun,W 13-10,,4,29,4,45,8,74
9191,TEN,2007,2007-09-16,1:02,12:02,,IND,2,2,Sun,L 20-22,,4,40,5,44,9,84
9192,TEN,2007,2007-12-09,1:02,12:02,,SDG,14,13,Sun,L 17-23,OT,4,21,4,30,8,51
9193,TEN,2008,2008-09-28,1:03,12:03,,MIN,4,4,Sun,W 30-17,,4,18,7,50,11,68
9194,TEN,2008,2008-10-27,8:39,7:39,,IND,8,7,Mon,W 31-21,,4,40,5,35,9,75
9195,TEN,2008,2008-12-21,1:02,12:02,,PIT,16,15,Sun,W 31-14,,4,45,3,17,7,62
9196,TEN,2009,2009-11-01,4:05,3:05,,JAX,8,7,Sun,W 30-13,,4,20,2,27,6,47
9197,TEN,2009,2009-12-06,1:03,1:03,@,IND,13,12,Sun,L 17-27,,4,50,5,40,9,90
9198,TEN,2009,2009-12-13,4:05,3:05,,STL,14,13,Sun,W 47-7,,4,40,10,82,14,122
9199,TEN,2009,2009-12-20,1:02,12:02,,MIA,15,14,Sun,W 27-24,OT,4,46,8,60,12,106
9200,TEN,2010,2010-10-10,4:16,3:16,@,DAL,5,5,Sun,W 34-27,,4,40,12,133,16,173
9201,TEN,2010,2010-12-05,1:03,12:03,,JAX,13,12,Sun,L 6-17,,4,30,4,31,8,61
9202,TEN,2012,2012-11-11,1:03,1:03,@,MIA,10,10,Sun,W 37-3,,4,39,7,67,11,106
9203,TEN,2012,2012-12-02,1:02,12:02,,HOU,13,12,Sun,L 10-24,,4,35,11,97,15,132
9204,TEN,2013,2013-09-29,4:05,3:05,,NYJ,4,4,Sun,W 38-13,,4,30,10,66,14,96
9205,TEN,2013,2013-11-14,8:29,7:29,,IND,11,10,Thu,L 27-30,,4,34,5,51,9,85
9206,TEN,2014,2014-12-28,1:02,12:02,,IND,17,16,Sun,L 10-27,,4,20,4,20,8,40
9207,TEN,2015,2015-11-15,1:03,12:03,,CAR,10,9,Sun,L 10-27,,4,30,5,45,9,75
9208,TEN,2015,2015-11-29,1:02,12:02,,OAK,12,11,Sun,L 21-24,,4,25,11,94,15,119
9209,TEN,2015,2015-12-06,1:02,12:02,,JAX,13,12,Sun,W 42-39,,4,38,6,21,10,59
9210,TEN,2015,2015-12-27,1:02,12:02,,HOU,16,15,Sun,L 6-34,,4,43,4,28,8,71
9211,TEN,2017,2017-10-16,8:30,7:30,,IND,6,6,Mon,W 36-22,,4,45,5,51,9,96
9212,TEN,2018,2018-09-23,1:00,1:00,@,JAX,3,3,Sun,W 9-6,,4,30,8,75,12,105
9213,TEN,2018,2018-09-30,1:00,12:00,,PHI,4,4,Sun,W 26-23,OT,4,30,8,77,12,107
9214,TEN,2018,2018-10-14,4:25,3:25,,BAL,6,6,Sun,L 0-21,,4,35,10,70,14,105
9215,TEN,2018,2018-10-21,9:30,2:30,@,LAC,7,7,Sun,L 19-20,,4,32,4,31,8,63
9216,TEN,2018,2018-11-11,1:00,12:00,,NWE,10,9,Sun,W 34-10,,4,35,4,31,8,66
9217,TEN,2018,2018-12-16,1:00,1:00,@,NYG,15,14,Sun,W 17-0,,4,35,10,58,14,93
9218,TEN,2019,2019-12-08,4:25,1:25,@,OAK,14,13,Sun,W 42-21,,4,21,3,20,7,41
9219,TEN,2019,2019-12-15,1:00,12:00,,HOU,15,14,Sun,L 21-24,,4,30,5,27,9,57
9220,TEN,2020,2020-09-20,1:00,12:00,,JAX,2,2,Sun,W 33-30,,4,30,8,60,12,90
9221,TEN,2020,2020-09-27,1:00,3:00,@,MIN,3,3,Sun,W 31-30,,4,45,3,20,7,65
9222,TEN,2020,2020-11-22,1:00,1:00,@,BAL,11,10,Sun,W 30-24,OT,4,44,6,81,10,125
9223,TEN,2021,2021-09-26,1:00,12:00,,IND,3,3,Sun,W 25-16,,4,24,4,66,8,90
9224,TEN,2021,2021-11-07,8:20,5:20,@,LAR,9,9,Sun,W 28-16,,4,19,12,115,16,134
9225,PHI,2000,2000-09-03,4:05,3:05,@,DAL,1,1,Sun,W 41-14,,4,25,9,93,13,118
9226,PHI,2000,2000-10-22,1:03,1:03,,CHI,8,8,Sun,W 13-9,,4,35,7,50,11,85
9227,PHI,2000,2000-12-10,1:03,1:03,@,CLE,15,15,Sun,W 35-24,,4,21,6,55,10,76
9228,PHI,2000,2000-12-24,1:03,1:03,,CIN,17,16,Sun,W 16-7,,4,34,6,39,10,73
9229,PHI,2001,2001-12-09,1:03,1:03,,SDG,13,12,Sun,W 24-14,,4,30,7,67,11,97
9230,PHI,2002,2002-09-16,9:05,9:05,@,WAS,2,2,Mon,W 37-7,,4,30,7,55,11,85
9231,PHI,2002,2002-09-29,1:02,1:02,,HOU,4,4,Sun,W 35-17,,4,32,11,83,15,115
9232,PHI,2003,2003-11-30,1:02,1:02,@,CAR,13,12,Sun,W 25-16,,4,35,9,70,13,105
9233,PHI,2004,2004-10-17,1:04,1:04,,CAR,6,5,Sun,W 30-8,,4,38,8,45,12,83
9234,PHI,2007,2007-11-18,1:02,1:02,,MIA,11,10,Sun,W 17-7,,4,40,3,15,7,55
9235,PHI,2007,2007-12-16,4:15,3:15,@,DAL,15,14,Sun,W 10-6,,4,35,6,45,10,80
9236,PHI,2007,2007-12-23,1:02,12:02,@,NOR,16,15,Sun,W 38-23,,4,29,6,64,10,93
9237,PHI,2008,2008-09-07,1:02,1:02,,STL,1,1,Sun,W 38-3,,4,41,9,66,13,107
9238,PHI,2008,2008-10-05,1:04,1:04,,WAS,5,5,Sun,L 17-23,,4,33,3,24,7,57
9239,PHI,2009,2009-10-18,4:05,1:05,@,OAK,6,5,Sun,L 9-13,,4,38,3,23,7,61
9240,PHI,2009,2009-12-20,4:16,4:16,,SFO,15,14,Sun,W 27-13,,4,69,8,55,12,124
9241,PHI,2010,2011-01-02,4:15,4:15,,DAL,17,16,Sun,L 13-14,,4,40,6,45,10,85
9242,PHI,2011,2011-09-18,8:30,8:30,@,ATL,2,2,Sun,L 31-35,,4,20,7,57,11,77
9243,PHI,2012,2012-12-23,1:03,1:03,,WAS,16,15,Sun,L 20-27,,4,25,3,24,7,49
9244,PHI,2013,2013-10-27,1:02,1:02,,NYG,8,8,Sun,L 7-15,,4,48,11,92,15,140
9245,PHI,2014,2014-10-05,1:02,1:02,,STL,5,5,Sun,W 34-28,,4,39,10,82,14,121
9246,PHI,2014,2014-11-27,4:36,3:36,@,DAL,13,12,Thu,W 33-10,,4,20,6,42,10,62
9247,PHI,2014,2014-12-07,4:25,4:25,,SEA,14,13,Sun,L 14-24,,4,69,8,67,12,136
9248,PHI,2015,2015-10-11,1:04,1:04,,NOR,5,5,Sun,W 39-17,,4,35,7,78,11,113
9249,PHI,2016,2016-11-06,1:00,1:00,@,NYG,9,8,Sun,L 23-28,,4,43,5,30,9,73
9250,PHI,2016,2017-01-01,1:00,1:00,,DAL,17,16,Sun,W 27-13,,4,61,5,35,9,96
9251,PHI,2017,2017-09-17,1:00,12:00,@,KAN,2,2,Sun,L 20-27,,4,30,5,40,9,70
9252,PHI,2017,2017-10-29,1:00,1:00,,SFO,8,8,Sun,W 33-10,,4,35,6,69,10,104
9253,PHI,2018,2018-10-11,8:20,8:20,@,NYG,6,6,Thu,W 34-13,,4,25,5,61,9,86
9254,PHI,2018,2018-10-21,1:00,1:00,,CAR,7,7,Sun,L 17-21,,4,35,5,78,9,113
9255,PHI,2018,2018-10-28,9:30,2:30,@,JAX,8,8,Sun,W 24-18,,4,36,5,45,9,81
9256,PHI,2019,2019-09-22,1:00,1:00,,DET,3,3,Sun,L 24-27,,4,30,9,61,13,91
9257,PHI,2019,2019-10-27,1:00,1:00,@,BUF,8,8,Sun,W 31-13,,4,44,8,57,12,101
9258,PHI,2019,2019-12-09,8:15,8:15,,NYG,14,13,Mon,W 23-17,OT,4,30,7,54,11,84
9259,PHI,2019,2019-12-22,4:25,4:25,,DAL,16,15,Sun,W 17-9,,4,30,2,20,6,50
9260,PHI,2020,2020-11-01,8:20,8:20,,DAL,8,8,Sun,W 23-9,,4,28,7,68,11,96
9261,PHI,2020,2020-12-06,4:25,3:25,@,GNB,13,12,Sun,L 16-30,,4,40,5,30,9,70
9262,PHI,2021,2021-10-14,8:20,8:20,,TAM,6,6,Thu,L 22-28,,4,41,7,120,11,161
9263,PHI,2021,2021-10-24,4:05,1:05,@,LVR,7,7,Sun,L 22-33,,4,37,7,65,11,102
9264,PHI,2021,2021-11-28,1:00,1:00,@,NYG,12,12,Sun,L 7-13,,4,26,2,15,6,41
9265,PHI,2021,2021-12-21,7:00,7:00,,WAS,15,14,Tue,W 27-17,,4,48,2,25,6,73
9266,PIT,2000,2000-09-17,1:02,1:02,@,CLE,3,2,Sun,L 20-23,,4,35,4,26,8,61
9267,PIT,2000,2000-11-05,1:03,12:03,@,TEN,10,9,Sun,L 7-9,,4,25,14,115,18,140
9268,PIT,2000,2000-11-19,8:35,8:35,,JAX,12,11,Sun,L 24-34,,4,30,8,55,12,85
9269,PIT,2000,2000-11-26,1:02,1:02,@,CIN,13,12,Sun,W 48-28,,4,35,3,15,7,50
9270,PIT,2001,2001-09-09,1:05,1:05,@,JAX,1,1,Sun,L 3-21,,4,29,4,31,8,60
9271,PIT,2001,2001-10-07,1:02,1:02,,CIN,4,3,Sun,W 16-7,,4,29,6,35,10,64
9272,PIT,2001,2001-10-29,9:05,9:05,,TEN,7,6,Mon,W 34-7,,4,20,4,41,8,61
9273,PIT,2001,2001-12-09,4:15,4:15,,NYJ,13,12,Sun,W 18-7,,4,40,3,30,7,70
9274,PIT,2002,2002-10-21,9:08,9:08,,IND,7,6,Mon,W 28-10,,4,38,7,55,11,93
9275,PIT,2002,2002-11-10,1:01,1:01,,ATL,10,9,Sun,T 34-34,OT,4,25,11,95,15,120
9276,PIT,2002,2002-11-17,1:03,12:03,@,TEN,11,10,Sun,L 23-31,,4,20,5,36,9,56
9277,PIT,2002,2002-12-01,1:05,1:05,@,JAX,13,12,Sun,W 25-23,,4,25,0,0,4,25
9278,PIT,2003,2003-12-14,1:03,1:03,@,NYJ,15,14,Sun,L 0-6,,4,19,4,40,8,59
9279,PIT,2004,2004-11-07,1:02,1:02,,PHI,9,8,Sun,W 27-3,,4,20,5,25,9,45
9280,PIT,2005,2005-10-31,9:07,9:07,,BAL,8,7,Mon,W 20-19,,4,19,6,38,10,57
9281,PIT,2005,2005-11-06,4:15,3:15,@,GNB,9,8,Sun,W 20-10,,4,53,8,74,12,127
9282,PIT,2005,2005-11-13,8:36,8:36,,CLE,10,9,Sun,W 34-21,,4,30,9,75,13,105
9283,PIT,2006,2006-10-08,8:15,5:15,@,SDG,5,4,Sun,L 13-23,,4,30,2,10,6,40
9284,PIT,2006,2006-11-26,1:02,1:02,@,BAL,12,11,Sun,L 0-27,,4,28,10,87,14,115
9285,PIT,2006,2006-12-07,8:04,8:04,,CLE,14,13,Thu,W 27-7,,4,25,5,60,9,85
9286,PIT,2007,2007-12-16,1:03,1:03,,JAX,15,14,Sun,L 22-29,,4,34,1,10,5,44
9287,PIT,2008,2008-09-07,1:02,1:02,,HOU,1,1,Sun,W 38-17,,4,41,5,43,9,84
9288,PIT,2008,2008-11-20,8:15,8:15,,CIN,12,11,Thu,W 27-10,,4,40,2,15,6,55
9289,PIT,2009,2009-10-18,1:01,1:01,,CLE,6,6,Sun,W 27-14,,4,30,4,45,8,75
9290,PIT,2009,2009-11-09,8:41,6:41,@,DEN,9,8,Mon,W 28-10,,4,28,3,25,7,53
9291,PIT,2009,2009-12-06,1:02,1:02,,OAK,13,12,Sun,L 24-27,,4,41,9,70,13,111
9292,PIT,2009,2009-12-10,8:21,8:21,@,CLE,14,13,Thu,L 6-13,,4,40,6,55,10,95
9293,PIT,2009,2009-12-27,1:02,1:02,,BAL,16,15,Sun,W 23-20,,4,20,11,113,15,133
9294,PIT,2010,2010-09-12,1:02,1:02,,ATL,1,1,Sun,W 15-9,OT,4,25,3,24,7,49
9295,PIT,2010,2010-10-17,1:02,1:02,,CLE,6,5,Sun,W 28-10,,4,25,3,41,7,66
9296,PIT,2010,2010-10-31,8:30,7:30,@,NOR,8,7,Sun,L 10-20,,4,38,3,35,7,73
9297,PIT,2010,2010-12-23,8:29,8:29,,CAR,16,15,Thu,W 27-3,,4,40,6,62,10,102
9298,PIT,2011,2011-09-18,1:02,1:02,,SEA,2,2,Sun,W 24-0,,4,48,6,66,10,114
9299,PIT,2011,2011-09-25,8:30,8:30,@,IND,3,3,Sun,W 23-20,,4,38,3,21,7,59
9300,PIT,2011,2011-11-13,1:02,1:02,@,CIN,10,10,Sun,W 24-17,,4,31,4,35,8,66
9301,PIT,2011,2011-12-04,1:02,1:02,,CIN,13,12,Sun,W 35-7,,4,29,10,109,14,138
9302,PIT,2011,2012-01-01,4:16,4:16,@,CLE,17,16,Sun,W 13-9,,4,37,5,40,9,77
9303,PIT,2012,2012-10-11,8:29,7:29,@,TEN,6,5,Thu,L 23-26,,4,50,5,45,9,95
9304,PIT,2012,2012-12-02,4:25,4:25,@,BAL,13,12,Sun,W 23-20,,4,50,8,70,12,120
9305,PIT,2013,2013-09-08,1:02,1:02,,TEN,1,1,Sun,L 9-16,,4,47,6,60,10,107
9306,PIT,2013,2013-09-29,1:07,6:07,@,MIN,4,4,Sun,L 27-34,,4,50,5,89,9,139
9307,PIT,2013,2013-11-17,1:02,1:02,,DET,11,10,Sun,W 37-27,,4,23,8,45,12,68
9308,PIT,2013,2013-11-28,8:31,8:31,@,BAL,13,12,Thu,L 20-22,,4,51,9,55,13,106
9309,PIT,2013,2013-12-15,8:30,8:30,,CIN,15,14,Sun,W 30-20,,4,25,6,50,10,75
9310,PIT,2014,2014-11-17,8:30,7:30,@,TEN,11,11,Mon,W 27-24,,4,39,1,10,5,49
9311,PIT,2014,2014-12-21,1:02,1:02,,KAN,16,15,Sun,W 20-12,,4,40,4,39,8,79
9312,PIT,2015,2015-09-27,1:00,12:00,@,STL,3,3,Sun,W 12-6,,4,63,7,97,11,160
9313,PIT,2015,2015-10-01,8:26,8:26,,BAL,4,4,Thu,L 20-23,OT,4,20,4,30,8,50
9314,PIT,2015,2015-12-06,8:30,8:30,,IND,13,12,Sun,W 45-10,,4,48,5,30,9,78
9315,PIT,2016,2016-09-12,7:11,7:11,@,WAS,1,1,Mon,W 38-16,,4,81,9,55,13,136
9316,PIT,2016,2016-11-13,4:25,4:25,,DAL,10,9,Sun,L 30-35,,4,40,10,98,14,138
9317,PIT,2016,2016-12-25,4:30,4:30,,BAL,16,15,Sun,W 31-27,,4,45,7,95,11,140
9318,PIT,2017,2017-12-25,4:30,3:30,@,HOU,16,15,Mon,W 34-6,,4,24,7,80,11,104
9319,PIT,2018,2018-12-16,4:25,4:25,,NWE,15,14,Sun,W 17-10,,4,40,14,106,18,146
9320,PIT,2019,2019-09-30,8:15,8:15,,CIN,4,4,Mon,W 27-3,,4,37,8,60,12,97
9321,PIT,2019,2019-12-08,4:25,2:25,@,ARI,14,13,Sun,W 23-17,,4,20,7,75,11,95
9322,PIT,2019,2019-12-22,1:00,1:00,@,NYJ,16,15,Sun,L 10-16,,4,34,3,30,7,64
9323,PIT,2020,2020-12-21,8:15,8:15,@,CIN,15,14,Mon,L 17-27,,4,30,2,16,6,46
9324,PIT,2021,2021-11-28,1:00,1:00,@,CIN,12,11,Sun,L 10-41,,4,30,3,18,7,48
9325,OAK,2001,2001-11-25,4:15,4:15,@,NYG,11,10,Sun,W 28-10,,4,30,5,40,9,70
9326,OAK,2001,2001-12-22,9:00,6:00,,TEN,15,14,Sat,L 10-13,,4,66,7,54,11,120
9327,OAK,2002,2002-12-28,5:15,2:15,,KAN,17,16,Sat,W 24-0,,4,25,1,5,5,30
9328,OAK,2008,2008-09-21,1:02,1:02,@,BUF,3,3,Sun,L 23-24,,4,25,4,25,8,50
9329,OAK,2008,2008-12-28,1:02,1:02,@,TAM,17,16,Sun,W 31-24,,4,25,6,83,10,108
9330,OAK,2010,2010-11-28,4:05,1:05,,MIA,12,11,Sun,L 17-33,,4,20,5,35,9,55
9331,OAK,2010,2010-12-12,1:02,1:02,@,JAX,14,13,Sun,L 31-38,,4,25,6,52,10,77
9332,OAK,2012,2012-11-18,4:05,1:05,,NOR,11,10,Sun,L 17-38,,4,40,11,109,15,149
9333,OAK,2013,2013-09-29,4:25,1:25,,WAS,4,4,Sun,L 14-24,,4,25,3,29,7,54
9334,OAK,2013,2013-11-24,4:05,1:05,,TEN,12,11,Sun,L 19-23,,4,50,10,100,14,150
9335,OAK,2013,2013-12-08,1:02,1:02,@,NYJ,14,13,Sun,L 27-37,,4,31,4,36,8,67
9336,OAK,2014,2014-09-07,1:02,1:02,@,NYJ,1,1,Sun,L 14-19,,4,20,11,105,15,125
9337,OAK,2014,2014-11-09,4:05,1:05,,DEN,10,9,Sun,L 17-41,,4,37,12,95,16,132
9338,OAK,2014,2014-12-21,4:25,1:25,,BUF,16,15,Sun,W 26-24,,4,35,7,55,11,90
9339,OAK,2015,2015-12-06,4:05,1:05,,KAN,13,12,Sun,L 20-34,,4,21,11,88,15,109
9340,OAK,2016,2016-11-21,8:30,7:30,,HOU,11,10,Mon,W 27-20,,4,21,7,101,11,122
9341,OAK,2017,2017-09-24,8:30,8:30,@,WAS,3,3,Sun,L 10-27,,4,35,10,77,14,112
9342,OAK,2018,2018-09-16,4:25,2:25,@,DEN,2,2,Sun,L 19-20,,4,30,6,35,10,65
9343,OAK,2018,2018-11-18,4:05,2:05,@,ARI,11,10,Sun,W 23-21,,4,20,7,62,11,82
9344,OAK,2018,2018-11-25,1:00,1:00,@,BAL,12,11,Sun,L 17-34,,4,24,6,45,10,69
9345,OAK,2018,2018-12-30,4:25,12:00,@,KAN,17,16,Sun,L 3-35,,4,22,4,50,8,72
9346,OAK,2019,2019-11-24,1:00,1:00,@,NYJ,12,11,Sun,L 3-34,,4,35,4,37,8,72
9347,LVR,2020,2020-10-25,4:05,1:05,,TAM,7,6,Sun,L 20-45,,4,35,4,20,8,55
9348,LVR,2020,2020-12-26,8:15,5:15,,MIA,16,15,Sat,L 25-26,,4,40,5,76,9,116
9349,LVR,2021,2022-01-09,4:25,1:25,,LAC,18,17,Sun,W 35-32,OT,4,38,10,108,14,146
9350,STL,2000,2000-09-10,4:15,1:15,@,SEA,2,2,Sun,W 37-34,,4,16,1,10,5,26
9351,STL,2000,2000-10-01,1:02,12:02,,SDG,5,5,Sun,W 57-31,,4,36,3,15,7,51
9352,STL,2001,2001-10-21,1:02,1:02,@,NYJ,6,6,Sun,W 34-14,,4,33,9,66,13,99
9353,STL,2001,2001-12-23,1:02,1:02,@,CAR,15,14,Sun,W 38-32,,4,33,4,30,8,63
9354,STL,2001,2001-12-30,1:02,12:02,,IND,16,15,Sun,W 42-17,,4,48,4,38,8,86
9355,STL,2002,2002-10-06,4:15,1:15,@,SFO,5,5,Sun,L 13-37,,4,40,4,27,8,67
9356,STL,2003,2003-09-14,1:02,12:02,,SFO,2,2,Sun,W 27-24,OT,4,43,13,121,17,164
9357,STL,2003,2003-11-30,1:02,12:02,,MIN,13,12,Sun,W 48-17,,4,25,11,65,15,90
9358,STL,2005,2005-09-18,4:05,1:05,@,ARI,2,2,Sun,W 17-12,,4,30,8,72,12,102
9359,STL,2005,2005-12-04,4:05,3:05,,WAS,13,12,Sun,L 9-24,,4,30,8,76,12,106
9360,STL,2005,2005-12-24,1:02,12:02,,SFO,16,15,Sat,L 20-24,,4,24,6,39,10,63
9361,STL,2006,2006-10-29,4:05,1:05,@,SDG,8,7,Sun,L 24-38,,4,20,3,43,7,63
9362,STL,2006,2006-12-31,1:05,12:05,@,MIN,17,16,Sun,W 41-21,,4,62,5,35,9,97
9363,STL,2007,2007-09-16,1:02,12:02,,SFO,2,2,Sun,L 16-17,,4,34,3,21,7,55
9364,STL,2007,2007-10-28,1:00,12:00,,CLE,8,8,Sun,L 20-27,,4,30,14,102,18,132
9365,STL,2007,2007-11-25,1:00,12:00,,SEA,12,11,Sun,L 19-24,,4,20,6,45,10,65
9366,STL,2007,2007-12-09,1:02,1:02,@,CIN,14,13,Sun,L 10-19,,4,53,4,20,8,73
9367,STL,2008,2008-11-02,1:00,12:00,,ARI,9,8,Sun,L 13-34,,4,41,10,69,14,110
9368,STL,2008,2008-11-09,1:03,1:03,@,NYJ,10,9,Sun,L 3-47,,4,25,5,24,9,49
9369,STL,2009,2009-11-15,1:00,12:00,,NOR,10,9,Sun,L 23-28,,4,20,6,40,10,60
9370,STL,2009,2009-11-29,1:00,12:00,,SEA,12,11,Sun,L 17-27,,4,35,7,52,11,87
9371,STL,2009,2009-12-27,4:05,2:05,@,ARI,16,15,Sun,L 10-31,,4,20,3,15,7,35
9372,STL,2010,2010-11-28,4:16,2:16,@,DEN,12,11,Sun,W 36-33,,4,30,6,60,10,90
9373,STL,2010,2010-12-12,4:05,3:05,@,NOR,14,13,Sun,L 13-31,,4,39,5,55,9,94
9374,STL,2011,2011-10-23,4:15,3:15,@,DAL,7,6,Sun,L 7-34,,4,16,6,30,10,46
9375,STL,2011,2011-12-24,1:02,1:02,@,PIT,16,15,Sat,L 0-27,,4,21,7,50,11,71
9376,STL,2012,2012-09-23,1:04,12:04,@,CHI,3,3,Sun,L 6-23,,4,40,6,45,10,85
9377,STL,2013,2013-12-15,4:25,3:25,,NOR,15,14,Sun,W 27-16,,4,30,8,77,12,107
9378,STL,2015,2015-09-13,1:00,12:00,,SEA,1,1,Sun,W 34-31,OT,4,30,7,46,11,76
9379,LAR,2016,2016-12-04,1:00,1:00,@,NWE,13,12,Sun,L 10-26,,4,30,8,46,12,76
9380,LAR,2018,2018-11-04,4:25,3:25,@,NOR,9,9,Sun,L 35-45,,4,32,2,20,6,52
9381,LAR,2020,2020-09-20,1:00,1:00,@,PHI,2,2,Sun,W 37-19,,4,24,5,30,9,54
9382,LAR,2020,2020-10-26,8:15,5:15,,CHI,7,7,Mon,W 24-10,,4,46,6,46,10,92
9383,LAR,2020,2020-11-15,4:25,1:25,,SEA,10,9,Sun,W 23-16,,4,49,4,23,8,72
9384,LAR,2021,2021-09-12,8:20,5:20,,CHI,1,1,Sun,W 34-14,,4,36,3,35,7,71
9385,LAR,2021,2021-10-24,4:05,1:05,,DET,7,7,Sun,W 28-19,,4,35,8,77,12,112
9386,LAR,2021,2021-11-28,4:25,3:25,@,GNB,12,11,Sun,L 28-36,,4,30,3,32,7,62
9387,LAR,2021,2021-12-21,7:00,4:00,,SEA,15,14,Tue,W 20-10,,4,34,8,65,12,99
9388,LAR,2021,2022-01-02,4:25,4:25,@,BAL,17,16,Sun,W 20-19,,4,35,4,24,8,59
9389,BAL,2000,2000-09-17,8:36,8:36,@,MIA,3,3,Sun,L 6-19,,4,20,6,38,10,58
9390,BAL,2000,2000-10-29,1:02,1:02,,PIT,9,9,Sun,L 6-9,,4,20,3,20,7,40
9391,BAL,2001,2001-10-28,1:01,1:01,,JAX,7,7,Sun,W 18-17,,4,34,10,70,14,104
9392,BAL,2001,2001-11-04,1:01,1:01,@,PIT,8,8,Sun,W 13-10,,4,25,2,25,6,50
9393,BAL,2002,2002-10-20,1:02,1:02,,JAX,7,6,Sun,W 17-10,,4,30,5,30,9,60
9394,BAL,2003,2003-09-21,4:15,1:15,@,SDG,3,3,Sun,W 24-10,,4,28,10,61,14,89
9395,BAL,2003,2003-09-28,4:05,4:05,,KAN,4,4,Sun,L 10-17,,4,30,4,26,8,56
9396,BAL,2003,2003-11-30,1:02,1:02,,SFO,13,12,Sun,W 44-6,,4,25,6,46,10,71
9397,BAL,2004,2004-10-24,1:02,1:02,,BUF,7,6,Sun,W 20-6,,4,25,5,40,9,65
9398,BAL,2004,2004-11-21,1:02,1:02,,DAL,11,10,Sun,W 30-10,,4,30,4,20,8,50
9399,BAL,2004,2004-12-05,1:02,1:02,,CIN,13,12,Sun,L 26-27,,4,30,5,45,9,75
9400,BAL,2006,2006-09-10,1:01,1:01,@,TAM,1,1,Sun,W 27-0,,4,25,3,21,7,46
9401,BAL,2006,2006-10-01,1:02,1:02,,SDG,4,4,Sun,W 16-13,,4,30,10,78,14,108
9402,BAL,2006,2006-12-17,1:02,1:02,,CLE,15,14,Sun,W 27-17,,4,30,7,50,11,80
9403,BAL,2008,2008-10-12,1:02,1:02,@,IND,6,5,Sun,L 3-31,,4,33,11,84,15,117
9404,BAL,2008,2008-12-07,8:23,8:23,,WAS,14,13,Sun,W 24-10,,4,35,7,39,11,74
9405,BAL,2009,2009-09-20,4:15,1:15,@,SDG,2,2,Sun,W 31-26,,4,32,12,85,16,117
9406,BAL,2009,2009-12-20,4:15,4:15,,CHI,15,14,Sun,W 31-7,,4,26,1,9,5,35
9407,BAL,2010,2010-10-24,1:02,1:02,,BUF,7,7,Sun,W 37-34,OT,4,18,6,78,10,96
9408,BAL,2010,2010-11-28,4:15,4:15,,TAM,12,11,Sun,W 17-10,,4,30,9,78,13,108
9409,BAL,2011,2011-11-13,4:06,1:06,@,SEA,10,9,Sun,L 17-22,,4,34,13,100,17,134
9410,BAL,2011,2011-12-04,4:05,4:05,@,CLE,13,12,Sun,W 24-10,,4,18,3,37,7,55
9411,BAL,2012,2012-11-11,1:02,1:02,,OAK,10,9,Sun,W 55-20,,4,41,10,105,14,146
9412,BAL,2012,2012-11-18,8:30,8:30,@,PIT,11,10,Sun,W 13-10,,4,68,6,43,10,111
9413,BAL,2014,2014-09-11,8:28,8:28,,PIT,2,2,Thu,W 26-6,,4,35,9,75,13,110
9414,BAL,2014,2014-09-28,1:02,1:02,,CAR,4,4,Sun,W 38-10,,4,40,7,59,11,99
9415,BAL,2015,2015-10-01,8:26,8:26,@,PIT,4,4,Thu,W 23-20,OT,4,30,4,20,8,50
9416,BAL,2015,2016-01-03,1:02,1:02,@,CIN,17,16,Sun,L 16-24,,4,38,11,72,15,110
9417,BAL,2016,2016-09-18,1:02,1:02,@,CLE,2,2,Sun,W 25-20,,4,29,8,59,12,88
9418,BAL,2016,2016-10-23,1:04,1:04,@,NYJ,7,7,Sun,L 16-24,,4,35,4,25,8,60
9419,BAL,2016,2017-01-01,1:00,1:00,@,CIN,17,16,Sun,L 10-27,,4,41,2,20,6,61
9420,BAL,2018,2018-10-07,1:00,1:00,@,CLE,5,5,Sun,L 9-12,OT,4,41,10,66,14,107
9421,BAL,2018,2018-12-22,8:20,5:20,@,LAC,16,15,Sat,W 22-10,,4,40,8,69,12,109
9422,BAL,2019,2019-09-08,1:00,1:00,@,MIA,1,1,Sun,W 59-10,,4,40,9,64,13,104
9423,BAL,2019,2019-11-03,8:20,8:20,,NWE,9,8,Sun,W 37-20,,4,34,7,48,11,82
9424,BAL,2020,2020-10-11,1:00,1:00,,CIN,5,5,Sun,W 27-3,,4,25,5,40,9,65
9425,BAL,2020,2020-12-08,8:05,8:05,,DAL,13,12,Tue,W 34-17,,4,23,7,58,11,81
9426,BAL,2020,2020-12-20,1:00,1:00,,JAX,15,14,Sun,W 40-14,,4,40,7,67,11,107
9427,BAL,2021,2021-11-11,8:20,8:20,@,MIA,10,9,Thu,L 10-22,,4,20,11,97,15,117
9428,BAL,2021,2022-01-02,4:25,4:25,,LAR,17,16,Sun,L 19-20,,4,24,4,35,8,59
9429,SDG,2000,2000-09-03,4:15,1:15,@,OAK,1,1,Sun,L 6-9,,4,35,8,60,12,95
9430,SDG,2000,2000-12-10,1:02,1:02,@,BAL,15,14,Sun,L 3-24,,4,20,3,15,7,35
9431,SDG,2001,2001-11-04,4:15,1:15,,KAN,8,8,Sun,L 20-25,,4,20,6,61,10,81
9432,SDG,2002,2002-09-08,1:04,1:04,@,CIN,1,1,Sun,W 34-6,,4,39,9,57,13,96
9433,SDG,2002,2002-09-15,4:15,1:15,,HOU,2,2,Sun,W 24-3,,4,35,12,73,16,108
9434,SDG,2002,2002-10-13,4:15,1:15,,KAN,6,6,Sun,W 35-34,,4,35,3,30,7,65
9435,SDG,2003,2003-11-02,1:05,12:05,@,CHI,9,8,Sun,L 7-20,,4,24,5,35,9,59
9436,SDG,2004,2004-10-10,4:05,1:05,,JAX,5,5,Sun,W 34-21,,4,44,5,33,9,77
9437,SDG,2004,2004-12-12,4:15,1:15,,TAM,14,13,Sun,W 31-24,,4,40,12,111,16,151
9438,SDG,2005,2005-10-30,4:05,1:05,,KAN,8,8,Sun,W 28-20,,4,38,9,59,13,97
9439,SDG,2006,2006-11-12,1:03,1:03,@,CIN,10,9,Sun,W 49-41,,4,45,5,44,9,89
9440,SDG,2007,2007-09-30,4:15,1:15,,KAN,4,4,Sun,L 16-30,,4,21,4,28,8,49
9441,SDG,2007,2007-11-18,1:03,1:03,@,JAX,11,10,Sun,L 17-24,,4,31,5,42,9,73
9442,SDG,2007,2007-12-09,1:02,12:02,@,TEN,14,13,Sun,W 23-17,OT,4,30,4,21,8,51
9443,SDG,2008,2008-10-05,1:03,1:03,@,MIA,5,5,Sun,L 10-17,,4,46,1,5,5,51
9444,SDG,2008,2008-12-21,1:02,1:02,@,TAM,16,15,Sun,W 41-24,,4,25,2,25,6,50
9445,SDG,2009,2009-10-19,8:40,5:40,,DEN,6,5,Mon,L 23-34,,4,44,4,48,8,92
9446,SDG,2009,2009-12-20,4:05,1:05,,CIN,15,14,Sun,W 27-24,,4,30,9,55,13,85
9447,SDG,2010,2010-09-19,4:15,1:15,,JAX,2,2,Sun,W 38-13,,4,25,5,33,9,58
9448,SDG,2010,2010-11-28,8:30,8:30,@,IND,12,11,Sun,W 36-14,,4,40,1,15,5,55
9449,SDG,2010,2010-12-16,8:20,5:20,,SFO,15,14,Thu,W 34-7,,4,35,5,60,9,95
9450,SDG,2011,2011-09-11,4:20,1:20,,MIN,1,1,Sun,W 24-17,,4,26,9,78,13,104
9451,SDG,2011,2011-09-25,4:05,1:05,,KAN,3,3,Sun,W 20-17,,4,40,7,65,11,105
9452,SDG,2011,2011-11-27,4:15,1:15,,DEN,12,11,Sun,L 13-16,OT,4,30,9,63,13,93
9453,SDG,2012,2012-09-16,4:25,1:25,,TEN,2,2,Sun,W 38-10,,4,41,8,59,12,100
9454,SDG,2012,2012-09-23,4:05,1:05,,ATL,3,3,Sun,L 3-27,,4,17,2,15,6,32
9455,SDG,2013,2013-09-15,1:02,1:02,@,PHI,2,2,Sun,W 33-30,,4,32,9,77,13,109
9456,SDG,2013,2013-12-12,8:29,6:29,@,DEN,15,14,Thu,W 27-20,,4,35,6,43,10,78
9457,SDG,2013,2013-12-29,4:26,1:26,,KAN,17,16,Sun,W 27-24,OT,4,22,1,5,5,27
9458,SDG,2014,2014-10-19,4:05,1:05,,KAN,7,7,Sun,L 20-23,,4,49,7,73,11,122
9459,SDG,2016,2016-10-09,4:25,1:25,@,OAK,5,5,Sun,L 31-34,,4,38,6,36,10,74
9460,SDG,2016,2016-11-13,4:05,1:05,,MIA,10,10,Sun,L 24-31,,4,29,11,81,15,110
9461,LAC,2017,2017-09-11,10:20,8:20,@,DEN,1,1,Mon,L 21-24,,4,40,3,62,7,102
9462,LAC,2017,2017-10-15,4:25,1:25,@,OAK,6,6,Sun,W 17-16,,4,32,5,40,9,72
9463,LAC,2018,2018-09-23,4:05,1:05,@,LAR,3,3,Sun,L 23-35,,4,30,6,64,10,94
9464,LAC,2018,2018-10-21,9:30,2:30,,TEN,7,7,Sun,W 20-19,,4,31,4,32,8,63
9465,LAC,2018,2018-11-25,4:05,1:05,,ARI,12,11,Sun,W 45-10,,4,30,3,35,7,65
9466,LAC,2019,2019-10-06,4:05,1:05,,DEN,5,5,Sun,L 13-20,,4,43,12,122,16,165
9467,LAC,2019,2019-10-20,4:05,3:05,@,TEN,7,7,Sun,L 20-23,,4,29,7,54,11,83
9468,LAC,2020,2021-01-03,4:25,3:25,@,KAN,17,16,Sun,W 38-21,,4,23,5,69,9,92
9469,LAC,2021,2021-10-17,1:00,1:00,@,BAL,6,6,Sun,L 6-34,,4,35,2,15,6,50
9470,LAC,2021,2021-11-07,4:05,4:05,@,PHI,9,8,Sun,W 27-24,,4,30,3,25,7,55
9471,SEA,2000,2000-09-17,4:15,1:15,,NOR,3,3,Sun,W 20-10,,4,32,4,40,8,72
9472,SEA,2000,2000-12-10,4:05,2:05,@,DEN,15,14,Sun,L 24-31,,4,38,2,15,6,53
9473,SEA,2000,2000-12-23,8:36,5:36,,BUF,17,16,Sat,L 23-42,,4,45,2,10,6,55
9474,SEA,2001,2001-11-25,1:00,12:00,@,KAN,11,10,Sun,L 7-19,,4,35,3,20,7,55
9475,SEA,2001,2001-12-30,4:15,1:15,@,SDG,16,15,Sun,W 25-22,,4,24,10,64,14,88
9476,SEA,2001,2002-01-06,4:16,1:16,,KAN,17,16,Sun,W 21-18,,4,30,2,15,6,45
9477,SEA,2002,2002-09-29,8:35,5:35,,MIN,4,4,Sun,W 48-23,,4,35,8,58,12,93
9478,SEA,2002,2002-11-10,4:06,2:06,@,ARI,10,9,Sun,W 27-6,,4,34,3,20,7,54
9479,SEA,2002,2002-12-22,4:05,1:05,,STL,16,15,Sun,W 30-10,,4,20,12,102,16,122
9480,SEA,2003,2003-09-21,4:06,1:06,,STL,3,3,Sun,W 24-23,,4,30,3,15,7,45
9481,SEA,2003,2003-11-09,1:02,1:02,@,WAS,10,9,Sun,L 20-27,,4,32,4,40,8,72
9482,SEA,2004,2004-10-24,4:16,1:16,@,ARI,7,6,Sun,L 17-25,,4,35,6,45,10,80
9483,SEA,2004,2004-11-14,1:02,12:02,@,STL,10,9,Sun,L 12-23,,4,20,7,55,11,75
9484,SEA,2005,2005-12-18,1:03,12:03,@,TEN,15,14,Sun,W 28-24,,4,38,4,30,8,68
9485,SEA,2006,2006-09-24,4:16,1:16,,NYG,3,3,Sun,W 42-30,,4,22,8,63,12,85
9486,SEA,2006,2006-10-29,1:00,12:00,@,KAN,8,7,Sun,L 28-35,,4,35,6,40,10,75
9487,SEA,2007,2007-09-16,4:05,1:05,@,ARI,2,2,Sun,L 20-23,,4,25,7,55,11,80
9488,SEA,2007,2007-10-07,1:02,1:02,@,PIT,5,5,Sun,L 0-21,,4,25,6,64,10,89
9489,SEA,2007,2007-10-21,4:16,1:16,,STL,7,7,Sun,W 33-6,,4,25,8,45,12,70
9490,SEA,2007,2007-11-04,4:06,4:06,@,CLE,9,8,Sun,L 30-33,OT,4,20,6,49,10,69
9491,SEA,2007,2007-11-12,8:41,5:41,,SFO,10,9,Mon,W 24-0,,4,39,10,53,14,92
9492,SEA,2008,2008-11-02,4:16,1:16,,PHI,9,8,Sun,L 7-26,,4,20,1,15,5,35
9493,SEA,2009,2009-09-13,4:16,1:16,,STL,1,1,Sun,W 28-0,,4,25,10,85,14,110
9494,SEA,2009,2009-09-27,4:06,1:06,,CHI,3,3,Sun,L 19-25,,4,45,6,60,10,105
9495,SEA,2009,2009-12-06,4:16,1:16,,SFO,13,12,Sun,W 20-17,,4,48,8,57,12,105
9496,SEA,2010,2010-12-05,4:16,1:16,,CAR,13,12,Sun,W 31-14,,4,20,8,53,12,73
9497,SEA,2012,2012-10-14,4:04,1:04,,NWE,6,6,Sun,W 24-23,,4,35,6,80,10,115
9498,SEA,2012,2012-11-04,4:06,1:06,,MIN,9,9,Sun,W 30-20,,4,49,6,33,10,82
9499,SEA,2012,2012-12-16,4:05,4:05,@,BUF,15,14,Sun,W 50-17,,4,32,4,20,8,52
9500,SEA,2012,2012-12-23,8:31,5:31,,SFO,16,15,Sun,W 42-13,,4,45,6,58,10,103
9501,SEA,2013,2013-09-22,4:26,1:26,,JAX,3,3,Sun,W 45-17,,4,24,4,45,8,69
9502,SEA,2014,2014-09-04,8:42,5:42,,GNB,1,1,Thu,W 36-16,,4,69,8,65,12,134
9503,SEA,2016,2017-01-01,4:25,1:25,@,SFO,17,16,Sun,W 25-23,,4,34,4,25,8,59
9504,SEA,2018,2018-11-25,1:00,1:00,@,CAR,12,11,Sun,W 30-27,,4,36,3,30,7,66
9505,SEA,2018,2018-12-10,8:15,5:15,,MIN,14,13,Mon,W 21-7,,4,45,4,51,8,96
9506,SEA,2019,2019-11-03,4:05,1:05,,TAM,9,9,Sun,W 40-34,OT,4,45,10,82,14,127
9507,SEA,2020,2020-11-08,1:00,1:00,@,BUF,9,8,Sun,L 34-44,,4,13,6,70,10,83
9508,SEA,2020,2020-11-15,4:25,1:25,@,LAR,10,9,Sun,L 16-23,,4,23,4,49,8,72
9509,SEA,2020,2020-12-13,4:05,1:05,,NYJ,14,13,Sun,W 40-3,,4,35,7,50,11,85
9510,SEA,2020,2020-12-20,1:00,1:00,@,WAS,15,14,Sun,W 20-15,,4,45,6,41,10,86
9511,SEA,2020,2021-01-03,4:25,2:25,@,SFO,17,16,Sun,W 26-23,,4,35,2,25,6,60
9512,SEA,2021,2021-09-26,4:25,2:25,@,MIN,3,3,Sun,L 17-30,,4,35,4,40,8,75
9513,SEA,2021,2022-01-09,4:25,2:25,@,ARI,18,17,Sun,W 38-30,,4,30,6,46,10,76
9514,SFO,2000,2000-10-15,4:15,3:15,@,GNB,7,7,Sun,L 28-31,,4,53,9,65,13,118
9515,SFO,2002,2002-10-06,4:15,1:15,,STL,5,4,Sun,W 37-13,,4,27,4,40,8,67
9516,SFO,2002,2002-12-21,5:05,3:05,@,ARI,16,15,Sat,W 17-14,,4,30,1,15,5,45
9517,SFO,2003,2003-09-07,4:19,1:19,,CHI,1,1,Sun,W 49-7,,4,25,4,30,8,55
9518,SFO,2003,2003-10-05,4:15,1:15,,DET,5,5,Sun,W 24-17,,4,45,5,48,9,93
9519,SFO,2003,2003-11-17,9:09,6:09,,PIT,11,10,Mon,W 30-14,,4,20,3,30,7,50
9520,SFO,2004,2004-11-21,1:01,1:01,@,TAM,11,10,Sun,L 3-35,,4,30,5,50,9,80
9521,SFO,2004,2004-12-26,4:06,1:06,,BUF,16,15,Sun,L 7-41,,4,30,5,46,9,76
9522,SFO,2005,2005-11-27,1:03,12:03,@,TEN,12,11,Sun,L 22-33,,4,35,10,70,14,105
9523,SFO,2006,2006-12-10,4:06,1:06,,GNB,14,13,Sun,L 19-30,,4,25,2,10,6,35
9524,SFO,2007,2007-10-07,4:15,1:15,,BAL,5,5,Sun,L 7-9,,4,48,7,40,11,88
9525,SFO,2007,2007-11-04,1:02,1:02,@,ATL,9,8,Sun,L 16-20,,4,30,5,31,9,61
9526,SFO,2007,2007-12-30,1:03,1:03,@,CLE,17,16,Sun,L 7-20,,4,29,9,75,13,104
9527,SFO,2008,2008-11-30,1:01,1:01,@,BUF,13,12,Sun,W 10-3,,4,35,6,43,10,78
9528,SFO,2008,2008-12-14,1:03,1:03,@,MIA,15,14,Sun,L 9-14,,4,22,8,66,12,88
9529,SFO,2009,2009-09-13,1:15,1:15,@,ARI,1,1,Sun,W 20-16,,4,31,12,82,16,113
9530,SFO,2009,2009-11-22,1:02,12:02,@,GNB,11,10,Sun,L 24-30,,4,30,6,64,10,94
9531,SFO,2009,2009-12-27,4:04,1:04,,DET,16,15,Sun,W 20-6,,4,29,1,10,5,39
9532,SFO,2013,2013-10-13,4:25,1:25,,ARI,6,6,Sun,W 32-20,,4,35,6,38,10,73
9533,SFO,2013,2013-10-27,1:07,5:07,@,JAX,8,8,Sun,W 42-10,,4,35,6,76,10,111
9534,SFO,2013,2013-11-10,4:05,1:05,,CAR,10,9,Sun,L 9-10,,4,25,3,25,7,50
9535,SFO,2013,2013-11-25,8:40,8:40,@,WAS,12,11,Mon,W 27-6,,4,25,4,30,8,55
9536,SFO,2013,2013-12-29,4:25,2:25,@,ARI,17,16,Sun,W 23-20,,4,20,3,30,7,50
9537,SFO,2014,2014-11-16,1:03,1:03,@,NYG,11,10,Sun,W 16-10,,4,35,3,54,7,89
9538,SFO,2015,2015-10-04,4:25,1:25,,GNB,4,4,Sun,L 3-17,,4,30,8,65,12,95
9539,SFO,2015,2015-10-11,8:31,8:31,@,NYG,5,5,Sun,L 27-30,,4,28,6,65,10,93
9540,SFO,2015,2015-10-18,4:25,1:25,,BAL,6,6,Sun,W 25-20,,4,25,3,15,7,40
9541,SFO,2015,2015-10-22,8:26,5:26,,SEA,7,7,Thu,L 3-20,,4,33,6,50,10,83
9542,SFO,2016,2016-09-25,4:05,1:05,@,SEA,3,3,Sun,L 18-37,,4,35,6,50,10,85
9543,SFO,2016,2016-10-06,8:27,5:27,,ARI,5,5,Thu,L 21-33,,4,34,7,50,11,84
9544,SFO,2016,2016-10-23,4:05,1:05,,TAM,7,7,Sun,L 17-34,,4,31,7,78,11,109
9545,SFO,2016,2016-12-18,4:05,4:05,@,ATL,15,14,Sun,L 13-41,,4,20,4,27,8,47
9546,SFO,2016,2017-01-01,4:25,1:25,,SEA,17,16,Sun,L 23-25,,4,25,4,34,8,59
9547,SFO,2017,2017-12-31,4:25,1:25,@,LAR,17,16,Sun,W 34-13,,4,23,6,46,10,69
9548,SFO,2018,2018-09-30,4:25,1:25,@,LAC,4,4,Sun,L 27-29,,4,29,5,49,9,78
9549,SFO,2019,2019-10-07,8:15,5:15,,CLE,5,4,Mon,W 31-3,,4,34,7,55,11,89
9550,SFO,2019,2019-10-13,4:05,1:05,@,LAR,6,5,Sun,W 20-7,,4,30,8,59,12,89
9551,SFO,2019,2019-10-27,4:05,1:05,,CAR,8,7,Sun,W 51-13,,4,31,9,70,13,101
9552,SFO,2020,2020-11-05,8:20,5:20,,GNB,9,9,Thu,L 17-34,,4,33,5,45,9,78
9553,SFO,2020,2020-12-20,1:00,12:00,@,DAL,15,14,Sun,L 33-41,,4,39,5,58,9,97
9554,SFO,2020,2020-12-26,4:30,2:30,@,ARI,16,15,Sat,W 20-12,,4,27,4,20,8,47
9555,SFO,2021,2021-09-26,8:20,5:20,,GNB,3,3,Sun,L 28-30,,4,86,7,87,11,173
9556,TAM,2000,2000-09-03,1:02,1:02,@,NWE,1,1,Sun,W 21-16,,4,25,5,33,9,58
9557,TAM,2000,2000-10-01,4:15,4:15,@,WAS,5,5,Sun,L 17-20,OT,4,40,8,48,12,88
9558,TAM,2000,2000-10-29,1:01,1:01,,MIN,9,8,Sun,W 41-13,,4,34,6,46,10,80
9559,TAM,2000,2000-11-05,1:02,1:02,@,ATL,10,9,Sun,W 27-14,,4,43,5,25,9,68
9560,TAM,2000,2000-12-24,1:02,12:02,@,GNB,17,16,Sun,L 14-17,OT,4,54,6,43,10,97
9561,TAM,2001,2001-12-09,1:01,1:01,,DET,13,12,Sun,W 15-12,,4,59,4,28,8,87
9562,TAM,2002,2002-10-27,1:02,1:02,@,CAR,8,8,Sun,W 12-9,,4,26,7,70,11,96
9563,TAM,2003,2003-12-28,1:03,12:03,@,TEN,17,16,Sun,L 13-33,,4,31,4,50,8,81
9564,TAM,2006,2006-11-05,1:02,1:02,,NOR,9,8,Sun,L 14-31,,4,25,4,25,8,50
9565,TAM,2006,2006-11-19,1:03,1:03,,WAS,11,10,Sun,W 20-17,,4,35,3,19,7,54
9566,TAM,2007,2007-10-14,1:03,1:03,,TEN,6,6,Sun,W 13-10,,4,25,8,49,12,74
9567,TAM,2007,2007-11-25,1:02,1:02,,WAS,12,11,Sun,W 19-13,,4,25,4,27,8,52
9568,TAM,2007,2007-12-09,1:01,12:01,@,HOU,14,13,Sun,L 14-28,,4,25,5,35,9,60
9569,TAM,2007,2007-12-30,1:02,1:02,,CAR,17,16,Sun,L 23-31,,4,22,4,23,8,45
9570,TAM,2008,2008-10-19,8:23,8:23,,SEA,7,7,Sun,W 20-10,,4,26,1,6,5,32
9571,TAM,2009,2009-09-13,1:03,1:03,,DAL,1,1,Sun,L 21-34,,4,20,4,41,8,61
9572,TAM,2009,2009-10-11,1:02,1:02,@,PHI,5,5,Sun,L 14-33,,4,30,10,111,14,141
9573,TAM,2010,2010-09-19,1:03,1:03,@,CAR,2,2,Sun,W 20-7,,4,30,4,48,8,78
9574,TAM,2010,2010-09-26,1:03,1:03,,PIT,3,3,Sun,L 13-38,,4,45,2,20,6,65
9575,TAM,2011,2011-11-27,1:02,12:02,@,TEN,12,11,Sun,L 17-23,,4,30,5,50,9,80
9576,TAM,2012,2012-09-09,4:26,4:26,,CAR,1,1,Sun,W 16-10,,4,35,6,65,10,100
9577,TAM,2012,2012-10-25,8:29,7:29,@,MIN,8,7,Thu,W 36-17,,4,49,5,32,9,81
9578,TAM,2013,2013-09-22,1:02,1:02,@,NWE,3,3,Sun,L 3-23,,4,48,6,50,10,98
9579,TAM,2013,2013-12-01,1:04,1:04,@,CAR,13,12,Sun,L 6-27,,4,30,3,25,7,55
9580,TAM,2013,2013-12-15,1:02,1:02,,SFO,15,14,Sun,L 14-33,,4,32,8,62,12,94
9581,TAM,2014,2014-09-14,4:05,4:05,,STL,2,2,Sun,L 17-19,,4,30,5,65,9,95
9582,TAM,2014,2014-11-02,1:02,1:02,@,CLE,9,8,Sun,L 17-22,,4,33,7,44,11,77
9583,TAM,2014,2014-12-14,1:03,1:03,@,CAR,15,14,Sun,L 17-19,,4,29,4,25,8,54
9584,TAM,2014,2014-12-28,1:03,1:03,,NOR,17,16,Sun,L 20-23,,4,23,2,15,6,38
9585,TAM,2015,2015-12-27,1:03,1:03,,CHI,16,15,Sun,L 21-26,,4,47,3,25,7,72
9586,TAM,2017,2017-09-17,1:00,1:00,,CHI,2,1,Sun,W 29-7,,4,34,8,59,12,93
9587,TAM,2017,2017-10-01,4:05,4:05,,NYG,4,3,Sun,W 25-23,,4,19,1,0,5,19
9588,TAM,2018,2018-09-16,1:00,1:00,,PHI,2,2,Sun,W 27-21,,4,44,6,55,10,99
9589,TAM,2018,2018-10-14,1:00,1:00,@,ATL,6,5,Sun,L 29-34,,4,20,5,30,9,50
9590,TAM,2018,2018-11-18,1:00,1:00,@,NYG,11,10,Sun,L 35-38,,4,40,8,60,12,100
9591,TAM,2019,2019-09-22,4:05,4:05,,NYG,3,3,Sun,L 31-32,,4,30,6,59,10,89
9592,TAM,2019,2019-10-06,1:00,12:00,@,NOR,5,5,Sun,L 24-31,,4,30,6,40,10,70
9593,TAM,2020,2020-10-25,4:05,1:05,@,LVR,7,7,Sun,W 45-20,,4,20,4,35,8,55
9594,TAM,2021,2021-11-28,1:00,1:00,@,IND,12,11,Sun,W 38-31,,4,44,6,66,10,110
9595,TAM,2021,2021-12-12,4:25,4:25,,BUF,14,13,Sun,W 33-27,OT,4,24,7,65,11,89
9596,TAM,2021,2022-01-02,1:00,1:00,@,NYJ,17,16,Sun,W 28-24,,4,39,2,14,6,53
9597,WAS,2000,2000-09-24,8:37,8:37,@,NYG,4,4,Sun,W 16-6,,4,25,6,59,10,84
9598,WAS,2000,2000-12-03,1:01,1:01,,NYG,14,13,Sun,L 7-9,,4,35,3,20,7,55
9599,WAS,2001,2001-09-30,1:01,1:01,,KAN,3,3,Sun,L 13-45,,4,25,7,78,11,103
9600,WAS,2001,2001-12-30,8:36,7:36,@,NOR,16,15,Sun,W 40-10,,4,34,8,75,12,109
9601,WAS,2002,2002-09-22,4:15,1:15,@,SFO,3,3,Sun,L 10-20,,4,35,5,50,9,85
9602,WAS,2002,2002-11-24,1:01,1:01,,STL,12,11,Sun,W 20-17,,4,40,8,65,12,105
9603,WAS,2003,2003-11-09,1:02,1:02,,SEA,10,9,Sun,W 27-20,,4,40,4,32,8,72
9604,WAS,2003,2003-12-14,4:17,4:17,,DAL,15,14,Sun,L 0-27,,4,35,2,10,6,45
9605,WAS,2005,2005-11-06,8:37,8:37,,PHI,9,8,Sun,W 17-10,,4,35,5,64,9,99
9606,WAS,2006,2006-10-01,4:15,4:15,,JAX,4,4,Sun,W 36-30,OT,4,40,4,35,8,75
9607,WAS,2007,2007-10-07,1:02,1:02,,DET,5,4,Sun,W 34-3,,4,50,4,20,8,70
9608,WAS,2007,2007-11-25,1:02,1:02,@,TAM,12,11,Sun,L 13-19,,4,27,4,25,8,52
9609,WAS,2007,2007-12-02,1:02,1:02,,BUF,13,12,Sun,L 16-17,,4,34,8,101,12,135
9610,WAS,2007,2007-12-16,8:24,8:24,@,NYG,15,14,Sun,W 22-10,,4,35,3,35,7,70
9611,WAS,2008,2008-09-14,1:03,1:03,,NOR,2,2,Sun,W 29-24,,4,26,5,55,9,81
9612,WAS,2009,2009-09-13,4:15,4:15,@,NYG,1,1,Sun,L 17-23,,4,32,4,30,8,62
9613,WAS,2009,2009-10-04,1:00,1:00,,TAM,4,4,Sun,W 16-13,,4,40,5,40,9,80
9614,WAS,2009,2009-10-11,1:04,1:04,@,CAR,5,5,Sun,L 17-20,,4,20,5,27,9,47
9615,WAS,2009,2009-12-27,8:31,8:31,,DAL,16,15,Sun,L 0-17,,4,33,4,21,8,54
9616,WAS,2010,2010-10-10,1:02,1:02,,GNB,5,5,Sun,W 16-13,OT,4,28,9,63,13,91
9617,WAS,2010,2010-12-12,1:03,1:03,,TAM,14,13,Sun,L 16-17,,4,25,2,14,6,39
9618,WAS,2010,2011-01-02,4:16,4:16,,NYG,17,16,Sun,L 14-17,,4,25,2,24,6,49
9619,WAS,2011,2011-09-26,8:41,7:41,@,DAL,3,3,Mon,L 16-18,,4,35,6,55,10,90
9620,WAS,2011,2011-10-30,4:05,4:05,@,BUF,8,7,Sun,L 0-23,,4,59,6,35,10,94
9621,WAS,2012,2012-10-07,1:04,1:04,,ATL,5,5,Sun,L 17-24,,4,20,2,13,6,33
9622,WAS,2012,2012-12-03,8:40,8:40,,NYG,13,12,Mon,W 17-16,,4,56,9,73,13,129
9623,WAS,2013,2013-11-17,1:02,1:02,@,PHI,11,10,Sun,L 16-24,,4,39,9,68,13,107
9624,WAS,2013,2013-11-25,8:40,8:40,,SFO,12,11,Mon,L 6-27,,4,30,4,25,8,55
9625,WAS,2013,2013-12-08,1:03,1:03,,KAN,14,13,Sun,L 10-45,,4,27,3,30,7,57
9626,WAS,2015,2015-10-25,1:04,1:04,,TAM,7,7,Sun,W 31-30,,4,20,16,142,20,162
9627,WAS,2015,2015-11-08,1:02,1:02,@,NWE,9,8,Sun,L 10-27,,4,27,6,43,10,70
9628,WAS,2016,2016-10-09,1:03,1:03,@,BAL,5,5,Sun,W 16-10,,4,46,9,65,13,111
9629,WAS,2016,2016-10-23,1:02,1:02,@,DET,7,7,Sun,L 17-20,,4,20,4,30,8,50
9630,WAS,2016,2016-11-13,1:00,1:00,,MIN,10,9,Sun,W 26-20,,4,35,4,35,8,70
9631,WAS,2017,2017-09-17,4:25,1:25,@,LAR,2,2,Sun,W 27-20,,4,25,7,75,11,100
9632,WAS,2017,2017-12-10,4:05,1:05,@,LAC,14,13,Sun,L 13-30,,4,48,5,40,9,88
9633,WAS,2017,2017-12-31,1:00,1:00,@,NYG,17,16,Sun,L 10-18,,4,35,3,25,7,60
9634,WAS,2018,2018-11-22,4:30,3:30,@,DAL,12,11,Thu,L 23-31,,4,25,4,30,8,55
9635,WAS,2019,2019-10-24,8:20,10:20,@,MIN,8,8,Thu,L 9-19,,4,46,7,74,11,120
9636,WAS,2020,2020-09-27,1:00,1:00,@,CLE,3,3,Sun,L 20-34,,4,40,6,50,10,90
9637,WAS,2020,2020-10-25,1:00,1:00,,DAL,7,7,Sun,W 25-3,,4,30,6,49,10,79
9638,WAS,2021,2021-10-24,1:00,12:00,@,GNB,7,7,Sun,L 10-24,,4,50,4,36,8,86
9639,WAS,2021,2021-10-31,4:25,2:25,@,DEN,8,8,Sun,L 10-17,,4,29,4,35,8,64
9640,WAS,2021,2021-11-29,8:15,8:15,,SEA,12,11,Mon,W 17-15,,4,38,6,51,10,89
9641,ATL,2001,2001-09-09,1:15,1:15,@,SFO,1,1,Sun,L 13-16,OT,3,25,6,60,9,85
9642,ATL,2002,2002-10-13,1:03,1:03,@,NYG,6,5,Sun,W 17-10,,3,20,6,35,9,55
9643,ATL,2003,2003-10-13,9:00,8:00,@,STL,6,6,Mon,L 0-36,,3,30,6,45,9,75
9644,ATL,2004,2004-09-26,1:05,1:05,,ARI,3,3,Sun,W 6-3,,3,15,8,66,11,81
9645,ATL,2004,2004-10-24,1:00,12:00,@,KAN,7,7,Sun,L 10-56,,3,41,5,45,8,86
9646,ATL,2005,2005-09-18,4:06,1:06,@,SEA,2,2,Sun,L 18-21,,3,24,10,79,13,103
9647,ATL,2007,2007-10-15,8:40,8:40,,NYG,6,6,Mon,L 10-31,,3,31,6,45,9,76
9648,ATL,2008,2008-11-23,4:15,4:15,,CAR,12,11,Sun,W 45-28,,3,25,8,48,11,73
9649,ATL,2008,2008-12-14,1:03,1:03,,TAM,15,14,Sun,W 13-10,OT,3,20,11,76,14,96
9650,ATL,2008,2008-12-28,1:02,1:02,,STL,17,16,Sun,W 31-27,,3,14,3,14,6,28
9651,ATL,2009,2009-10-25,4:15,3:15,@,DAL,7,6,Sun,L 21-37,,3,30,8,50,11,80
9652,ATL,2009,2009-11-22,1:03,1:03,@,NYG,11,10,Sun,L 31-34,OT,3,16,8,64,11,80
9653,ATL,2009,2009-11-29,1:03,1:03,,TAM,12,11,Sun,W 20-17,,3,29,8,52,11,81
9654,ATL,2009,2010-01-03,1:03,1:03,@,TAM,17,16,Sun,W 20-10,,3,15,5,51,8,66
9655,ATL,2010,2010-09-12,1:02,1:02,@,PIT,1,1,Sun,L 9-15,OT,3,24,4,25,7,49
9656,ATL,2010,2010-10-24,1:05,1:05,,CIN,7,7,Sun,W 39-32,,3,41,7,36,10,77
9657,ATL,2010,2010-11-21,4:05,3:05,@,STL,11,10,Sun,W 34-17,,3,30,7,54,10,84
9658,ATL,2011,2012-01-01,4:17,4:17,,TAM,17,16,Sun,W 45-24,,3,20,2,20,5,40
9659,ATL,2012,2012-12-09,1:04,1:04,@,CAR,14,13,Sun,L 20-30,,3,15,3,10,6,25
9660,ATL,2012,2012-12-16,1:03,1:03,,NYG,15,14,Sun,W 34-0,,3,30,2,25,5,55
9661,ATL,2012,2012-12-22,8:40,8:40,@,DET,16,15,Sat,W 31-18,,3,20,2,20,5,40
9662,ATL,2013,2013-11-21,8:30,8:30,,NOR,12,11,Thu,L 13-17,,3,25,5,66,8,91
9663,ATL,2013,2013-12-08,1:02,12:02,@,GNB,14,13,Sun,L 21-22,,3,15,2,10,5,25
9664,ATL,2014,2014-12-08,8:30,7:30,@,GNB,14,13,Mon,L 37-43,,3,11,5,40,8,51
9665,ATL,2014,2014-12-14,1:02,1:02,,PIT,15,14,Sun,L 20-27,,3,25,3,34,6,59
9666,ATL,2015,2015-12-27,1:02,1:02,,CAR,16,15,Sun,W 20-13,,3,20,4,40,7,60
9667,ATL,2019,2019-11-17,1:00,1:00,@,CAR,11,10,Sun,W 29-3,,3,20,8,68,11,88
9668,ATL,2020,2020-10-05,8:15,7:15,@,GNB,4,4,Mon,L 16-30,,3,23,3,30,6,53
9669,ATL,2020,2020-10-11,1:00,1:00,,CAR,5,5,Sun,L 16-23,,3,40,4,25,7,65
9670,ATL,2020,2020-12-20,1:00,1:00,,TAM,15,14,Sun,L 27-31,,3,28,1,10,4,38
9671,ATL,2021,2021-10-24,1:00,1:00,@,MIA,7,6,Sun,W 30-28,,3,29,6,44,9,73
9672,ATL,2021,2021-10-31,1:00,1:00,,CAR,8,7,Sun,L 13-19,,3,15,8,76,11,91
9673,BUF,2000,2000-10-08,1:02,1:02,@,MIA,6,5,Sun,L 13-22,,3,40,5,64,8,104
9674,BUF,2000,2000-11-12,1:02,1:02,,CHI,11,10,Sun,W 20-3,,3,15,3,20,6,35
9675,BUF,2003,2003-12-07,4:15,4:15,,NYJ,14,13,Sun,W 17-6,,3,23,6,54,9,77
9676,BUF,2003,2003-12-14,1:03,12:03,@,TEN,15,14,Sun,L 26-28,,3,15,6,68,9,83
9677,BUF,2005,2005-09-18,1:02,1:02,@,TAM,2,2,Sun,L 3-19,,3,20,13,99,16,119
9678,BUF,2005,2005-09-25,1:02,1:02,,ATL,3,3,Sun,L 16-24,,3,35,7,75,10,110
9679,BUF,2005,2006-01-01,1:01,1:01,@,NYJ,17,16,Sun,L 26-30,,3,30,6,40,9,70
9680,BUF,2006,2006-11-19,1:03,12:03,@,HOU,11,10,Sun,W 24-21,,3,17,5,40,8,57
9681,BUF,2006,2006-12-31,4:16,4:16,@,BAL,17,16,Sun,L 7-19,,3,19,5,24,8,43
9682,BUF,2007,2007-10-21,1:02,1:02,,BAL,7,6,Sun,W 19-14,,3,25,11,91,14,116
9683,BUF,2007,2007-11-04,1:02,1:02,,CIN,9,8,Sun,W 33-21,,3,25,5,45,8,70
9684,BUF,2007,2007-12-30,1:01,1:01,@,PHI,17,16,Sun,L 9-17,,3,23,6,39,9,62
9685,BUF,2008,2008-11-09,1:02,1:02,@,NWE,10,9,Sun,L 10-20,,3,22,2,15,5,37
9686,BUF,2008,2008-11-17,8:40,8:40,,CLE,11,10,Mon,L 27-29,,3,30,2,15,5,45
9687,BUF,2008,2008-12-07,4:05,4:05,,MIA,14,13,Sun,L 3-16,,3,25,5,28,8,53
9688,BUF,2008,2008-12-28,1:02,1:02,,NWE,17,16,Sun,L 0-13,,3,20,2,10,5,30
9689,BUF,2009,2009-10-04,4:05,4:05,@,MIA,4,4,Sun,L 10-38,,3,19,5,45,8,64
9690,BUF,2009,2009-10-25,4:05,4:05,@,CAR,7,7,Sun,W 20-9,,3,22,9,67,12,89
9691,BUF,2009,2009-11-29,1:02,1:02,,MIA,12,11,Sun,W 31-14,,3,20,6,50,9,70
9692,BUF,2009,2009-12-13,1:00,12:00,@,KAN,14,13,Sun,W 16-10,,3,40,5,43,8,83
9693,BUF,2010,2010-10-03,1:02,1:02,,NYJ,4,4,Sun,L 14-38,,3,32,4,30,7,62
9694,BUF,2010,2011-01-02,1:03,1:03,@,NYJ,17,16,Sun,L 7-38,,3,15,3,25,6,40
9695,BUF,2011,2011-09-18,1:03,1:03,,OAK,2,2,Sun,W 38-35,,3,26,8,85,11,111
9696,BUF,2011,2011-11-13,1:02,12:02,@,DAL,10,9,Sun,L 7-44,,3,12,8,74,11,86
9697,BUF,2011,2011-11-20,1:02,1:02,@,MIA,11,10,Sun,L 8-35,,3,27,4,50,7,77
9698,BUF,2012,2012-09-30,1:02,1:02,,NWE,4,4,Sun,L 28-52,,3,17,1,10,4,27
9699,BUF,2012,2012-11-04,1:02,12:02,@,HOU,9,8,Sun,L 9-21,,3,15,7,42,10,57
9700,BUF,2017,2017-12-03,1:00,1:00,,NWE,13,12,Sun,L 3-23,,3,34,9,66,12,100
9701,BUF,2017,2017-12-17,1:00,1:00,,MIA,15,14,Sun,W 24-16,,3,28,7,60,10,88
9702,BUF,2018,2018-09-30,1:00,12:00,@,GNB,4,4,Sun,L 0-22,,3,20,5,60,8,80
9703,BUF,2018,2018-12-16,1:00,1:00,,DET,15,14,Sun,W 14-13,,3,20,4,81,7,101
9704,BUF,2018,2018-12-23,1:00,1:00,@,NWE,16,15,Sun,L 12-24,,3,29,5,49,8,78
9705,BUF,2018,2018-12-30,1:00,1:00,,MIA,17,16,Sun,W 42-17,,3,24,4,35,7,59
9706,BUF,2020,2020-12-28,8:15,8:15,@,NWE,16,15,Mon,W 38-9,,3,27,4,25,7,52
9707,BUF,2020,2021-01-03,1:00,1:00,,MIA,17,16,Sun,W 56-26,,3,16,2,20,5,36
9708,BUF,2021,2021-10-03,1:00,1:00,,HOU,4,4,Sun,W 40-0,,3,30,10,100,13,130
9709,BUF,2021,2021-12-06,8:15,8:15,,NWE,13,12,Mon,L 10-14,,3,20,6,47,9,67
9710,CAR,2000,2000-11-12,1:02,1:02,,NOR,11,10,Sun,L 10-20,,3,22,8,99,11,121
9711,CAR,2001,2001-09-30,1:03,1:03,,GNB,3,3,Sun,L 7-28,,3,35,6,45,9,80
9712,CAR,2001,2001-12-02,1:03,12:03,@,NOR,12,12,Sun,L 23-27,,3,21,10,85,13,106
9713,CAR,2002,2002-12-01,1:04,1:04,@,CLE,13,12,Sun,W 13-6,,3,25,2,10,5,35
9714,CAR,2002,2002-12-29,1:02,12:02,@,NOR,17,16,Sun,W 10-6,,3,19,4,27,7,46
9715,CAR,2005,2005-11-13,4:05,4:05,,NYJ,10,9,Sun,W 30-3,,3,25,5,50,8,75
9716,CAR,2005,2005-12-04,1:03,1:03,,ATL,13,12,Sun,W 24-6,,3,38,4,37,7,75
9717,CAR,2005,2005-12-18,1:03,12:03,@,NOR,15,14,Sun,W 27-10,,3,25,9,72,12,97
9718,CAR,2007,2007-09-23,4:15,4:15,@,ATL,3,3,Sun,W 27-20,,3,45,10,135,13,180
9719,CAR,2007,2007-12-22,8:15,8:15,,DAL,16,15,Sat,L 13-20,,3,15,5,39,8,54
9720,CAR,2008,2008-10-19,1:04,1:04,,NOR,7,7,Sun,W 30-7,,3,29,3,30,6,59
9721,CAR,2008,2008-10-26,1:04,1:04,,ARI,8,8,Sun,W 27-23,,3,25,7,60,10,85
9722,CAR,2009,2009-10-18,1:00,1:00,@,TAM,6,5,Sun,W 28-21,,3,30,5,40,8,70
9723,CAR,2009,2010-01-03,1:04,1:04,,NOR,17,16,Sun,W 23-10,,3,29,4,35,7,64
9724,CAR,2012,2012-09-20,8:20,8:20,,NYG,3,3,Thu,L 7-36,,3,22,5,38,8,60
9725,CAR,2012,2012-10-07,4:04,4:04,,SEA,5,5,Sun,L 12-16,,3,25,7,65,10,90
9726,CAR,2012,2012-10-28,1:03,12:03,@,CHI,8,7,Sun,L 22-23,,3,21,5,40,8,61
9727,CAR,2012,2012-12-09,1:04,1:04,,ATL,14,13,Sun,W 30-20,,3,10,3,15,6,25
9728,CAR,2013,2013-09-15,1:02,1:02,@,BUF,2,2,Sun,L 23-24,,3,30,7,55,10,85
9729,CAR,2013,2013-11-10,4:05,1:05,@,SFO,10,9,Sun,W 10-9,,3,25,4,25,7,50
9730,CAR,2013,2013-12-01,1:04,1:04,,TAM,13,12,Sun,W 27-6,,3,25,4,30,7,55
9731,CAR,2013,2013-12-22,1:04,1:04,,NOR,16,15,Sun,W 17-13,,3,26,4,40,7,66
9732,CAR,2014,2014-10-05,1:03,1:03,,CHI,5,5,Sun,W 31-24,,3,30,10,79,13,109
9733,CAR,2015,2015-09-13,1:03,1:03,@,JAX,1,1,Sun,W 20-9,,3,22,3,25,6,47
9734,CAR,2018,2018-09-23,1:00,1:00,,CIN,3,3,Sun,W 31-21,,3,17,4,36,7,53
9735,CAR,2018,2018-11-25,1:00,1:00,,SEA,12,11,Sun,L 27-30,,3,30,4,36,7,66
9736,CAR,2019,2019-09-22,4:05,2:05,@,ARI,3,3,Sun,W 38-20,,3,35,7,52,10,87
9737,CAR,2019,2019-10-13,9:30,2:30,@,TAM,6,6,Sun,W 37-26,,3,30,9,70,12,100
9738,CAR,2019,2019-11-24,1:00,12:00,@,NOR,12,11,Sun,L 31-34,,3,25,12,123,15,148
9739,CAR,2020,2020-09-27,4:05,1:05,@,LAC,3,3,Sun,W 21-16,,3,30,8,60,11,90
9740,CAR,2020,2020-12-27,4:05,4:05,@,WAS,16,15,Sun,W 20-13,,3,35,5,26,8,61
9741,CHI,2000,2000-11-12,1:02,1:02,@,BUF,11,10,Sun,L 3-20,,3,20,3,15,6,35
9742,CHI,2000,2000-12-10,1:02,12:02,,NWE,15,14,Sun,W 24-17,,3,35,7,60,10,95
9743,CHI,2001,2001-10-28,1:03,12:03,,SFO,7,6,Sun,W 37-31,OT,3,17,8,78,11,95
9744,CHI,2001,2002-01-06,1:02,12:02,,JAX,17,16,Sun,W 33-13,,3,14,3,14,6,28
9745,CHI,2002,2002-12-22,1:02,1:02,@,CAR,16,15,Sun,L 14-24,,3,32,4,40,7,72
9746,CHI,2003,2003-12-14,1:03,12:03,,MIN,15,14,Sun,W 13-10,,3,30,7,68,10,98
9747,CHI,2005,2005-12-18,8:37,7:37,,ATL,15,14,Sun,W 16-3,,3,16,6,75,9,91
9748,CHI,2008,2008-11-02,1:02,12:02,,DET,9,8,Sun,W 27-23,,3,25,4,36,7,61
9749,CHI,2008,2008-11-09,1:02,12:02,,TEN,10,9,Sun,L 14-21,,3,20,8,55,11,75
9750,CHI,2008,2008-11-23,1:00,12:00,@,STL,12,11,Sun,W 27-3,,3,14,11,85,14,99
9751,CHI,2009,2009-09-13,8:30,7:30,@,GNB,1,1,Sun,L 15-21,,3,25,6,45,9,70
9752,CHI,2009,2009-10-04,1:02,12:02,,DET,4,4,Sun,W 48-24,,3,36,7,51,10,87
9753,CHI,2009,2009-12-28,8:40,7:40,,MIN,16,15,Mon,W 36-30,OT,3,31,4,47,7,78
9754,CHI,2011,2011-10-16,8:30,7:30,,MIN,6,6,Sun,W 39-10,,3,15,5,40,8,55
9755,CHI,2012,2012-12-30,1:03,1:03,@,DET,17,16,Sun,W 26-24,,3,35,4,29,7,64
9756,CHI,2013,2013-09-22,8:30,8:30,@,PIT,3,3,Sun,W 40-23,,3,25,6,59,9,84
9757,CHI,2015,2015-12-27,1:03,1:03,@,TAM,16,15,Sun,W 26-21,,3,25,4,47,7,72
9758,CHI,2018,2018-11-22,12:30,12:30,@,DET,12,11,Thu,W 23-16,,3,20,5,54,8,74
9759,CHI,2019,2019-10-20,4:25,3:25,,NOR,7,6,Sun,L 25-36,,3,10,4,35,7,45
9760,CHI,2019,2019-12-29,1:00,3:00,@,MIN,17,16,Sun,W 21-19,,3,34,3,40,6,74
9761,CHI,2020,2020-12-06,1:00,12:00,,DET,13,12,Sun,L 30-34,,3,20,7,45,10,65
9762,CHI,2021,2021-09-12,8:20,5:20,@,LAR,1,1,Sun,L 14-34,,3,35,4,36,7,71
9763,CIN,2000,2000-11-26,1:02,1:02,,PIT,13,12,Sun,L 28-48,,3,15,4,35,7,50
9764,CIN,2001,2001-09-09,1:03,1:03,,NWE,1,1,Sun,W 23-17,,3,20,3,15,6,35
9765,CIN,2002,2002-09-15,1:03,1:03,@,CLE,2,2,Sun,L 7-20,,3,30,12,87,15,117
9766,CIN,2002,2002-12-01,1:02,1:02,,BAL,13,12,Sun,L 23-27,,3,30,8,79,11,109
9767,CIN,2004,2004-09-19,8:36,8:36,,MIA,2,2,Sun,W 16-13,,3,19,8,69,11,88
9768,CIN,2004,2004-12-26,1:03,1:03,,NYG,16,15,Sun,W 23-22,,3,20,9,85,12,105
9769,CIN,2005,2005-10-30,1:02,1:02,,GNB,8,8,Sun,W 21-14,,3,58,7,29,10,87
9770,CIN,2005,2005-12-24,1:03,1:03,,BUF,16,15,Sat,L 27-37,,3,15,6,55,9,70
9771,CIN,2007,2007-09-16,1:03,1:03,@,CLE,2,2,Sun,L 45-51,,3,15,6,45,9,60
9772,CIN,2007,2007-12-30,1:03,1:03,@,MIA,17,16,Sun,W 38-25,,3,20,5,55,8,75
9773,CIN,2008,2008-11-30,1:02,1:02,,BAL,13,12,Sun,L 3-34,,3,15,3,30,6,45
9774,CIN,2008,2008-12-07,1:02,1:02,@,IND,14,13,Sun,L 3-35,,3,23,3,21,6,44
9775,CIN,2009,2009-10-25,4:16,4:16,,CHI,7,7,Sun,W 45-10,,3,20,6,44,9,64
9776,CIN,2010,2010-11-08,8:40,8:40,,PIT,9,8,Mon,L 21-27,,3,30,7,73,10,103
9777,CIN,2011,2011-09-11,1:06,1:06,@,CLE,1,1,Sun,W 27-17,,3,22,11,72,14,94
9778,CIN,2011,2011-10-02,1:03,1:03,,BUF,4,4,Sun,W 23-20,,3,15,4,26,7,41
9779,CIN,2011,2011-12-11,1:02,1:02,,HOU,14,13,Sun,L 19-20,,3,27,5,50,8,77
9780,CIN,2012,2012-09-10,7:10,7:10,@,BAL,1,1,Mon,L 13-44,,3,41,6,50,9,91
9781,CIN,2012,2012-11-25,1:02,1:02,,OAK,12,11,Sun,W 34-10,,3,25,3,25,6,50
9782,CIN,2013,2013-09-29,1:06,1:06,@,CLE,4,4,Sun,L 6-17,,3,25,5,80,8,105
9783,CIN,2013,2013-10-31,8:29,8:29,@,MIA,9,9,Thu,L 20-22,OT,3,63,2,25,5,88
9784,CIN,2013,2013-12-01,4:25,1:25,@,SDG,13,12,Sun,W 17-10,,3,30,5,45,8,75
9785,CIN,2015,2015-10-18,1:02,1:02,@,BUF,6,6,Sun,W 34-21,,3,20,8,93,11,113
9786,CIN,2015,2015-11-29,1:02,1:02,,STL,12,11,Sun,W 31-7,,3,35,7,45,10,80
9787,CIN,2016,2016-10-23,1:02,1:02,,CLE,7,7,Sun,W 31-17,,3,30,5,35,8,65
9788,CIN,2016,2016-12-04,1:00,1:00,,PHI,13,12,Sun,W 32-14,,3,23,10,88,13,111
9789,CIN,2017,2017-11-19,4:25,2:25,@,DEN,11,10,Sun,W 20-17,,3,14,5,50,8,64
9790,CIN,2018,2018-12-23,1:00,1:00,@,CLE,16,15,Sun,L 18-26,,3,15,6,57,9,72
9791,CIN,2019,2019-12-29,1:00,1:00,,CLE,17,16,Sun,W 33-23,,3,20,4,33,7,53
9792,CIN,2020,2020-11-22,1:00,1:00,@,WAS,11,10,Sun,L 9-20,,3,31,6,49,9,80
9793,CIN,2020,2020-11-29,1:00,1:00,,NYG,12,11,Sun,L 17-19,,3,27,5,51,8,78
9794,CIN,2020,2020-12-13,1:00,1:00,,DAL,14,13,Sun,L 7-30,,3,25,5,30,8,55
9795,CIN,2020,2021-01-03,1:00,1:00,,BAL,17,16,Sun,L 3-38,,3,29,6,49,9,78
9796,CIN,2021,2021-09-12,1:00,1:00,,MIN,1,1,Sun,W 27-24,OT,3,15,12,116,15,131
9797,CIN,2021,2021-11-28,1:00,1:00,,PIT,12,11,Sun,W 41-10,,3,18,4,30,7,48
9798,CLE,2000,2000-09-03,1:02,1:02,,JAX,1,1,Sun,L 7-27,,3,25,1,5,4,30
9799,CLE,2000,2000-11-26,1:01,1:01,@,BAL,13,13,Sun,L 7-44,,3,11,3,25,6,36
9800,CLE,2001,2001-12-23,4:15,3:15,@,GNB,15,14,Sun,L 7-30,,3,35,1,5,4,40
9801,CLE,2001,2001-12-30,1:03,12:03,@,TEN,16,15,Sun,W 41-38,,3,25,6,50,9,75
9802,CLE,2004,2004-11-14,1:03,1:03,,PIT,10,9,Sun,L 10-24,,3,11,5,38,8,49
9803,CLE,2006,2006-10-29,4:16,4:16,,NYJ,8,7,Sun,W 20-13,,3,42,1,5,4,47
9804,CLE,2006,2006-12-03,1:03,1:03,,KAN,13,12,Sun,W 31-28,OT,3,15,3,29,6,44
9805,CLE,2008,2008-11-06,8:15,8:15,,DEN,10,9,Thu,L 30-34,,3,20,3,30,6,50
9806,CLE,2008,2008-12-15,8:40,8:40,@,PHI,15,14,Mon,L 10-30,,3,20,1,5,4,25
9807,CLE,2009,2009-10-11,1:01,1:01,@,BUF,5,5,Sun,W 6-3,,3,29,13,75,16,104
9808,CLE,2009,2009-11-01,1:00,12:00,@,CHI,8,8,Sun,L 6-30,,3,30,5,35,8,65
9809,CLE,2009,2009-12-20,1:00,12:00,@,KAN,15,14,Sun,W 41-34,,3,20,3,34,6,54
9810,CLE,2009,2010-01-03,1:02,1:02,,JAX,17,16,Sun,W 23-17,,3,15,3,20,6,35
9811,CLE,2010,2010-10-17,1:02,1:02,@,PIT,6,6,Sun,L 10-28,,3,41,4,25,7,66
9812,CLE,2010,2010-12-19,1:02,1:02,@,CIN,15,14,Sun,L 17-19,,3,25,6,55,9,80
9813,CLE,2011,2011-09-18,1:02,1:02,@,IND,2,2,Sun,W 27-19,,3,49,4,21,7,70
9814,CLE,2011,2011-11-27,1:02,1:02,@,CIN,12,11,Sun,L 20-23,,3,15,5,35,8,50
9815,CLE,2011,2011-12-04,4:05,4:05,,BAL,13,12,Sun,L 10-24,,3,37,4,18,7,55
9816,CLE,2012,2012-09-09,1:03,1:03,,PHI,1,1,Sun,L 16-17,,3,35,12,110,15,145
9817,CLE,2013,2013-12-22,1:02,1:02,@,NYJ,16,15,Sun,L 13-24,,3,24,6,35,9,59
9818,CLE,2013,2013-12-29,1:02,1:02,@,PIT,17,16,Sun,L 7-20,,3,30,2,15,5,45
9819,CLE,2016,2016-11-10,8:25,8:25,@,BAL,10,10,Thu,L 7-28,,3,35,6,61,9,96
9820,CLE,2020,2020-11-22,1:00,1:00,,PHI,11,10,Sun,W 22-17,,3,53,5,33,8,86
9821,CLE,2021,2021-12-20,5:00,5:00,,LVR,15,14,Mon,L 14-16,,3,61,7,64,10,125
9822,IND,2000,2000-10-01,1:01,1:01,@,BUF,5,4,Sun,W 18-16,,3,20,8,60,11,80
9823,IND,2000,2000-10-15,4:05,1:05,@,SEA,7,6,Sun,W 37-24,,3,25,5,39,8,64
9824,IND,2000,2000-10-29,2:00,1:00,,DET,9,8,Sun,W 30-18,,3,20,9,57,12,77
9825,IND,2000,2000-12-24,4:15,4:15,,MIN,17,16,Sun,W 31-10,,3,20,6,53,9,73
9826,IND,2001,2001-11-04,1:01,1:01,@,BUF,8,7,Sun,W 30-14,,3,35,4,20,7,55
9827,IND,2001,2002-01-06,1:00,1:00,,DEN,17,16,Sun,W 29-10,,3,20,2,15,5,35
9828,IND,2002,2002-11-10,1:03,1:03,@,PHI,10,9,Sun,W 35-13,,3,25,3,25,6,50
9829,IND,2003,2003-10-26,4:15,4:15,,HOU,8,7,Sun,W 30-21,,3,13,7,52,10,65
9830,IND,2004,2004-09-09,9:08,9:08,@,NWE,1,1,Thu,L 24-27,,3,20,8,55,11,75
9831,IND,2004,2004-10-03,1:02,1:02,@,JAX,4,4,Sun,W 24-17,,3,26,5,28,8,54
9832,IND,2005,2005-09-25,12:03,12:03,,CLE,3,3,Sun,W 13-6,,3,15,7,62,10,77
9833,IND,2005,2005-10-17,8:08,8:08,,STL,6,6,Mon,W 45-28,,3,15,9,50,12,65
9834,IND,2006,2006-09-10,8:24,8:24,@,NYG,1,1,Sun,W 26-21,,3,20,10,64,13,84
9835,IND,2006,2006-10-22,4:15,4:15,,WAS,7,6,Sun,W 36-22,,3,27,10,91,13,118
9836,IND,2007,2007-12-16,4:05,1:05,@,OAK,15,14,Sun,W 21-14,,3,30,6,47,9,77
9837,IND,2008,2008-11-23,8:20,5:20,@,SDG,12,11,Sun,W 23-20,,3,15,5,37,8,52
9838,IND,2008,2008-12-07,1:02,1:02,,CIN,14,13,Sun,W 35-3,,3,21,3,23,6,44
9839,IND,2008,2008-12-28,1:02,1:02,,TEN,17,16,Sun,W 23-0,,3,20,3,30,6,50
9840,IND,2009,2009-09-13,1:02,1:02,,JAX,1,1,Sun,W 14-12,,3,17,3,24,6,41
9841,IND,2009,2009-11-15,8:31,8:31,,NWE,10,9,Sun,W 35-34,,3,20,4,72,7,92
9842,IND,2009,2009-11-29,1:02,12:02,@,HOU,12,11,Sun,W 35-27,,3,25,10,129,13,154
9843,IND,2009,2009-12-27,4:16,4:16,,NYJ,16,15,Sun,L 15-29,,3,15,5,52,8,67
9844,IND,2009,2010-01-03,1:02,1:02,@,BUF,17,16,Sun,L 7-30,,3,15,4,40,7,55
9845,IND,2010,2010-10-03,4:05,4:05,@,JAX,4,4,Sun,L 28-31,,3,35,7,45,10,80
9846,IND,2010,2010-10-17,8:31,8:31,@,WAS,6,6,Sun,W 27-24,,3,15,7,53,10,68
9847,IND,2010,2010-12-05,4:15,4:15,,DAL,13,12,Sun,L 35-38,OT,3,28,5,35,8,63
9848,IND,2011,2011-09-25,8:30,8:30,,PIT,3,3,Sun,L 20-23,,3,21,4,38,7,59
9849,IND,2011,2011-12-11,1:02,1:02,@,BAL,14,13,Sun,L 10-24,,3,15,5,40,8,55
9850,IND,2012,2012-09-09,1:02,12:02,@,CHI,1,1,Sun,L 21-41,,3,19,7,48,10,67
9851,IND,2012,2012-10-14,1:02,1:02,@,NYJ,6,5,Sun,L 9-35,,3,27,8,110,11,137
9852,IND,2012,2012-12-30,1:02,1:02,,HOU,17,16,Sun,W 28-16,,3,24,9,64,12,88
9853,IND,2013,2013-09-08,1:02,1:02,,OAK,1,1,Sun,W 21-17,,3,31,8,51,11,82
9854,IND,2013,2013-09-15,1:02,1:02,,MIA,2,2,Sun,L 20-24,,3,13,0,0,3,13
9855,IND,2013,2013-10-06,1:03,1:03,,SEA,5,5,Sun,W 34-28,,3,35,7,85,10,120
9856,IND,2013,2013-11-03,8:30,7:30,@,HOU,9,8,Sun,W 27-24,,3,15,5,86,8,101
9857,IND,2013,2013-12-22,1:02,12:02,@,KAN,16,15,Sun,W 23-7,,3,31,7,65,10,96
9858,IND,2016,2016-12-05,8:30,8:30,@,NYJ,13,12,Mon,W 41-10,,3,28,6,90,9,118
9859,IND,2019,2019-09-08,4:05,1:05,@,LAC,1,1,Sun,L 24-30,OT,3,10,3,20,6,30
9860,IND,2019,2019-11-10,4:05,4:05,,MIA,10,9,Sun,L 12-16,,3,25,4,30,7,55
9861,IND,2019,2019-11-17,1:00,1:00,,JAX,11,10,Sun,W 33-13,,3,20,8,81,11,101
9862,IND,2019,2019-11-21,8:20,7:20,@,HOU,12,11,Thu,L 17-20,,3,29,4,27,7,56
9863,IND,2019,2019-12-08,1:00,1:00,@,TAM,14,13,Sun,L 35-38,,3,35,6,104,9,139
9864,IND,2020,2020-11-01,1:00,1:00,@,DET,8,7,Sun,W 41-21,,3,19,4,76,7,95
9865,IND,2021,2021-09-19,1:00,1:00,,LAR,2,2,Sun,L 24-27,,3,25,2,15,5,40
9866,IND,2021,2021-11-21,1:00,1:00,@,BUF,11,11,Sun,W 41-15,,3,30,7,56,10,86
9867,IND,2021,2022-01-02,1:00,1:00,,LVR,17,16,Sun,L 20-23,,3,25,6,41,9,66
9868,ARI,2000,2000-10-08,4:15,1:15,,CLE,6,5,Sun,W 29-21,,3,20,8,86,11,106
9869,ARI,2000,2000-12-17,4:15,2:15,,BAL,16,15,Sun,L 7-13,,3,15,6,64,9,79
9870,ARI,2001,2001-09-30,4:05,1:05,,ATL,3,2,Sun,L 14-34,,3,30,9,98,12,128
9871,ARI,2001,2001-11-25,4:05,1:05,@,SDG,11,10,Sun,W 20-17,,3,26,6,55,9,81
9872,ARI,2002,2002-11-10,4:06,2:06,,SEA,10,9,Sun,L 6-27,,3,20,4,34,7,54
9873,ARI,2003,2003-11-30,1:03,12:03,@,CHI,13,12,Sun,L 3-28,,3,15,4,25,7,40
9874,ARI,2004,2004-11-14,4:15,2:15,,NYG,10,9,Sun,W 17-14,,3,15,10,97,13,112
9875,ARI,2008,2008-11-23,4:16,2:16,,NYG,12,11,Sun,L 29-37,,3,29,9,76,12,105
9876,ARI,2008,2008-12-21,1:02,1:02,@,NWE,16,15,Sun,L 7-47,,3,20,7,65,10,85
9877,ARI,2009,2009-12-27,4:05,2:05,,STL,16,15,Sun,W 31-10,,3,15,4,20,7,35
9878,ARI,2010,2010-10-10,4:05,1:05,,NOR,5,5,Sun,W 30-20,,3,20,6,45,9,65
9879,ARI,2010,2010-10-31,4:15,1:15,,TAM,8,7,Sun,L 35-38,,3,12,9,80,12,92
9880,ARI,2013,2013-09-22,1:03,12:03,@,NOR,3,3,Sun,L 7-31,,3,18,4,30,7,48
9881,ARI,2013,2013-10-06,4:05,1:05,,CAR,5,5,Sun,W 22-6,,3,30,9,79,12,109
9882,ARI,2013,2013-10-17,8:25,5:25,,SEA,7,7,Thu,L 22-34,,3,22,10,70,13,92
9883,ARI,2013,2013-12-29,4:25,2:25,,SFO,17,16,Sun,L 20-23,,3,30,4,20,7,50
9884,ARI,2014,2014-10-05,4:05,2:05,@,DEN,5,4,Sun,L 20-41,,3,15,7,67,10,82
9885,ARI,2014,2014-11-23,4:06,1:06,@,SEA,12,11,Sun,L 3-19,,3,25,7,74,10,99
9886,ARI,2014,2014-12-28,4:25,1:25,@,SFO,17,16,Sun,L 17-20,,3,21,10,78,13,99
9887,ARI,2015,2015-10-04,4:25,1:25,,STL,4,4,Sun,L 22-24,,3,20,7,66,10,86
9888,ARI,2015,2015-12-06,1:00,12:00,@,STL,13,12,Sun,W 27-3,,3,25,7,104,10,129
9889,ARI,2016,2016-09-18,1:05,1:05,,TAM,2,2,Sun,W 40-7,,3,30,5,39,8,69
9890,ARI,2018,2018-11-11,1:00,12:00,@,KAN,10,9,Sun,L 14-26,,3,30,8,63,11,93
9891,ARI,2018,2018-11-25,4:05,1:05,@,LAC,12,11,Sun,L 10-45,,3,35,4,30,7,65
9892,ARI,2018,2018-12-30,4:25,1:25,@,SEA,17,16,Sun,L 24-27,,3,20,1,10,4,30
9893,ARI,2021,2021-11-21,4:25,1:25,@,SEA,11,11,Sun,W 23-13,,3,32,2,17,5,49
9894,DAL,2000,2000-11-19,4:15,4:15,@,BAL,12,11,Sun,L 0-27,,3,15,6,55,9,70
9895,DAL,2001,2001-09-23,1:12,12:12,,SDG,2,2,Sun,L 21-32,,3,27,3,57,6,84
9896,DAL,2001,2001-10-15,8:08,8:08,,WAS,5,5,Mon,W 9-7,,3,22,7,60,10,82
9897,DAL,2003,2003-12-21,1:02,12:02,,NYG,16,15,Sun,W 19-3,,3,35,4,20,7,55
9898,DAL,2007,2007-11-04,8:23,8:23,@,PHI,9,8,Sun,W 38-17,,3,35,5,35,8,70
9899,DAL,2007,2007-12-09,1:03,1:03,@,DET,14,13,Sun,W 28-27,,3,23,7,35,10,58
9900,DAL,2008,2008-09-28,4:15,3:15,,WAS,4,4,Sun,L 24-26,,3,15,5,30,8,45
9901,DAL,2010,2010-10-31,1:05,12:05,,JAX,8,7,Sun,L 17-35,,3,20,6,36,9,56
9902,DAL,2011,2011-10-30,8:28,8:28,@,PHI,8,7,Sun,L 7-34,,3,20,6,33,9,53
9903,DAL,2014,2014-09-21,1:00,12:00,@,STL,3,3,Sun,W 34-31,,3,15,8,119,11,134
9904,DAL,2014,2014-10-27,8:30,7:30,,WAS,8,8,Mon,L 17-20,OT,3,35,6,45,9,80
9905,DAL,2015,2015-09-13,8:31,7:31,,NYG,1,1,Sun,W 27-26,,3,35,5,44,8,79
9906,DAL,2016,2016-11-24,4:30,3:30,,WAS,12,11,Thu,W 31-26,,3,25,3,30,6,55
9907,DAL,2017,2017-11-30,8:25,7:25,,WAS,13,12,Thu,W 38-14,,3,25,7,43,10,68
9908,DAL,2018,2018-10-14,4:25,3:25,,JAX,6,6,Sun,W 40-7,,3,25,4,30,7,55
9909,DAL,2020,2020-10-11,4:25,3:25,,NYG,5,5,Sun,W 37-34,,3,25,8,81,11,106
9910,DAL,2021,2021-12-26,8:20,7:20,,WAS,16,15,Sun,W 56-14,,3,15,1,13,4,28
9911,DEN,2000,2000-09-17,4:05,1:05,@,OAK,3,3,Sun,W 33-24,,3,30,5,51,8,81
9912,DEN,2002,2002-09-08,4:17,2:17,,STL,1,1,Sun,W 23-16,,3,31,6,44,9,75
9913,DEN,2002,2002-09-15,4:00,1:00,@,SFO,2,2,Sun,W 24-14,,3,30,10,114,13,144
9914,DEN,2002,2002-11-11,9:09,7:09,,OAK,10,9,Mon,L 10-34,,3,15,5,35,8,50
9915,DEN,2002,2002-12-15,4:05,2:05,,KAN,15,14,Sun,W 31-24,,3,25,10,93,13,118
9916,DEN,2004,2004-09-26,4:05,2:05,,SDG,3,3,Sun,W 23-13,,3,25,6,61,9,86
9917,DEN,2005,2005-11-20,4:15,2:15,,NYJ,11,10,Sun,W 27-0,,3,30,7,41,10,71
9918,DEN,2006,2006-10-09,8:41,6:41,,BAL,5,4,Mon,W 13-3,,3,25,3,15,6,40
9919,DEN,2006,2006-10-22,4:06,4:06,@,CLE,7,6,Sun,W 17-7,,3,30,2,10,5,40
9920,DEN,2006,2006-10-29,4:15,2:15,,IND,8,7,Sun,L 31-34,,3,24,5,55,8,79
9921,DEN,2006,2006-12-03,8:20,6:20,,SEA,13,12,Sun,L 20-23,,3,25,10,80,13,105
9922,DEN,2006,2006-12-24,4:16,2:16,,CIN,16,15,Sun,W 24-23,,3,10,8,46,11,56
9923,DEN,2007,2007-09-09,1:02,1:02,@,BUF,1,1,Sun,W 15-14,,3,31,5,40,8,71
9924,DEN,2007,2007-10-07,4:15,2:15,,SDG,5,5,Sun,L 3-41,,3,18,6,45,9,63
9925,DEN,2008,2008-09-08,10:22,7:22,@,OAK,1,1,Mon,W 41-14,,3,15,10,96,13,111
9926,DEN,2008,2008-09-21,4:06,2:06,,NOR,3,3,Sun,W 34-32,,3,20,4,51,7,71
9927,DEN,2008,2008-09-28,1:00,12:00,@,KAN,4,4,Sun,L 19-33,,3,22,5,45,8,67
9928,DEN,2008,2008-11-06,8:15,8:15,@,CLE,10,9,Thu,W 34-30,,3,30,3,20,6,50
9929,DEN,2008,2008-12-14,4:15,4:15,@,CAR,15,14,Sun,L 10-30,,3,25,5,35,8,60
9930,DEN,2009,2009-10-11,4:16,2:16,,NWE,5,5,Sun,W 20-17,OT,3,20,4,46,7,66
9931,DEN,2009,2009-11-09,8:41,6:41,,PIT,9,8,Mon,L 10-28,,3,25,4,28,7,53
9932,DEN,2009,2009-12-06,1:00,12:00,@,KAN,13,12,Sun,W 44-13,,3,20,3,25,6,45
9933,DEN,2010,2010-09-19,4:06,2:06,,SEA,2,2,Sun,W 31-14,,3,35,7,64,10,99
9934,DEN,2010,2010-11-14,4:05,2:05,,KAN,10,9,Sun,W 49-29,,3,28,6,40,9,68
9935,DEN,2011,2011-10-02,4:15,3:15,@,GNB,4,4,Sun,L 23-49,,3,24,3,27,6,51
9936,DEN,2012,2012-12-06,8:30,5:30,@,OAK,14,13,Thu,W 26-13,,3,25,11,94,14,119
9937,DEN,2013,2013-11-10,4:25,1:25,@,SDG,10,9,Sun,W 28-20,,3,28,6,40,9,68
9938,DEN,2015,2015-12-06,4:05,1:05,@,SDG,13,12,Sun,W 17-3,,3,18,8,72,11,90
9939,DEN,2017,2017-09-11,10:20,8:20,,LAC,1,1,Mon,W 24-21,,3,62,4,40,7,102
9940,DEN,2017,2017-12-10,4:05,2:05,,NYJ,14,13,Sun,W 23-0,,3,21,4,20,7,41
9941,DEN,2017,2017-12-24,1:00,1:00,@,WAS,16,15,Sun,L 11-27,,3,30,6,35,9,65
9942,DEN,2018,2018-10-01,8:15,6:15,,KAN,4,4,Mon,L 23-27,,3,25,10,93,13,118
9943,DEN,2019,2019-09-22,1:00,12:00,@,GNB,3,3,Sun,L 16-27,,3,27,7,53,10,80
9944,DEN,2019,2019-12-01,4:25,2:25,,LAC,13,12,Sun,W 23-20,,3,25,7,82,10,107
9945,DEN,2021,2021-12-26,4:25,1:25,@,LVR,16,15,Sun,L 13-17,,3,30,3,37,6,67
9946,DEN,2021,2022-01-02,4:05,1:05,@,LAC,17,16,Sun,L 13-34,,3,23,3,22,6,45
9947,DET,2000,2000-12-10,1:02,12:02,@,GNB,15,14,Sun,L 13-26,,3,30,2,11,5,41
9948,DET,2003,2003-11-02,1:03,1:03,,OAK,9,8,Sun,W 23-13,,3,30,8,51,11,81
9949,DET,2005,2005-09-18,1:02,12:02,@,CHI,2,2,Sun,L 6-38,,3,30,6,40,9,70
9950,DET,2005,2005-12-04,1:02,1:02,,MIN,13,12,Sun,L 16-21,,3,30,11,94,14,124
9951,DET,2009,2009-11-26,12:35,12:35,,GNB,12,11,Thu,L 12-34,,3,28,7,57,10,85
9952,DET,2011,2011-12-24,4:05,4:05,,SDG,16,15,Sat,W 38-10,,3,8,1,10,4,18
9953,DET,2012,2012-09-09,1:03,1:03,,STL,1,1,Sun,W 27-23,,3,27,7,65,10,92
9954,DET,2013,2013-09-29,1:03,1:03,,CHI,4,4,Sun,W 40-32,,3,25,4,30,7,55
9955,DET,2015,2015-11-15,1:04,12:04,@,GNB,10,9,Sun,W 18-16,,3,35,5,55,8,90
9956,DET,2018,2018-09-10,7:10,7:10,,NYJ,1,1,Mon,L 17-48,,3,15,7,49,10,64
9957,DET,2018,2018-12-30,1:00,12:00,@,GNB,17,16,Sun,W 31-0,,3,34,5,38,8,72
9958,DET,2020,2020-11-08,1:00,3:00,@,MIN,9,8,Sun,L 20-34,,3,37,9,69,12,106
9959,DET,2020,2020-12-20,1:00,12:00,@,TEN,15,14,Sun,L 25-46,,3,33,3,22,6,55
9960,DET,2021,2021-10-10,1:00,11:00,@,MIN,5,5,Sun,L 17-19,,3,30,7,74,10,104
9961,DET,2021,2021-12-05,1:00,1:00,,MIN,13,12,Sun,W 29-27,,3,11,7,66,10,77
9962,GNB,2000,2000-12-17,1:00,12:00,@,MIN,16,15,Sun,W 33-28,,3,25,8,67,11,92
9963,GNB,2001,2001-09-24,9:08,8:08,,WAS,2,2,Mon,W 37-0,,3,15,8,70,11,85
9964,GNB,2001,2001-11-18,1:02,12:02,,ATL,10,9,Sun,L 20-23,,3,25,9,70,12,95
9965,GNB,2001,2002-01-06,1:04,1:04,@,NYG,17,16,Sun,W 34-25,,3,15,6,64,9,79
9966,GNB,2002,2002-09-08,1:04,12:04,,ATL,1,1,Sun,W 37-34,OT,3,15,4,82,7,97
9967,GNB,2002,2002-12-22,1:02,12:02,,BUF,16,15,Sun,W 10-0,,3,25,2,10,5,35
9968,GNB,2003,2003-10-05,1:02,12:02,,SEA,5,5,Sun,W 35-13,,3,25,7,57,10,82
9969,GNB,2003,2003-10-12,1:02,12:02,,KAN,6,6,Sun,L 34-40,OT,3,25,5,40,8,65
9970,GNB,2003,2003-11-02,8:35,7:35,@,MIN,9,8,Sun,W 30-27,,3,25,4,20,7,45
9971,GNB,2004,2004-10-11,9:09,8:09,,TEN,5,5,Mon,L 27-48,,3,15,12,105,15,120
9972,GNB,2004,2004-10-17,1:03,1:03,@,DET,6,6,Sun,W 38-10,,3,15,2,20,5,35
9973,GNB,2006,2006-11-19,1:02,12:02,,NWE,11,10,Sun,L 0-35,,3,32,6,38,9,70
9974,GNB,2006,2006-12-31,8:15,7:15,@,CHI,17,16,Sun,W 26-7,,3,35,6,44,9,79
9975,GNB,2008,2008-11-24,8:40,7:40,@,NOR,12,11,Mon,L 29-51,,3,20,2,10,5,30
9976,GNB,2008,2008-12-14,1:04,1:04,@,JAX,15,14,Sun,L 16-20,,3,30,6,58,9,88
9977,GNB,2010,2010-10-03,1:02,12:02,,DET,4,4,Sun,W 28-26,,3,31,13,102,16,133
9978,GNB,2010,2010-10-31,1:03,1:03,@,NYJ,8,8,Sun,W 9-0,,3,15,7,55,10,70
9979,GNB,2010,2010-12-12,1:03,1:03,@,DET,14,13,Sun,L 3-7,,3,20,6,35,9,55
9980,GNB,2010,2010-12-26,4:15,3:15,,NYG,16,15,Sun,W 45-17,,3,31,5,45,8,76
9981,GNB,2011,2011-10-02,4:15,3:15,,DEN,4,4,Sun,W 49-23,,3,27,3,24,6,51
9982,GNB,2011,2011-10-16,1:02,12:02,,STL,6,6,Sun,W 24-3,,3,16,7,45,10,61
9983,GNB,2012,2012-10-21,1:00,12:00,@,STL,7,7,Sun,W 30-20,,3,30,6,30,9,60
9984,GNB,2013,2013-11-28,12:36,12:36,@,DET,13,12,Thu,L 10-40,,3,25,5,50,8,75
9985,GNB,2014,2014-09-14,4:25,3:25,,NYJ,2,2,Sun,W 31-24,,3,34,7,82,10,116
9986,GNB,2015,2015-11-26,8:30,7:30,,CHI,12,11,Thu,L 13-17,,3,38,12,95,15,133
9987,GNB,2016,2016-12-24,1:00,12:00,,MIN,16,15,Sat,W 38-25,,3,21,8,70,11,91
9988,GNB,2017,2017-11-26,8:30,8:30,@,PIT,12,11,Sun,L 28-31,,3,27,5,45,8,72
9989,GNB,2017,2017-12-10,1:00,1:00,@,CLE,14,13,Sun,W 27-21,OT,3,20,6,45,9,65
9990,GNB,2019,2019-10-20,1:00,12:00,,OAK,7,7,Sun,W 42-24,,3,20,8,97,11,117
9991,GNB,2020,2020-10-05,8:15,7:15,,ATL,4,4,Mon,W 30-16,,3,30,3,23,6,53
9992,GNB,2020,2020-11-29,8:20,7:20,,CHI,12,11,Sun,W 41-25,,3,17,5,45,8,62
9993,GNB,2021,2021-10-03,4:25,3:25,,PIT,4,4,Sun,W 27-17,,3,25,5,34,8,59
9994,GNB,2021,2021-10-17,1:00,12:00,@,CHI,6,6,Sun,W 24-14,,3,51,7,54,10,105
9995,GNB,2021,2021-11-14,4:25,3:25,,SEA,10,10,Sun,W 17-0,,3,43,5,39,8,82
9996,GNB,2021,2021-11-28,4:25,3:25,,LAR,12,12,Sun,W 36-28,,3,32,4,30,7,62
9997,GNB,2021,2021-12-12,8:20,7:20,,CHI,14,13,Sun,W 45-30,,3,30,7,41,10,71
9998,GNB,2021,2021-12-25,4:30,3:30,,CLE,16,15,Sat,W 24-22,,3,29,6,38,9,67
9999,HOU,2004,2004-11-21,8:35,7:35,,GNB,11,10,Sun,L 13-16,,3,25,10,90,13,115
10000,HOU,2004,2004-11-28,1:05,12:05,,TEN,12,11,Sun,W 31-21,,3,36,5,37,8,73
10001,HOU,2005,2005-10-23,1:03,12:03,,IND,7,6,Sun,L 20-38,,3,15,6,35,9,50
10002,HOU,2006,2006-09-10,1:02,12:02,,PHI,1,1,Sun,L 10-24,,3,20,5,51,8,71
10003,HOU,2006,2006-10-22,1:03,12:03,,JAX,7,6,Sun,W 27-7,,3,17,7,35,10,52
10004,HOU,2007,2007-11-18,1:02,12:02,,NOR,11,10,Sun,W 23-10,,3,22,4,30,7,52
10005,HOU,2007,2007-12-13,8:15,7:15,,DEN,15,14,Thu,W 31-13,,3,15,5,25,8,40
10006,HOU,2007,2007-12-30,1:02,12:02,,JAX,17,16,Sun,W 42-28,,3,20,8,45,11,65
10007,HOU,2008,2008-11-16,1:02,1:02,@,IND,11,10,Sun,L 27-33,,3,23,6,45,9,68
10008,HOU,2009,2009-12-27,1:02,1:02,@,MIA,16,15,Sun,W 27-20,,3,15,4,30,7,45
10009,HOU,2010,2010-11-21,1:03,1:03,@,NYJ,11,10,Sun,L 27-30,,3,25,4,39,7,64
10010,HOU,2010,2010-12-26,4:06,2:06,@,DEN,16,15,Sun,L 23-24,,3,24,4,27,7,51
10011,HOU,2012,2012-11-11,8:31,7:31,@,CHI,10,9,Sun,W 13-6,,3,35,5,49,8,84
10012,HOU,2014,2014-11-23,1:02,12:02,,CIN,12,11,Sun,L 13-22,,3,15,6,60,9,75
10013,HOU,2015,2015-10-25,1:02,1:02,@,MIA,7,7,Sun,L 26-44,,3,25,8,52,11,77
10014,HOU,2015,2015-11-22,1:03,12:03,,NYJ,11,10,Sun,W 24-17,,3,54,7,54,10,108
10015,HOU,2016,2016-12-04,1:00,12:00,@,GNB,13,12,Sun,L 13-21,,3,12,4,30,7,42
10016,HOU,2016,2016-12-24,8:25,7:25,,CIN,16,15,Sat,W 12-10,,3,25,6,60,9,85
10017,HOU,2017,2017-10-01,1:00,12:00,,TEN,4,4,Sun,W 57-14,,3,20,6,88,9,108
10018,HOU,2018,2018-11-26,8:15,7:15,,TEN,12,11,Mon,W 34-17,,3,53,7,50,10,103
10019,HOU,2020,2020-11-08,1:00,1:00,@,JAX,9,8,Sun,W 27-25,,3,18,4,78,7,96
10020,HOU,2020,2020-12-06,1:00,12:00,,IND,13,12,Sun,L 20-26,,3,30,7,50,10,80
10021,JAX,2000,2000-12-23,12:37,12:37,@,NYG,17,16,Sat,L 25-28,,3,25,1,10,4,35
10022,JAX,2001,2001-09-23,1:10,1:10,,TEN,2,2,Sun,W 13-6,,3,20,6,65,9,85
10023,JAX,2001,2001-10-18,8:35,8:35,,BUF,6,5,Thu,L 10-13,,3,35,5,31,8,66
10024,JAX,2001,2001-11-04,1:03,12:03,@,TEN,8,7,Sun,L 24-28,,3,14,8,48,11,62
10025,JAX,2001,2001-12-23,1:00,12:00,@,MIN,15,14,Sun,W 33-3,,3,34,3,33,6,67
10026,JAX,2001,2002-01-06,1:02,12:02,@,CHI,17,16,Sun,L 13-33,,3,14,3,14,6,28
10027,JAX,2002,2002-09-29,1:02,1:02,,NYJ,4,3,Sun,W 28-3,,3,15,4,25,7,40
10028,JAX,2003,2003-11-16,1:02,12:02,@,TEN,11,10,Sun,L 3-10,,3,15,2,12,5,27
10029,JAX,2003,2003-11-23,1:03,1:03,@,NYJ,12,11,Sun,L 10-13,,3,37,6,45,9,82
10030,JAX,2004,2004-11-21,1:02,1:02,,TEN,11,10,Sun,L 15-18,,3,22,4,49,7,71
10031,JAX,2004,2004-12-05,8:35,8:35,,PIT,13,12,Sun,L 16-17,,3,25,11,82,14,107
10032,JAX,2005,2005-11-20,1:02,12:02,@,TEN,11,10,Sun,W 31-28,,3,15,11,73,14,88
10033,JAX,2006,2006-12-10,1:03,1:03,,IND,14,13,Sun,W 44-17,,3,31,7,71,10,102
10034,JAX,2007,2007-09-23,4:05,2:05,@,DEN,3,3,Sun,W 23-14,,3,14,6,36,9,50
10035,JAX,2007,2007-10-14,1:03,1:03,,HOU,6,5,Sun,W 37-17,,3,28,8,58,11,86
10036,JAX,2009,2009-09-13,1:02,1:02,@,IND,1,1,Sun,L 12-14,,3,24,3,17,6,41
10037,JAX,2009,2009-10-18,1:03,1:03,,STL,6,6,Sun,W 23-20,OT,3,15,6,52,9,67
10038,JAX,2009,2010-01-03,1:02,1:02,@,CLE,17,16,Sun,L 17-23,,3,20,3,15,6,35
10039,JAX,2010,2010-11-28,1:02,1:02,@,NYG,12,11,Sun,L 20-24,,3,20,4,25,7,45
10040,JAX,2011,2011-12-05,8:41,8:41,,SDG,13,12,Mon,L 14-38,,3,26,6,55,9,81
10041,JAX,2012,2012-09-30,4:05,4:05,,CIN,4,4,Sun,L 10-27,,3,37,6,50,9,87
10042,JAX,2012,2012-11-04,1:04,1:04,,DET,9,8,Sun,L 14-31,,3,40,5,42,8,82
10043,JAX,2014,2014-09-28,4:05,1:05,@,SDG,4,4,Sun,L 14-33,,3,32,7,57,10,89
10044,JAX,2014,2014-10-19,1:02,1:02,,CLE,7,7,Sun,W 24-6,,3,25,8,50,11,75
10045,JAX,2014,2014-11-02,1:02,1:02,@,CIN,9,9,Sun,L 23-33,,3,35,6,40,9,75
10046,JAX,2014,2014-12-18,8:26,8:26,,TEN,16,15,Thu,W 21-13,,3,25,7,47,10,72
10047,JAX,2015,2015-09-13,1:03,1:03,,CAR,1,1,Sun,L 9-20,,3,25,3,22,6,47
10048,JAX,2015,2015-10-11,1:02,1:02,@,TAM,5,5,Sun,L 31-38,,3,12,10,72,13,84
10049,JAX,2019,2019-12-29,4:25,4:25,,IND,17,16,Sun,W 38-20,,3,27,4,36,7,63
10050,JAX,2020,2021-01-03,4:25,4:25,@,IND,17,16,Sun,L 14-28,,3,54,1,15,4,69
10051,JAX,2021,2021-12-05,4:25,1:25,@,LAR,13,12,Sun,L 7-37,,3,39,7,47,10,86
10052,JAX,2021,2022-01-02,1:00,1:00,@,NWE,17,16,Sun,L 10-50,,3,25,3,30,6,55
10053,KAN,2001,2001-11-11,1:02,1:02,@,NYJ,9,9,Sun,L 7-27,,3,25,0,0,3,25
10054,KAN,2001,2001-11-25,1:00,12:00,,SEA,11,10,Sun,W 19-7,,3,20,4,35,7,55
10055,KAN,2001,2001-11-29,8:30,7:30,,PHI,12,11,Thu,L 10-23,,3,43,5,35,8,78
10056,KAN,2002,2002-10-13,4:15,1:15,@,SDG,6,6,Sun,L 34-35,,3,30,4,35,7,65
10057,KAN,2005,2005-12-11,4:15,3:15,@,DAL,14,13,Sun,L 28-31,,3,17,5,45,8,62
10058,KAN,2006,2006-10-01,1:00,12:00,,SFO,4,3,Sun,W 41-0,,3,30,6,73,9,103
10059,KAN,2006,2006-12-03,1:03,1:03,@,CLE,13,12,Sun,L 28-31,OT,3,29,3,15,6,44
10060,KAN,2006,2006-12-17,8:15,5:15,@,SDG,15,14,Sun,L 9-20,,3,23,7,61,10,84
10061,KAN,2007,2007-10-07,1:00,12:00,,JAX,5,5,Sun,L 7-17,,3,25,5,30,8,55
10062,KAN,2008,2008-09-21,1:02,1:02,@,ATL,3,3,Sun,L 14-38,,3,13,4,22,7,35
10063,KAN,2008,2008-11-09,4:15,1:15,@,SDG,10,9,Sun,L 19-20,,3,16,5,37,8,53
10064,KAN,2009,2009-09-13,1:02,1:02,@,BAL,1,1,Sun,L 24-38,,3,15,8,65,11,80
10065,KAN,2009,2009-12-06,1:00,12:00,,DEN,13,12,Sun,L 13-44,,3,25,3,20,6,45
10066,KAN,2009,2009-12-20,1:00,12:00,,CLE,15,14,Sun,L 34-41,,3,34,3,20,6,54
10067,KAN,2010,2010-09-13,10:20,9:20,,SDG,1,1,Mon,W 21-14,,3,35,5,30,8,65
10068,KAN,2013,2013-09-08,1:03,1:03,@,JAX,1,1,Sun,W 28-2,,3,20,5,30,8,50
10069,KAN,2013,2013-12-08,1:03,1:03,@,WAS,14,13,Sun,W 45-10,,3,30,4,27,7,57
10070,KAN,2014,2014-09-07,1:02,12:02,,TEN,1,1,Sun,L 10-26,,3,25,12,110,15,135
10071,KAN,2014,2014-11-02,1:03,12:03,,NYJ,9,8,Sun,W 24-10,,3,20,5,40,8,60
10072,KAN,2014,2014-11-09,1:02,1:02,@,BUF,10,9,Sun,W 17-13,,3,19,6,44,9,63
10073,KAN,2014,2014-11-16,1:04,12:04,,SEA,11,10,Sun,W 24-20,,3,6,8,50,11,56
10074,KAN,2015,2015-10-11,1:02,12:02,,CHI,5,5,Sun,L 17-18,,3,49,6,49,9,98
10075,KAN,2015,2015-11-01,9:36,2:36,,DET,8,8,Sun,W 45-10,,3,20,8,81,11,101
10076,KAN,2017,2017-10-02,8:30,7:30,,WAS,4,4,Mon,W 29-20,,3,15,7,44,10,59
10077,KAN,2019,2019-10-27,8:20,7:20,,GNB,8,8,Sun,L 24-31,,3,30,4,25,7,55
10078,MIA,2002,2002-11-17,4:16,4:16,,BAL,11,10,Sun,W 26-7,,3,34,7,50,10,84
10079,MIA,2004,2004-10-17,1:01,1:01,@,BUF,6,6,Sun,L 13-20,,3,21,7,60,10,81
10080,MIA,2004,2004-11-01,9:08,9:08,@,NYJ,8,8,Mon,L 14-41,,3,20,6,45,9,65
10081,MIA,2005,2005-12-11,4:15,1:15,@,SDG,14,13,Sun,W 23-21,,3,12,7,49,10,61
10082,MIA,2006,2006-12-10,1:02,1:02,,NWE,14,13,Sun,W 21-0,,3,30,9,71,12,101
10083,MIA,2006,2006-12-31,4:15,4:15,@,IND,17,16,Sun,L 22-27,,3,20,5,45,8,65
10084,MIA,2007,2007-11-18,1:02,1:02,@,PHI,11,10,Sun,L 7-17,,3,15,4,40,7,55
10085,MIA,2008,2008-11-16,1:02,1:02,,OAK,11,10,Sun,W 17-15,,3,55,7,35,10,90
10086,MIA,2009,2009-11-08,1:02,1:02,@,NWE,9,8,Sun,L 17-27,,3,35,5,49,8,84
10087,MIA,2009,2009-11-15,1:03,1:03,,TAM,10,9,Sun,W 25-23,,3,30,9,77,12,107
10088,MIA,2009,2010-01-03,1:02,1:02,,PIT,17,16,Sun,L 24-30,,3,45,5,40,8,85
10089,MIA,2010,2010-09-12,1:02,1:02,@,BUF,1,1,Sun,W 15-10,,3,15,5,35,8,50
10090,MIA,2010,2010-10-24,1:02,1:02,,PIT,7,6,Sun,L 22-23,,3,35,5,34,8,69
10091,MIA,2011,2011-09-18,4:15,4:15,,HOU,2,2,Sun,L 13-23,,3,20,4,76,7,96
10092,MIA,2012,2012-09-16,1:02,1:02,,OAK,2,2,Sun,W 35-13,,3,21,5,42,8,63
10093,MIA,2012,2012-12-23,1:02,1:02,,BUF,16,15,Sun,W 24-10,,3,25,11,93,14,118
10094,MIA,2012,2012-12-30,4:25,4:25,@,NWE,17,16,Sun,L 0-28,,3,23,6,48,9,71
10095,MIA,2013,2013-11-17,4:05,4:05,,SDG,11,10,Sun,W 20-16,,3,15,10,76,13,91
10096,MIA,2013,2013-12-01,1:02,1:02,@,NYJ,13,12,Sun,W 23-3,,3,28,4,25,7,53
10097,MIA,2014,2014-09-14,1:02,1:02,@,BUF,2,2,Sun,L 10-29,,3,20,6,40,9,60
10098,MIA,2014,2014-11-02,1:02,1:02,,SDG,9,8,Sun,W 37-0,,3,25,7,57,10,82
10099,MIA,2014,2014-12-01,8:30,8:30,@,NYJ,13,12,Mon,W 16-13,,3,20,7,57,10,77
10100,MIA,2018,2018-11-11,4:25,12:00,@,GNB,10,10,Sun,L 12-31,,3,10,6,45,9,55
10101,MIA,2020,2020-09-20,1:00,1:00,,BUF,2,2,Sun,L 28-31,,3,20,6,55,9,75
10102,MIA,2020,2020-10-04,1:00,1:00,,SEA,4,4,Sun,L 23-31,,3,20,0,0,3,20
10103,MIA,2020,2020-11-01,1:00,1:00,,LAR,8,7,Sun,W 28-17,,3,30,5,45,8,75
10104,MIA,2020,2020-11-15,4:05,4:05,,LAC,10,9,Sun,W 29-21,,3,15,5,31,8,46
10105,MIA,2020,2020-11-29,1:00,1:00,@,NYJ,12,11,Sun,W 20-3,,3,20,6,74,9,94
10106,MIA,2020,2020-12-13,1:00,1:00,,KAN,14,13,Sun,L 27-33,,3,35,8,56,11,91
10107,MIA,2021,2021-12-05,1:00,1:00,,NYG,13,13,Sun,W 20-9,,3,15,3,23,6,38
10108,MIN,2001,2001-12-23,1:00,12:00,,JAX,15,14,Sun,L 3-33,,3,33,3,34,6,67
10109,MIN,2003,2003-09-14,8:30,7:30,,CHI,2,2,Sun,W 24-13,,3,25,6,50,9,75
10110,MIN,2005,2005-11-06,1:05,12:05,,DET,9,8,Sun,W 27-14,,3,18,6,31,9,49
10111,MIN,2007,2007-12-09,4:05,1:05,@,SFO,14,13,Sun,W 27-7,,3,25,7,35,10,60
10112,MIN,2008,2008-11-02,1:05,12:05,,HOU,9,8,Sun,W 28-21,,3,20,5,35,8,55
10113,MIN,2008,2008-12-21,4:15,3:15,,ATL,16,15,Sun,L 17-24,,3,15,6,70,9,85
10114,MIN,2009,2009-09-13,1:03,1:03,@,CLE,1,1,Sun,W 34-20,,3,38,8,66,11,104
10115,MIN,2009,2009-10-18,1:05,12:05,,BAL,6,6,Sun,W 33-31,,3,15,6,74,9,89
10116,MIN,2009,2009-11-01,4:15,3:15,@,GNB,8,8,Sun,W 38-26,,3,29,6,45,9,74
10117,MIN,2010,2010-11-28,1:02,1:02,@,WAS,12,11,Sun,W 17-13,,3,15,6,35,9,50
10118,MIN,2010,2011-01-02,1:03,1:03,@,DET,17,16,Sun,L 13-20,,3,25,5,33,8,58
10119,MIN,2012,2012-11-25,1:00,12:00,@,CHI,12,11,Sun,L 10-28,,3,44,5,55,8,99
10120,MIN,2012,2012-12-16,1:00,12:00,@,STL,15,14,Sun,W 36-22,,3,49,8,47,11,96
10121,MIN,2013,2013-09-15,1:03,12:03,@,CHI,2,2,Sun,L 30-31,,3,25,4,35,7,60
10122,MIN,2013,2013-10-21,8:40,8:40,@,NYG,7,6,Mon,L 7-23,,3,38,5,72,8,110
10123,MIN,2013,2013-12-15,1:02,12:02,,PHI,15,14,Sun,W 48-30,,3,25,9,94,12,119
10124,MIN,2014,2014-12-14,4:25,4:25,@,DET,15,14,Sun,L 14-16,,3,25,5,35,8,60
10125,MIN,2015,2015-09-27,1:02,12:02,,SDG,3,3,Sun,W 31-14,,3,39,7,74,10,113
10126,MIN,2015,2015-10-25,1:02,1:02,@,DET,7,6,Sun,W 28-19,,3,31,5,30,8,61
10127,MIN,2015,2015-11-15,4:05,1:05,@,OAK,10,9,Sun,W 30-14,,3,15,8,82,11,97
10128,MIN,2015,2015-12-10,8:25,6:25,@,ARI,14,13,Thu,L 20-23,,3,25,4,30,7,55
10129,MIN,2016,2016-09-11,1:05,12:05,@,TEN,1,1,Sun,W 25-16,,3,39,2,10,5,49
10130,MIN,2017,2017-11-12,1:00,1:00,@,WAS,10,9,Sun,W 38-30,,3,40,2,15,5,55
10131,MIN,2018,2018-11-04,1:00,3:00,,DET,9,9,Sun,W 24-9,,3,15,8,66,11,81
10132,MIN,2018,2018-12-30,4:25,3:00,,CHI,17,16,Sun,L 10-24,,3,30,11,102,14,132
10133,MIN,2019,2019-11-03,1:00,12:00,@,KAN,9,9,Sun,L 23-26,,3,25,4,25,7,50
10134,MIN,2019,2019-12-02,8:15,5:15,@,SEA,13,12,Mon,L 30-37,,3,30,1,30,4,60
10135,MIN,2019,2019-12-23,8:15,10:15,,GNB,16,15,Mon,L 10-23,,3,30,2,20,5,50
10136,MIN,2019,2019-12-29,1:00,3:00,,CHI,17,16,Sun,L 19-21,,3,40,3,34,6,74
10137,MIN,2020,2020-09-27,1:00,3:00,,TEN,3,3,Sun,L 30-31,,3,20,4,45,7,65
10138,MIN,2020,2020-10-18,1:00,3:00,,ATL,6,6,Sun,L 23-40,,3,30,5,25,8,55
10139,MIN,2020,2020-12-25,4:30,3:30,@,NOR,16,15,Fri,L 33-52,,3,20,4,38,7,58
10140,MIN,2021,2021-09-19,4:05,2:05,@,ARI,2,2,Sun,L 33-34,,3,16,5,40,8,56
10141,MIN,2021,2021-11-21,1:00,11:00,,GNB,11,10,Sun,W 34-31,,3,25,8,97,11,122
10142,MIN,2021,2022-01-02,8:20,7:20,@,GNB,17,16,Sun,L 10-37,,3,23,1,5,4,28
10143,NOR,2001,2001-10-21,12:03,12:03,,ATL,6,5,Sun,L 13-20,,3,25,5,34,8,59
10144,NOR,2001,2001-12-23,1:01,1:01,@,TAM,15,14,Sun,L 21-48,,3,23,5,40,8,63
10145,NOR,2001,2002-01-06,12:03,12:03,,SFO,17,16,Sun,L 0-38,,3,23,0,0,3,23
10146,NOR,2003,2003-11-30,4:05,4:05,@,WAS,13,12,Sun,W 24-20,,3,30,8,120,11,150
10147,NOR,2006,2006-11-12,4:15,4:15,@,PIT,10,9,Sun,L 31-38,,3,25,5,34,8,59
10148,NOR,2006,2006-12-03,1:04,12:04,,SFO,13,12,Sun,W 34-10,,3,47,7,37,10,84
10149,NOR,2007,2007-09-16,1:03,1:03,@,TAM,2,2,Sun,L 14-31,,3,35,2,10,5,45
10150,NOR,2007,2007-12-10,8:40,8:40,@,ATL,14,13,Mon,W 34-14,,3,20,4,40,7,60
10151,NOR,2007,2007-12-16,1:03,12:03,,ARI,15,14,Sun,W 31-24,,3,15,10,78,13,93
10152,NOR,2008,2008-10-19,1:04,1:04,@,CAR,7,7,Sun,L 7-30,,3,30,3,29,6,59
10153,NOR,2008,2008-12-07,1:02,12:02,,ATL,14,13,Sun,W 29-25,,3,30,5,34,8,64
10154,NOR,2008,2008-12-21,1:03,1:03,@,DET,16,15,Sun,W 42-7,,3,12,6,35,9,47
10155,NOR,2009,2009-09-20,1:04,1:04,@,PHI,2,2,Sun,W 48-22,,3,13,7,45,10,58
10156,NOR,2010,2010-09-09,8:41,7:41,,MIN,1,1,Thu,W 14-9,,3,20,6,60,9,80
10157,NOR,2010,2010-10-31,8:30,7:30,,PIT,8,8,Sun,W 20-10,,3,35,4,38,7,73
10158,NOR,2010,2010-11-21,4:05,3:05,,SEA,11,10,Sun,W 34-19,,3,24,8,79,11,103
10159,NOR,2011,2011-09-08,8:40,7:40,@,GNB,1,1,Thu,L 34-42,,3,15,6,48,9,63
10160,NOR,2011,2011-12-04,8:31,7:31,,DET,13,12,Sun,W 31-17,,3,30,11,107,14,137
10161,NOR,2012,2012-10-28,8:30,6:30,@,DEN,8,7,Sun,L 14-34,,3,15,5,34,8,49
10162,NOR,2014,2014-09-07,1:03,1:03,@,ATL,1,1,Sun,L 34-37,OT,3,27,10,96,13,123
10163,NOR,2014,2014-09-28,8:31,7:31,@,DAL,4,4,Sun,L 17-38,,3,20,6,50,9,70
10164,NOR,2014,2014-12-15,8:30,7:30,@,CHI,15,14,Mon,W 31-15,,3,25,9,74,12,99
10165,NOR,2014,2014-12-21,1:03,12:03,,ATL,16,15,Sun,L 14-30,,3,25,6,64,9,89
10166,NOR,2015,2015-10-15,8:26,7:26,,ATL,6,6,Thu,W 31-21,,3,15,7,41,10,56
10167,NOR,2016,2016-11-13,1:00,12:00,,DEN,10,9,Sun,L 23-25,,3,25,1,10,4,35
10168,NOR,2017,2017-12-24,1:00,12:00,,ATL,16,15,Sun,W 23-13,,3,30,10,91,13,121
10169,NOR,2018,2018-11-22,8:20,7:20,,ATL,12,11,Thu,W 31-17,,3,19,2,26,5,45
10170,NOR,2019,2019-10-13,1:00,1:00,@,JAX,6,6,Sun,W 13-6,,3,35,2,15,5,50
10171,NOR,2019,2019-12-29,1:00,1:00,@,CAR,17,16,Sun,W 42-10,,3,44,5,54,8,98
10172,NOR,2020,2020-11-08,8:20,8:20,@,TAM,9,8,Sun,W 38-3,,3,28,5,39,8,67
10173,NOR,2021,2021-11-21,1:00,1:00,@,PHI,11,10,Sun,L 29-40,,3,25,6,49,9,74
10174,NWE,2000,2000-09-11,9:09,9:09,@,NYJ,2,2,Mon,L 19-20,,3,8,6,69,9,77
10175,NWE,2000,2000-09-24,1:03,1:03,@,MIA,4,4,Sun,L 3-10,,3,30,5,40,8,70
10176,NWE,2001,2001-09-09,1:03,1:03,@,CIN,1,1,Sun,L 17-23,,3,15,3,20,6,35
10177,NWE,2001,2001-10-07,1:03,1:03,@,MIA,4,4,Sun,L 10-30,,3,20,11,86,14,106
10178,NWE,2001,2001-11-18,8:35,8:35,,STL,10,10,Sun,L 17-24,,3,15,5,36,8,51
10179,NWE,2002,2002-09-15,1:03,1:03,@,NYJ,2,2,Sun,W 44-7,,3,36,7,55,10,91
10180,NWE,2003,2003-10-26,1:02,1:02,,CLE,8,8,Sun,W 9-3,,3,30,5,25,8,55
10181,NWE,2004,2004-12-26,4:05,4:05,@,NYJ,16,15,Sun,W 23-7,,3,25,4,20,7,45
10182,NWE,2006,2006-10-22,1:02,1:02,@,BUF,7,6,Sun,W 28-6,,3,25,9,67,12,92
10183,NWE,2007,2007-10-01,8:40,8:40,@,CIN,4,4,Mon,W 34-13,,3,20,8,65,11,85
10184,NWE,2007,2007-12-09,4:15,4:15,,PIT,14,13,Sun,W 34-13,,3,20,6,49,9,69
10185,NWE,2008,2008-09-07,1:02,1:02,,KAN,1,1,Sun,W 17-10,,3,30,2,15,5,45
10186,NWE,2010,2010-10-04,8:41,8:41,@,MIA,4,4,Mon,W 41-14,,3,31,6,40,9,71
10187,NWE,2010,2010-11-07,1:02,1:02,@,CLE,9,8,Sun,L 14-34,,3,20,4,28,7,48
10188,NWE,2011,2011-11-21,8:40,8:40,,KAN,11,10,Mon,W 34-3,,3,20,5,34,8,54
10189,NWE,2011,2011-11-27,4:15,4:15,@,PHI,12,11,Sun,W 38-20,,3,20,10,60,13,80
10190,NWE,2011,2011-12-04,1:02,1:02,,IND,13,12,Sun,W 31-24,,3,20,5,29,8,49
10191,NWE,2012,2012-09-09,1:03,12:03,@,TEN,1,1,Sun,W 34-13,,3,20,3,30,6,50
10192,NWE,2013,2013-09-12,8:29,8:29,,NYJ,2,2,Thu,W 13-10,,3,30,8,66,11,96
10193,NWE,2013,2013-11-03,4:25,4:25,,PIT,9,9,Sun,W 55-31,,3,30,8,96,11,126
10194,NWE,2014,2014-09-29,8:31,7:31,@,KAN,4,4,Mon,L 14-41,,3,30,4,35,7,65
10195,NWE,2015,2015-12-06,4:25,4:25,,PHI,13,12,Sun,L 28-35,,3,30,8,97,11,127
10196,NWE,2016,2016-09-22,8:26,8:26,,HOU,3,3,Thu,W 27-0,,3,15,6,43,9,58
10197,NWE,2016,2016-12-24,1:00,1:00,,NYJ,16,15,Sat,W 41-3,,3,20,6,77,9,97
10198,NWE,2019,2019-10-10,8:20,8:20,,NYG,6,6,Thu,W 35-14,,3,20,5,40,8,60
10199,NWE,2019,2019-12-21,4:30,4:30,,BUF,16,15,Sat,W 24-17,,3,30,7,46,10,76
10200,NWE,2020,2020-09-13,1:00,1:00,,MIA,1,1,Sun,W 21-11,,3,47,4,35,7,82
10201,NWE,2020,2020-10-25,4:25,4:25,,SFO,7,6,Sun,L 6-33,,3,30,6,65,9,95
10202,NWE,2020,2020-11-15,8:20,8:20,,BAL,10,9,Sun,W 23-17,,3,18,8,64,11,82
10203,NWE,2020,2020-12-06,4:25,1:25,@,LAC,13,12,Sun,W 45-0,,3,15,5,30,8,45
10204,NWE,2021,2021-12-26,1:00,1:00,,BUF,16,15,Sun,L 21-33,,3,30,5,45,8,75
10205,NWE,2021,2022-01-02,1:00,1:00,,JAX,17,16,Sun,W 50-10,,3,30,3,25,6,55
10206,NYG,2000,2000-11-05,1:03,1:03,@,CLE,10,9,Sun,W 24-3,,3,39,4,55,7,94
10207,NYG,2000,2000-12-03,1:01,1:01,@,WAS,14,13,Sun,W 9-7,,3,20,4,35,7,55
10208,NYG,2001,2001-10-22,9:09,9:09,,PHI,6,6,Mon,L 9-10,,3,31,7,35,10,66
10209,NYG,2002,2002-09-22,4:14,4:14,,SEA,3,3,Sun,W 9-6,,3,24,6,37,9,61
10210,NYG,2004,2005-01-02,8:36,8:36,,DAL,17,16,Sun,W 28-24,,3,25,6,93,9,118
10211,NYG,2006,2006-10-23,8:40,7:40,@,DAL,7,6,Mon,W 36-22,,3,24,1,5,4,29
10212,NYG,2007,2007-09-23,4:15,4:15,@,WAS,3,3,Sun,W 24-17,,3,15,6,37,9,52
10213,NYG,2007,2007-10-07,1:02,1:02,,NYJ,5,5,Sun,W 35-24,,3,37,6,40,9,77
10214,NYG,2007,2007-12-09,1:02,1:02,@,PHI,14,13,Sun,W 16-13,,3,15,7,41,10,56
10215,NYG,2007,2007-12-16,8:24,8:24,,WAS,15,14,Sun,L 10-22,,3,35,4,35,7,70
10216,NYG,2008,2008-11-30,1:04,1:04,@,WAS,13,12,Sun,W 23-7,,3,19,7,47,10,66
10217,NYG,2009,2009-12-21,8:40,8:40,@,WAS,15,14,Mon,W 45-12,,3,15,6,52,9,67
10218,NYG,2010,2010-09-19,8:31,8:31,@,IND,2,2,Sun,L 14-38,,3,25,6,55,9,80
10219,NYG,2011,2012-01-01,8:31,8:31,,DAL,17,16,Sun,W 31-14,,3,28,7,43,10,71
10220,NYG,2012,2012-10-07,1:02,1:02,,CLE,5,5,Sun,W 41-27,,3,25,10,91,13,116
10221,NYG,2012,2012-10-21,1:03,1:03,,WAS,7,7,Sun,W 27-23,,3,30,7,55,10,85
10222,NYG,2013,2013-11-17,4:25,4:25,,GNB,11,10,Sun,W 27-13,,3,30,5,38,8,68
10223,NYG,2013,2013-12-29,1:04,1:04,,WAS,17,16,Sun,W 20-6,,3,20,3,30,6,50
10224,NYG,2014,2014-10-05,1:03,1:03,,ATL,5,5,Sun,W 30-20,,3,15,8,81,11,96
10225,NYG,2014,2014-11-16,1:03,1:03,,SFO,11,10,Sun,L 10-16,,3,54,4,35,7,89
10226,NYG,2015,2015-10-25,4:25,4:25,,DAL,7,7,Sun,W 27-20,,3,13,7,46,10,59
10227,NYG,2015,2015-12-14,8:30,8:30,@,MIA,14,13,Mon,W 31-24,,3,25,12,123,15,148
10228,NYG,2016,2016-09-18,1:03,1:03,,NOR,2,2,Sun,W 16-13,,3,25,7,76,10,101
10229,NYG,2016,2016-10-23,9:31,2:31,@,LAR,7,7,Sun,W 17-10,,3,33,8,43,11,76
10230,NYG,2017,2017-12-31,1:00,1:00,,WAS,17,16,Sun,W 18-10,,3,25,4,35,7,60
10231,NYG,2018,2018-09-16,8:20,7:20,@,DAL,2,2,Sun,L 13-20,,3,24,6,47,9,71
10232,NYG,2018,2018-09-23,1:00,12:00,@,HOU,3,3,Sun,W 27-22,,3,20,7,50,10,70
10233,NYG,2020,2020-09-20,1:00,12:00,@,CHI,2,2,Sun,L 13-17,,3,10,5,48,8,58
10234,NYG,2021,2021-10-03,1:00,12:00,@,NOR,4,4,Sun,W 27-21,OT,3,25,5,35,8,60
10235,NYG,2021,2021-12-05,1:00,1:00,@,MIA,13,12,Sun,L 9-20,,3,23,3,15,6,38
10236,NYG,2021,2021-12-12,4:05,1:05,@,LAC,14,13,Sun,L 21-37,,3,20,6,39,9,59
10237,NYG,2021,2022-01-02,1:00,12:00,@,CHI,17,16,Sun,L 3-29,,3,26,5,35,8,61
10238,NYG,2021,2022-01-09,1:00,1:00,,WAS,18,17,Sun,L 7-22,,3,21,3,29,6,50
10239,NYJ,2000,2000-09-17,1:03,1:03,,BUF,3,3,Sun,W 27-14,,3,10,7,66,10,76
10240,NYJ,2000,2000-10-23,9:10,9:10,,MIA,8,7,Mon,W 40-37,OT,3,30,13,95,16,125
10241,NYJ,2001,2001-09-09,1:03,1:03,,IND,1,1,Sun,L 24-45,,3,30,2,10,5,40
10242,NYJ,2001,2001-10-14,4:15,4:15,,MIA,5,5,Sun,W 21-17,,3,30,6,72,9,102
10243,NYJ,2001,2001-10-28,1:02,1:02,@,CAR,7,7,Sun,W 13-12,,3,15,5,55,8,70
10244,NYJ,2001,2001-12-09,4:15,4:15,@,PIT,13,12,Sun,L 7-18,,3,30,4,40,7,70
10245,NYJ,2001,2001-12-30,1:03,1:03,,BUF,16,15,Sun,L 9-14,,3,25,9,53,12,78
10246,NYJ,2002,2002-12-02,9:08,6:08,@,OAK,13,12,Mon,L 20-26,,3,40,10,83,13,123
10247,NYJ,2002,2002-12-29,4:16,4:16,,GNB,17,16,Sun,W 42-17,,3,30,5,43,8,73
10248,NYJ,2003,2003-10-12,4:15,4:15,,BUF,6,5,Sun,W 30-3,,3,25,5,45,8,70
10249,NYJ,2003,2003-11-02,1:03,1:03,,NYG,9,8,Sun,L 28-31,OT,3,30,6,62,9,92
10250,NYJ,2003,2003-11-09,4:15,1:15,@,OAK,10,9,Sun,W 27-24,OT,3,25,6,37,9,62
10251,NYJ,2003,2003-12-01,9:09,9:09,,TEN,13,12,Mon,W 24-17,,3,17,5,36,8,53
10252,NYJ,2006,2006-12-03,1:02,12:02,@,GNB,13,12,Sun,W 38-10,,3,20,4,29,7,49
10253,NYJ,2006,2006-12-10,4:15,4:15,,BUF,14,13,Sun,L 13-31,,3,15,2,10,5,25
10254,NYJ,2006,2006-12-31,1:02,1:02,,OAK,17,16,Sun,W 23-3,,3,31,6,32,9,63
10255,NYJ,2008,2008-11-23,1:02,12:02,@,TEN,12,11,Sun,W 34-13,,3,27,8,60,11,87
10256,NYJ,2008,2008-12-14,1:02,1:02,,BUF,15,14,Sun,W 31-27,,3,25,4,33,7,58
10257,NYJ,2009,2009-09-27,1:03,1:03,,TEN,3,3,Sun,W 24-17,,3,25,3,15,6,40
10258,NYJ,2009,2009-10-04,4:05,3:05,@,NOR,4,4,Sun,L 10-24,,3,21,7,70,10,91
10259,NYJ,2009,2009-11-29,1:02,1:02,,CAR,12,11,Sun,W 17-6,,3,24,5,30,8,54
10260,NYJ,2009,2009-12-03,8:20,8:20,@,BUF,13,12,Thu,W 19-13,,3,18,1,5,4,23
10261,NYJ,2010,2010-12-19,4:15,4:15,@,PIT,15,14,Sun,W 22-17,,3,19,3,35,6,54
10262,NYJ,2010,2010-12-26,1:02,12:02,@,CHI,16,15,Sun,L 34-38,,3,34,6,31,9,65
10263,NYJ,2010,2011-01-02,1:03,1:03,,BUF,17,16,Sun,W 38-7,,3,25,3,15,6,40
10264,NYJ,2012,2012-11-18,1:00,12:00,@,STL,11,10,Sun,W 27-13,,3,20,5,30,8,50
10265,NYJ,2012,2012-12-02,1:03,1:03,,ARI,13,12,Sun,W 7-6,,3,20,4,30,7,50
10266,NYJ,2013,2013-12-15,4:05,4:05,@,CAR,15,14,Sun,L 20-30,,3,20,6,59,9,79
10267,NYJ,2015,2015-11-12,8:26,8:26,,BUF,10,9,Thu,L 17-22,,3,20,5,44,8,64
10268,NYJ,2015,2015-12-13,1:02,1:02,,TEN,14,13,Sun,W 30-8,,3,20,3,20,6,40
10269,NYJ,2016,2016-09-25,4:26,3:26,@,KAN,3,3,Sun,L 3-24,,3,15,5,59,8,74
10270,NYJ,2016,2016-12-17,8:25,8:25,,MIA,15,14,Sat,L 13-34,,3,42,9,70,12,112
10271,NYJ,2019,2019-12-22,1:00,1:00,,PIT,16,15,Sun,W 16-10,,3,30,4,34,7,64
10272,NYJ,2020,2020-11-01,1:00,12:00,@,KAN,8,8,Sun,L 9-35,,3,25,7,61,10,86
10273,NYJ,2020,2021-01-03,1:00,1:00,@,NWE,17,16,Sun,L 14-28,,3,30,6,47,9,77
10274,NYJ,2021,2021-12-19,1:00,1:00,@,MIA,15,14,Sun,L 24-31,,3,32,5,45,8,77
10275,TEN,2000,2000-09-24,1:01,1:01,@,PIT,4,3,Sun,W 23-20,,3,25,5,35,8,60
10276,TEN,2000,2000-12-17,1:03,1:03,@,CLE,16,15,Sun,W 24-0,,3,25,7,66,10,91
10277,TEN,2001,2001-12-09,1:00,12:00,@,MIN,13,12,Sun,L 24-42,,3,20,5,35,8,55
10278,TEN,2001,2001-12-16,4:15,3:15,,GNB,14,13,Sun,W 26-20,,3,24,4,30,7,54
10279,TEN,2002,2002-11-10,1:03,12:03,,HOU,10,9,Sun,W 17-10,,3,20,5,47,8,67
10280,TEN,2003,2003-09-21,1:03,12:03,,NOR,3,3,Sun,W 27-12,,3,14,5,27,8,41
10281,TEN,2004,2004-12-25,8:35,7:35,,DEN,16,15,Sat,L 16-37,,3,16,2,45,5,61
10282,TEN,2006,2006-11-12,1:03,12:03,,BAL,10,9,Sun,L 26-27,,3,20,8,91,11,111
10283,TEN,2006,2006-11-26,4:15,3:15,,NYG,12,11,Sun,W 24-21,,3,30,5,43,8,73
10284,TEN,2008,2008-12-28,1:02,1:02,@,IND,17,16,Sun,L 0-23,,3,30,3,20,6,50
10285,TEN,2009,2009-09-27,1:03,1:03,@,NYJ,3,3,Sun,L 17-24,,3,15,3,25,6,40
10286,TEN,2011,2011-10-30,1:02,12:02,,IND,8,7,Sun,W 27-10,,3,40,10,66,13,106
10287,TEN,2011,2011-12-04,1:02,1:02,@,BUF,13,12,Sun,W 23-17,,3,20,2,15,5,35
10288,TEN,2012,2012-09-09,1:03,12:03,,NWE,1,1,Sun,L 13-34,,3,30,3,20,6,50
10289,TEN,2012,2012-10-21,1:02,1:02,@,BUF,7,7,Sun,W 35-34,,3,25,8,65,11,90
10290,TEN,2013,2013-11-03,1:00,12:00,@,STL,9,8,Sun,W 28-21,,3,30,6,44,9,74
10291,TEN,2013,2013-12-15,4:27,3:27,,ARI,15,14,Sun,L 34-37,OT,3,16,9,69,12,85
10292,TEN,2015,2015-12-13,1:02,1:02,@,NYJ,14,13,Sun,L 8-30,,3,20,3,20,6,40
10293,TEN,2015,2015-12-20,1:02,1:02,@,NWE,15,14,Sun,L 16-33,,3,29,5,35,8,64
10294,TEN,2017,2017-11-05,1:00,12:00,,BAL,9,8,Sun,W 23-20,,3,39,6,39,9,78
10295,TEN,2017,2017-12-17,4:25,1:25,@,SFO,15,14,Sun,L 23-25,,3,22,7,70,10,92
10296,TEN,2018,2018-11-05,8:15,7:15,@,DAL,9,8,Mon,W 28-14,,3,20,6,52,9,72
10297,TEN,2018,2018-12-06,8:20,7:20,,JAX,14,13,Thu,W 30-9,,3,30,7,67,10,97
10298,TEN,2019,2019-12-01,1:00,1:00,@,IND,13,12,Sun,W 31-17,,3,33,6,40,9,73
10299,TEN,2020,2020-11-12,8:20,7:20,,IND,10,9,Thu,L 17-34,,3,30,9,73,12,103
10300,TEN,2020,2020-12-20,1:00,12:00,,DET,15,14,Sun,W 46-25,,3,22,3,33,6,55
10301,TEN,2020,2020-12-27,8:20,7:20,@,GNB,16,15,Sun,L 14-40,,3,15,0,0,3,15
10302,PHI,2001,2001-11-18,1:03,12:03,@,DAL,10,9,Sun,W 36-3,,3,22,10,81,13,103
10303,PHI,2001,2001-12-30,4:06,4:06,,NYG,16,15,Sun,W 24-21,,3,25,6,73,9,98
10304,PHI,2002,2002-09-22,1:02,1:02,,DAL,3,3,Sun,W 44-13,,3,25,7,92,10,117
10305,PHI,2002,2002-11-10,1:03,1:03,,IND,10,9,Sun,L 13-35,,3,25,3,25,6,50
10306,PHI,2002,2002-12-08,4:05,1:05,@,SEA,14,13,Sun,W 27-20,,3,15,8,56,11,71
10307,PHI,2003,2003-09-08,9:09,9:09,,TAM,1,1,Mon,L 0-17,,3,25,7,64,10,89
10308,PHI,2003,2003-12-07,1:03,1:03,,DAL,14,13,Sun,W 36-10,,3,25,9,62,12,87
10309,PHI,2004,2004-09-20,9:09,9:09,,MIN,2,2,Mon,W 27-16,,3,25,10,70,13,95
10310,PHI,2005,2005-10-02,4:15,3:15,@,KAN,4,4,Sun,W 37-31,,3,25,6,40,9,65
10311,PHI,2006,2006-10-08,4:14,4:14,,DAL,5,5,Sun,W 38-24,,3,67,7,49,10,116
10312,PHI,2006,2006-11-26,8:21,8:21,@,IND,12,11,Sun,L 21-45,,3,15,4,30,7,45
10313,PHI,2007,2007-11-25,8:23,8:23,@,NWE,12,11,Sun,L 28-31,,3,18,7,44,10,62
10314,PHI,2008,2008-09-28,8:23,7:23,@,CHI,4,4,Sun,L 20-24,,3,25,1,5,4,30
10315,PHI,2008,2008-12-21,4:16,4:16,@,WAS,16,15,Sun,L 3-10,,3,20,3,25,6,45
10316,PHI,2009,2009-09-27,1:02,1:02,,KAN,3,3,Sun,W 34-14,,3,20,10,90,13,110
10317,PHI,2010,2010-11-28,4:15,3:15,@,CHI,12,11,Sun,L 26-31,,3,19,6,56,9,75
10318,PHI,2013,2013-10-13,1:03,1:03,@,TAM,6,6,Sun,W 31-20,,3,31,8,72,11,103
10319,PHI,2014,2014-10-12,8:41,8:41,,NYG,6,6,Sun,W 27-0,,3,25,10,75,13,100
10320,PHI,2015,2016-01-03,1:03,1:03,@,NYG,17,16,Sun,W 35-30,,3,11,2,10,5,21
10321,PHI,2016,2016-12-18,1:00,1:00,@,BAL,15,14,Sun,L 26-27,,3,30,7,62,10,92
10322,PHI,2017,2017-11-19,8:30,7:30,@,DAL,11,10,Sun,W 37-9,,3,30,2,10,5,40
10323,PHI,2020,2020-09-13,1:00,1:00,@,WAS,1,1,Sun,L 17-27,,3,20,7,55,10,75
10324,PHI,2020,2020-10-04,8:20,5:20,@,SFO,4,4,Sun,W 25-20,,3,25,6,42,9,67
10325,PHI,2020,2020-10-18,1:00,1:00,,BAL,6,6,Sun,L 28-30,,3,20,12,132,15,152
10326,PHI,2021,2021-11-07,4:05,4:05,,LAC,9,9,Sun,L 24-27,,3,25,4,30,7,55
10327,PHI,2021,2021-12-05,1:00,1:00,@,NYJ,13,13,Sun,W 33-18,,3,20,6,66,9,86
10328,PHI,2021,2022-01-08,8:15,8:15,,DAL,18,17,Sat,L 26-51,,3,30,5,44,8,74
10329,PIT,2000,2000-10-29,1:02,1:02,@,BAL,9,8,Sun,W 9-6,,3,20,4,20,7,40
10330,PIT,2000,2000-12-03,1:01,1:01,,OAK,14,13,Sun,W 21-20,,3,15,3,31,6,46
10331,PIT,2001,2001-12-02,1:01,1:01,,MIN,12,11,Sun,W 21-16,,3,30,5,36,8,66
10332,PIT,2002,2002-11-03,1:03,1:03,@,CLE,9,8,Sun,W 23-20,,3,21,11,85,14,106
10333,PIT,2003,2003-11-17,9:09,6:09,@,SFO,11,10,Mon,L 14-30,,3,30,4,20,7,50
10334,PIT,2003,2003-12-21,4:05,4:05,,SDG,16,15,Sun,W 40-24,,3,24,2,10,5,34
10335,PIT,2003,2003-12-28,8:36,8:36,@,BAL,17,16,Sun,L 10-13,OT,3,40,10,55,13,95
10336,PIT,2004,2004-09-12,1:04,1:04,,OAK,1,1,Sun,W 24-21,,3,20,5,31,8,51
10337,PIT,2004,2004-12-26,1:01,1:01,,BAL,16,15,Sun,W 20-7,,3,25,3,30,6,55
10338,PIT,2005,2005-09-11,1:05,1:05,,TEN,1,1,Sun,W 34-7,,3,27,7,49,10,76
10339,PIT,2005,2005-12-24,1:03,1:03,@,CLE,16,15,Sat,W 41-0,,3,30,4,25,7,55
10340,PIT,2006,2006-09-18,8:40,8:40,@,JAX,2,2,Mon,L 0-9,,3,25,10,86,13,111
10341,PIT,2007,2007-09-23,1:02,1:02,,SFO,3,3,Sun,W 37-16,,3,13,2,10,5,23
10342,PIT,2007,2007-10-21,8:23,6:23,@,DEN,7,6,Sun,L 28-31,,3,23,2,20,5,43
10343,PIT,2007,2007-10-28,1:02,1:02,@,CIN,8,7,Sun,W 24-13,,3,20,2,10,5,30
10344,PIT,2007,2007-11-26,8:55,8:55,,MIA,12,11,Mon,W 3-0,,3,30,4,19,7,49
10345,PIT,2008,2008-10-19,1:04,1:04,@,CIN,7,6,Sun,W 38-10,,3,15,4,55,7,70
10346,PIT,2008,2008-11-09,4:15,4:15,,IND,10,9,Sun,L 20-24,,3,20,6,45,9,65
10347,PIT,2008,2008-12-21,1:02,12:02,@,TEN,16,15,Sun,L 14-31,,3,17,4,45,7,62
10348,PIT,2009,2009-10-25,1:03,1:03,,MIN,7,7,Sun,W 27-17,,3,15,11,78,14,93
10349,PIT,2010,2010-12-19,4:15,4:15,,NYJ,15,14,Sun,L 17-22,,3,35,3,19,6,54
10350,PIT,2010,2011-01-02,1:02,1:02,@,CLE,17,16,Sun,W 41-9,,3,25,6,46,9,71
10351,PIT,2012,2012-10-28,1:02,1:02,,WAS,8,7,Sun,W 27-12,,3,20,7,55,10,75
10352,PIT,2012,2012-12-30,1:02,1:02,,CLE,17,16,Sun,W 24-10,,3,58,9,79,12,137
10353,PIT,2013,2013-09-16,8:41,8:41,@,CIN,2,2,Mon,L 10-20,,3,29,9,84,12,113
10354,PIT,2013,2013-10-27,4:05,1:05,@,OAK,8,7,Sun,L 18-21,,3,12,6,39,9,51
10355,PIT,2014,2014-11-09,1:02,1:02,@,NYJ,10,10,Sun,L 13-20,,3,20,9,75,12,95
10356,PIT,2014,2014-12-07,1:02,1:02,@,CIN,14,13,Sun,W 42-21,,3,20,7,54,10,74
10357,PIT,2014,2014-12-14,1:02,1:02,@,ATL,15,14,Sun,W 27-20,,3,34,3,25,6,59
10358,PIT,2015,2015-12-27,1:02,1:02,@,BAL,16,15,Sun,L 17-20,,3,25,12,121,15,146
10359,PIT,2017,2017-12-31,1:00,1:00,,CLE,17,16,Sun,W 28-24,,3,15,9,77,12,92
10360,PIT,2018,2018-11-18,1:00,1:00,@,JAX,11,10,Sun,W 20-16,,3,15,11,111,14,126
10361,PIT,2020,2020-09-14,7:15,7:15,@,NYG,1,1,Mon,W 26-16,,3,21,4,25,7,46
10362,PIT,2020,2020-11-01,1:00,1:00,@,BAL,8,7,Sun,W 28-24,,3,30,9,110,12,140
10363,PIT,2020,2020-11-08,4:25,3:25,@,DAL,9,8,Sun,W 24-19,,3,16,7,70,10,86
10364,PIT,2020,2020-12-13,8:20,8:20,@,BUF,14,13,Sun,L 15-26,,3,55,7,48,10,103
10365,OAK,2000,2000-12-03,1:01,1:01,@,PIT,14,13,Sun,L 20-21,,3,31,3,15,6,46
10366,OAK,2001,2001-09-23,1:10,1:10,@,MIA,2,2,Sun,L 15-18,,3,25,5,40,8,65
10367,OAK,2003,2003-12-22,9:05,6:05,,GNB,16,15,Mon,L 7-41,,3,25,10,70,13,95
10368,OAK,2006,2006-11-12,4:05,1:05,,DEN,10,9,Sun,L 13-17,,3,25,4,15,7,40
10369,OAK,2007,2007-12-02,4:05,1:05,,DEN,13,12,Sun,W 34-20,,3,20,5,25,8,45
10370,OAK,2009,2009-10-18,4:05,1:05,,PHI,6,6,Sun,W 13-9,,3,23,4,38,7,61
10371,OAK,2009,2009-10-25,4:05,1:05,,NYJ,7,7,Sun,L 0-38,,3,24,2,8,5,32
10372,OAK,2009,2009-11-22,4:15,1:15,,CIN,11,10,Sun,W 20-17,,3,13,8,59,11,72
10373,OAK,2012,2012-09-23,4:25,1:25,,PIT,3,3,Sun,W 34-31,,3,25,10,81,13,106
10374,OAK,2012,2012-11-25,1:02,1:02,@,CIN,12,11,Sun,L 10-34,,3,25,3,25,6,50
10375,OAK,2015,2015-11-08,1:02,1:02,@,PIT,9,8,Sun,L 35-38,,3,21,5,42,8,63
10376,OAK,2016,2016-10-16,4:05,1:05,,KAN,6,6,Sun,L 10-26,,3,25,2,10,5,35
10377,OAK,2017,2017-10-08,4:05,1:05,,BAL,5,5,Sun,L 17-30,,3,24,1,5,4,29
10378,OAK,2019,2019-12-08,4:25,1:25,,TEN,14,13,Sun,L 21-42,,3,20,4,21,7,41
10379,LVR,2020,2020-09-13,1:00,1:00,@,CAR,1,1,Sun,W 34-30,,3,40,5,65,8,105
10380,LVR,2020,2020-09-21,8:15,5:15,,NOR,2,2,Mon,W 34-24,,3,13,10,129,13,142
10381,LVR,2020,2020-12-06,1:00,1:00,@,NYJ,13,12,Sun,W 31-28,,3,21,6,40,9,61
10382,LVR,2021,2021-12-26,4:25,1:25,,DEN,16,15,Sun,W 17-13,,3,37,3,30,6,67
10383,STL,2000,2000-09-17,1:02,12:02,,SFO,3,3,Sun,W 41-24,,3,25,7,53,10,78
10384,STL,2001,2001-10-08,9:07,9:07,@,DET,4,4,Mon,W 35-0,,3,15,8,68,11,83
10385,STL,2003,2003-09-21,4:06,1:06,@,SEA,3,3,Sun,L 23-24,,3,15,4,30,7,45
10386,STL,2003,2003-11-23,4:06,2:06,@,ARI,12,11,Sun,W 30-27,OT,3,25,8,60,11,85
10387,STL,2007,2007-09-23,1:02,1:02,@,TAM,3,3,Sun,L 3-24,,3,25,5,40,8,65
10388,STL,2007,2007-11-18,4:15,1:15,@,SFO,11,10,Sun,W 13-9,,3,20,7,39,10,59
10389,STL,2007,2007-12-20,8:15,7:15,,PIT,16,15,Thu,L 24-41,,3,20,2,36,5,56
10390,STL,2008,2008-12-28,1:02,1:02,@,ATL,17,16,Sun,L 27-31,,3,14,3,14,6,28
10391,STL,2009,2009-12-20,1:00,12:00,,HOU,15,14,Sun,L 13-16,,3,15,4,30,7,45
10392,STL,2014,2014-11-16,1:00,12:00,,DEN,11,10,Sun,W 22-7,,3,25,8,62,11,87
10393,LAR,2017,2017-12-17,4:05,1:05,@,SEA,15,14,Sun,W 42-7,,3,25,9,60,12,85
10394,LAR,2019,2019-12-08,8:20,5:20,,SEA,14,13,Sun,W 28-12,,3,20,8,64,11,84
10395,LAR,2020,2020-09-27,1:00,1:00,@,BUF,3,3,Sun,L 32-35,,3,30,5,55,8,85
10396,LAR,2020,2020-11-29,4:05,1:05,,SFO,12,11,Sun,L 20-23,,3,27,5,40,8,67
10397,LAR,2021,2021-10-31,1:00,12:00,@,HOU,8,8,Sun,W 38-22,,3,20,6,38,9,58
10398,LAR,2021,2022-01-09,4:25,1:25,,SFO,18,17,Sun,L 24-27,OT,3,15,6,56,9,71
10399,BAL,2000,2000-11-26,1:01,1:01,,CLE,13,13,Sun,W 44-7,,3,25,3,11,6,36
10400,BAL,2000,2000-12-10,1:02,1:02,,SDG,15,14,Sun,W 24-3,,3,15,4,20,7,35
10401,BAL,2001,2001-12-16,8:35,8:35,,PIT,14,13,Sun,L 21-26,,3,35,7,70,10,105
10402,BAL,2001,2001-12-23,1:02,1:02,,CIN,15,14,Sun,W 16-0,,3,40,6,40,9,80
10403,BAL,2002,2002-09-15,1:02,1:02,,TAM,2,2,Sun,L 0-25,,3,25,10,74,13,99
10404,BAL,2004,2004-11-07,8:36,8:36,,CLE,9,8,Sun,W 27-13,,3,25,9,55,12,80
10405,BAL,2004,2004-12-26,1:01,1:01,@,PIT,16,15,Sun,L 7-20,,3,30,3,25,6,55
10406,BAL,2005,2005-10-02,4:05,4:05,,NYJ,4,3,Sun,W 13-3,,3,19,5,39,8,58
10407,BAL,2005,2005-12-11,4:15,2:15,@,DEN,14,13,Sun,L 10-12,,3,20,4,31,7,51
10408,BAL,2006,2006-10-09,8:41,6:41,@,DEN,5,5,Mon,L 3-13,,3,15,3,25,6,40
10409,BAL,2007,2007-11-25,4:15,1:15,@,SDG,12,11,Sun,L 14-32,,3,30,6,60,9,90
10410,BAL,2008,2008-11-30,1:02,1:02,@,CIN,13,12,Sun,W 34-3,,3,30,3,15,6,45
10411,BAL,2008,2008-12-20,8:15,7:15,@,DAL,16,15,Sat,W 33-24,,3,19,10,86,13,105
10412,BAL,2010,2010-11-21,1:04,1:04,@,CAR,11,10,Sun,W 37-13,,3,20,7,54,10,74
10413,BAL,2010,2010-12-13,8:40,7:40,@,HOU,14,13,Mon,W 34-28,OT,3,15,8,51,11,66
10414,BAL,2011,2011-11-06,8:30,8:30,@,PIT,9,8,Sun,W 23-20,,3,20,6,69,9,89
10415,BAL,2011,2011-11-24,8:29,8:29,,SFO,12,11,Thu,W 16-6,,3,20,7,97,10,117
10416,BAL,2011,2011-12-18,8:30,5:30,@,SDG,15,14,Sun,L 14-34,,3,25,3,35,6,60
10417,BAL,2013,2013-09-15,1:02,1:02,,CLE,2,2,Sun,W 14-6,,3,41,5,33,8,74
10418,BAL,2014,2014-09-07,1:02,1:02,,CIN,1,1,Sun,L 16-23,,3,29,4,45,7,74
10419,BAL,2015,2015-09-13,4:25,2:25,@,DEN,1,1,Sun,L 13-19,,3,15,8,45,11,60
10420,BAL,2015,2015-10-18,4:25,1:25,@,SFO,6,6,Sun,L 20-25,,3,15,4,25,7,40
10421,BAL,2017,2017-10-22,1:00,3:00,@,MIN,7,7,Sun,L 16-24,,3,15,4,47,7,62
10422,BAL,2017,2017-11-19,1:00,12:00,@,GNB,11,10,Sun,W 23-0,,3,30,5,53,8,83
10423,BAL,2019,2019-09-29,1:00,1:00,,CLE,4,4,Sun,L 25-40,,3,15,6,41,9,56
10424,BAL,2019,2019-12-01,1:00,1:00,,SFO,13,12,Sun,W 20-17,,3,23,6,54,9,77
10425,BAL,2020,2020-09-20,4:25,3:25,@,HOU,2,2,Sun,W 33-16,,3,21,4,22,7,43
10426,SDG,2000,2000-10-01,1:02,12:02,@,STL,5,5,Sun,L 31-57,,3,15,4,36,7,51
10427,SDG,2001,2001-09-23,1:12,12:12,@,DAL,2,2,Sun,W 32-21,,3,57,3,27,6,84
10428,SDG,2001,2001-11-11,4:05,2:05,@,DEN,9,9,Sun,L 16-26,,3,16,4,20,7,36
10429,SDG,2006,2006-09-11,10:25,7:25,@,OAK,1,1,Mon,W 27-0,,3,25,7,54,10,79
10430,SDG,2006,2006-10-29,4:05,1:05,,STL,8,7,Sun,W 38-24,,3,43,4,20,7,63
10431,SDG,2006,2006-12-03,1:02,1:02,@,BUF,13,12,Sun,W 24-21,,3,30,2,10,5,40
10432,SDG,2007,2007-09-09,4:15,1:15,,CHI,1,1,Sun,W 14-3,,3,20,4,38,7,58
10433,SDG,2007,2007-10-28,4:05,1:05,,HOU,8,7,Sun,W 35-10,,3,46,5,31,8,77
10434,SDG,2008,2008-09-28,4:05,1:05,@,OAK,4,4,Sun,W 28-18,,3,15,8,64,11,79
10435,SDG,2008,2008-10-12,8:20,5:20,,NWE,6,6,Sun,W 30-10,,3,20,6,73,9,93
10436,SDG,2009,2009-09-27,4:15,1:15,,MIA,3,3,Sun,W 23-13,,3,20,7,39,10,59
10437,SDG,2009,2009-10-04,8:30,8:30,@,PIT,4,4,Sun,L 28-38,,3,20,6,59,9,79
10438,SDG,2009,2009-11-08,4:15,4:15,@,NYG,9,8,Sun,W 21-20,,3,20,9,104,12,124
10439,SDG,2009,2009-11-15,4:15,1:15,,PHI,10,9,Sun,W 31-23,,3,31,9,70,12,101
10440,SDG,2010,2010-12-05,4:05,1:05,,OAK,13,12,Sun,L 13-28,,3,19,13,105,16,124
10441,SDG,2010,2011-01-02,4:15,2:15,@,DEN,17,16,Sun,W 33-28,,3,32,5,45,8,77
10442,SDG,2011,2011-11-20,4:16,3:16,@,CHI,11,10,Sun,L 20-31,,3,20,6,61,9,81
10443,SDG,2011,2011-12-18,8:30,5:30,,BAL,15,14,Sun,W 34-14,,3,35,3,25,6,60
10444,SDG,2012,2012-10-28,1:06,1:06,@,CLE,8,7,Sun,L 6-7,,3,15,4,35,7,50
10445,SDG,2013,2013-12-22,4:25,1:25,,OAK,16,15,Sun,W 26-13,,3,24,12,73,15,97
10446,SDG,2016,2016-09-18,4:25,1:25,,JAX,2,2,Sun,W 38-14,,3,23,14,93,17,116
10447,SDG,2016,2016-10-13,8:25,5:25,,DEN,6,6,Thu,W 21-13,,3,20,12,103,15,123
10448,SDG,2016,2016-10-23,4:05,4:05,@,ATL,7,7,Sun,W 33-30,OT,3,14,9,70,12,84
10449,LAC,2019,2019-09-08,4:05,1:05,,IND,1,1,Sun,W 30-24,OT,3,20,3,10,6,30
10450,LAC,2020,2020-10-25,4:25,1:25,,JAX,7,6,Sun,W 39-29,,3,35,6,55,9,90
10451,LAC,2020,2020-12-17,8:20,5:20,@,LVR,15,14,Thu,W 30-27,OT,3,20,6,69,9,89
10452,LAC,2021,2022-01-02,4:05,1:05,,DEN,17,16,Sun,W 34-13,,3,22,3,23,6,45
10453,SEA,2001,2001-11-11,8:36,5:36,,OAK,9,8,Sun,W 34-27,,3,20,5,25,8,45
10454,SEA,2001,2001-12-02,4:05,1:05,,SDG,12,11,Sun,W 13-10,OT,3,24,7,46,10,70
10455,SEA,2003,2003-09-07,4:18,1:18,,NOR,1,1,Sun,W 27-10,,3,20,11,114,14,134
10456,SEA,2003,2003-12-21,4:15,1:15,,ARI,16,15,Sun,W 28-10,,3,30,6,30,9,60
10457,SEA,2004,2004-09-26,4:16,1:16,,SFO,3,3,Sun,W 34-0,,3,19,6,50,9,69
10458,SEA,2005,2005-09-25,4:06,1:06,,ARI,3,3,Sun,W 37-12,,3,25,12,71,15,96
10459,SEA,2005,2005-11-13,4:16,1:16,,STL,10,9,Sun,W 31-16,,3,69,8,49,11,118
10460,SEA,2006,2006-11-12,4:17,1:17,,STL,10,9,Sun,W 24-22,,3,16,7,58,10,74
10461,SEA,2006,2006-11-27,8:41,5:41,,GNB,12,11,Mon,W 34-24,,3,25,10,61,13,86
10462,SEA,2006,2006-12-14,8:13,5:13,,SFO,15,14,Thu,L 14-24,,3,20,10,87,13,107
10463,SEA,2006,2006-12-31,1:03,1:03,@,TAM,17,16,Sun,W 23-7,,3,20,8,51,11,71
10464,SEA,2007,2007-09-09,4:15,1:15,,TAM,1,1,Sun,W 20-6,,3,35,5,37,8,72
10465,SEA,2007,2007-09-23,4:05,1:05,,CIN,3,3,Sun,W 24-21,,3,20,10,72,13,92
10466,SEA,2007,2007-09-30,4:05,1:05,@,SFO,4,4,Sun,W 23-3,,3,15,9,65,12,80
10467,SEA,2007,2007-10-14,8:23,5:23,,NOR,6,6,Sun,L 17-28,,3,11,5,37,8,48
10468,SEA,2007,2007-12-16,1:02,1:02,@,CAR,15,14,Sun,L 10-13,,3,15,5,54,8,69
10469,SEA,2008,2008-10-26,4:15,1:15,@,SFO,8,7,Sun,W 34-13,,3,15,7,65,10,80
10470,SEA,2010,2010-11-28,4:06,1:06,,KAN,12,11,Sun,L 24-42,,3,26,5,50,8,76
10471,SEA,2012,2012-10-18,8:29,5:29,@,SFO,7,7,Thu,L 6-13,,3,20,5,40,8,60
10472,SEA,2016,2016-10-16,4:26,1:26,,ATL,6,5,Sun,W 26-24,,3,30,8,66,11,96
10473,SEA,2018,2018-12-23,8:20,5:20,,KAN,16,15,Sun,W 38-31,,3,20,8,76,11,96
10474,SEA,2020,2020-10-11,8:20,5:20,,MIN,5,5,Sun,W 27-26,,3,25,6,55,9,80
10475,SEA,2021,2021-10-07,8:20,5:20,,LAR,5,5,Thu,L 17-26,,3,20,5,85,8,105
10476,SFO,2001,2001-09-23,4:29,1:29,,STL,2,2,Sun,L 26-30,,3,25,8,92,11,117
10477,SFO,2001,2001-12-22,5:15,2:15,,PHI,15,14,Sat,W 13-3,,3,15,11,109,14,124
10478,SFO,2002,2002-10-27,4:05,1:05,,ARI,8,7,Sun,W 38-28,,3,25,7,65,10,90
10479,SFO,2002,2002-11-03,4:15,1:15,@,OAK,9,8,Sun,W 23-20,OT,3,40,6,44,9,84
10480,SFO,2002,2002-11-10,4:15,1:15,,KAN,10,9,Sun,W 17-13,,3,15,4,37,7,52
10481,SFO,2002,2002-12-15,4:15,1:15,,GNB,15,14,Sun,L 14-20,,3,18,4,20,7,38
10482,SFO,2004,2004-11-07,4:05,1:05,,SEA,9,8,Sun,L 27-42,,3,29,7,55,10,84
10483,SFO,2006,2006-10-08,4:05,1:05,,OAK,5,5,Sun,W 34-20,,3,20,5,35,8,55
10484,SFO,2006,2006-12-24,4:05,1:05,,ARI,16,15,Sun,L 20-26,,3,35,5,45,8,80
10485,SFO,2007,2007-09-16,1:02,12:02,@,STL,2,2,Sun,W 17-16,,3,21,4,34,7,55
10486,SFO,2007,2007-11-25,4:06,2:06,@,ARI,12,11,Sun,W 37-31,OT,3,42,10,70,13,112
10487,SFO,2007,2007-12-15,8:15,5:15,,CIN,15,14,Sat,W 20-13,,3,15,1,15,4,30
10488,SFO,2008,2008-09-07,4:16,1:16,,ARI,1,1,Sun,L 13-23,,3,20,4,40,7,60
10489,SFO,2008,2008-09-21,4:06,1:06,,DET,3,3,Sun,W 31-13,,3,30,9,61,12,91
10490,SFO,2008,2008-12-07,4:05,1:05,,NYJ,14,13,Sun,W 24-14,,3,25,8,57,11,82
10491,SFO,2008,2008-12-28,4:15,1:15,,WAS,17,16,Sun,W 27-24,,3,15,2,10,5,25
10492,SFO,2009,2009-10-04,4:15,1:15,,STL,4,4,Sun,W 35-0,,3,33,10,73,13,106
10493,SFO,2010,2010-11-21,4:05,1:05,,TAM,11,10,Sun,L 0-21,,3,18,3,35,6,53
10494,SFO,2011,2011-10-09,4:05,1:05,,TAM,5,5,Sun,W 48-3,,3,30,9,96,12,126
10495,SFO,2012,2012-12-30,4:25,1:25,,ARI,17,16,Sun,W 27-13,,3,25,5,34,8,59
10496,SFO,2013,2013-10-06,8:31,5:31,,HOU,5,5,Sun,W 34-3,,3,17,7,52,10,69
10497,SFO,2014,2014-11-27,8:31,5:31,,SEA,13,12,Thu,L 3-19,,3,20,14,105,17,125
10498,SFO,2016,2016-12-11,4:05,1:05,,NYJ,14,13,Sun,L 17-23,OT,3,25,9,56,12,81
10499,SFO,2018,2018-09-09,1:00,3:00,@,MIN,1,1,Sun,L 16-24,,3,21,7,52,10,73
10500,SFO,2018,2018-11-01,8:20,5:20,,OAK,9,9,Thu,W 34-3,,3,23,6,40,9,63
10501,SFO,2019,2019-12-21,8:15,5:15,,LAR,16,15,Sat,W 34-31,,3,26,7,43,10,69
10502,SFO,2021,2021-11-07,4:25,1:25,,ARI,9,8,Sun,L 17-31,,3,35,9,84,12,119
10503,TAM,2000,2000-09-10,1:01,1:01,,CHI,2,2,Sun,W 41-0,,3,20,9,64,12,84
10504,TAM,2001,2001-09-30,1:00,12:00,@,MIN,3,2,Sun,L 16-20,,3,25,6,36,9,61
10505,TAM,2001,2001-11-18,4:15,4:15,,CHI,10,9,Sun,L 24-27,,3,39,7,75,10,114
10506,TAM,2001,2001-12-29,9:07,9:07,,BAL,16,15,Sat,W 22-10,,3,25,8,65,11,90
10507,TAM,2003,2003-10-26,1:01,1:01,,DAL,8,7,Sun,W 16-0,,3,15,1,5,4,20
10508,TAM,2003,2003-12-14,1:01,1:01,,HOU,15,14,Sun,W 16-3,,3,25,9,62,12,87
10509,TAM,2004,2004-10-18,9:09,8:09,@,STL,6,6,Mon,L 21-28,,3,12,7,50,10,62
10510,TAM,2004,2004-12-05,1:02,1:02,,ATL,13,12,Sun,W 27-0,,3,32,7,50,10,82
10511,TAM,2006,2006-09-10,1:01,1:01,,BAL,1,1,Sun,L 0-27,,3,21,4,25,7,46
10512,TAM,2006,2006-10-29,1:04,1:04,@,NYG,8,7,Sun,L 3-17,,3,30,4,40,7,70
10513,TAM,2007,2007-10-07,4:05,4:05,@,IND,5,5,Sun,L 14-33,,3,21,2,15,5,36
10514,TAM,2008,2008-11-23,1:03,1:03,@,DET,12,11,Sun,W 38-20,,3,25,10,70,13,95
10515,TAM,2009,2009-11-22,1:00,1:00,,NOR,11,10,Sun,L 7-38,,3,18,4,55,7,73
10516,TAM,2010,2010-10-10,1:03,1:03,@,CIN,5,4,Sun,W 24-21,,3,25,9,60,12,85
10517,TAM,2010,2010-11-21,4:05,1:05,@,SFO,11,10,Sun,W 21-0,,3,35,3,18,6,53
10518,TAM,2010,2010-12-26,4:16,4:16,,SEA,16,15,Sun,W 38-15,,3,22,1,10,4,32
10519,TAM,2013,2013-10-24,8:29,8:29,,CAR,8,7,Thu,L 13-31,,3,21,6,59,9,80
10520,TAM,2013,2013-12-22,1:00,12:00,@,STL,16,15,Sun,L 13-23,,3,26,7,85,10,111
10521,TAM,2014,2014-09-07,4:25,4:25,,CAR,1,1,Sun,L 14-20,,3,15,6,55,9,70
10522,TAM,2014,2014-12-21,1:03,1:03,,GNB,16,15,Sun,L 3-20,,3,30,5,40,8,70
10523,TAM,2016,2016-12-18,8:30,7:30,@,DAL,15,14,Sun,L 20-26,,3,35,8,91,11,126
10524,TAM,2018,2018-12-30,1:00,1:00,,ATL,17,16,Sun,L 32-34,,3,30,9,85,12,115
10525,TAM,2020,2020-11-02,8:15,8:15,@,NYG,8,8,Mon,W 25-23,,3,20,7,73,10,93
10526,TAM,2020,2020-11-15,1:00,1:00,@,CAR,10,10,Sun,W 46-23,,3,30,5,40,8,70
10527,TAM,2020,2021-01-03,1:00,1:00,,ATL,17,16,Sun,W 44-27,,3,23,4,48,7,71
10528,TAM,2021,2021-12-05,1:00,1:00,@,ATL,13,12,Sun,W 30-17,,3,15,6,39,9,54
10529,TAM,2021,2021-12-19,8:20,8:20,,NOR,15,14,Sun,L 0-9,,3,30,6,41,9,71
10530,WAS,2001,2002-01-06,1:01,1:01,,ARI,17,16,Sun,W 20-17,,3,20,1,5,4,25
10531,WAS,2004,2004-09-12,1:06,1:06,,TAM,1,1,Sun,W 16-10,,3,23,6,44,9,67
10532,WAS,2004,2005-01-02,1:04,1:04,,MIN,17,16,Sun,W 21-18,,3,13,7,49,10,62
10533,WAS,2006,2006-11-19,1:03,1:03,@,TAM,11,10,Sun,L 17-20,,3,19,4,35,7,54
10534,WAS,2006,2006-12-03,1:03,1:03,,ATL,13,12,Sun,L 14-24,,3,30,6,60,9,90
10535,WAS,2006,2006-12-17,1:04,12:04,@,NOR,15,14,Sun,W 16-10,,3,15,4,16,7,31
10536,WAS,2007,2007-11-18,4:15,3:15,@,DAL,11,10,Sun,L 23-28,,3,71,7,58,10,129
10537,WAS,2008,2008-10-05,1:04,1:04,@,PHI,5,5,Sun,W 23-17,,3,24,4,33,7,57
10538,WAS,2008,2008-12-21,4:16,4:16,,PHI,16,15,Sun,W 10-3,,3,25,3,20,6,45
10539,WAS,2009,2010-01-03,4:15,1:15,@,SDG,17,16,Sun,L 20-23,,3,14,2,17,5,31
10540,WAS,2010,2010-11-21,1:03,12:03,@,TEN,11,10,Sun,W 19-16,OT,3,20,11,81,14,101
10541,WAS,2010,2010-12-19,1:03,12:03,@,DAL,15,14,Sun,L 30-33,,3,25,9,70,12,95
10542,WAS,2011,2011-09-11,4:23,4:23,,NYG,1,1,Sun,W 28-14,,3,25,8,63,11,88
10543,WAS,2011,2011-09-18,1:03,1:03,,ARI,2,2,Sun,W 22-21,,3,15,10,97,13,112
10544,WAS,2011,2011-10-23,1:05,1:05,@,CAR,7,6,Sun,L 20-33,,3,26,13,105,16,131
10545,WAS,2011,2011-11-06,1:03,1:03,,SFO,9,8,Sun,L 11-19,,3,35,9,55,12,90
10546,WAS,2012,2012-12-23,1:03,1:03,@,PHI,16,15,Sun,W 27-20,,3,24,4,25,7,49
10547,WAS,2013,2013-09-29,4:25,1:25,@,OAK,4,4,Sun,W 24-14,,3,29,4,25,7,54
10548,WAS,2013,2013-12-29,1:04,1:04,@,NYG,17,16,Sun,L 6-20,,3,30,3,20,6,50
10549,WAS,2014,2014-10-06,8:30,8:30,,SEA,5,5,Mon,L 17-27,,3,30,13,90,16,120
10550,WAS,2014,2014-12-20,4:30,4:30,,PHI,16,15,Sat,W 27-24,,3,15,13,102,16,117
10551,WAS,2015,2015-10-18,1:02,1:02,@,NYJ,6,6,Sun,L 20-34,,3,15,1,5,4,20
10552,WAS,2015,2016-01-03,1:03,12:03,@,DAL,17,16,Sun,W 34-23,,3,20,4,44,7,64
10553,WAS,2016,2016-11-24,4:30,3:30,@,DAL,12,11,Thu,L 26-31,,3,30,3,25,6,55
10554,WAS,2019,2019-11-03,1:00,1:00,@,BUF,9,9,Sun,L 9-24,,3,15,2,20,5,35
10555,WAS,2019,2019-12-08,1:00,12:00,@,GNB,14,13,Sun,L 15-20,,3,25,5,34,8,59
10556,WAS,2020,2020-10-11,1:00,1:00,,LAR,5,5,Sun,L 10-30,,3,40,5,60,8,100
10557,WAS,2021,2021-11-14,1:00,1:00,,TAM,10,9,Sun,W 29-19,,3,33,6,43,9,76
10558,WAS,2021,2022-01-09,1:00,1:00,@,NYG,18,17,Sun,W 22-7,,3,29,3,21,6,50
10559,ATL,2000,2000-10-01,8:36,8:36,@,PHI,5,5,Sun,L 10-38,,2,10,9,110,11,120
10560,ATL,2000,2000-10-08,4:05,4:05,,NYG,6,6,Sun,L 6-13,,2,13,8,71,10,84
10561,ATL,2001,2001-11-11,1:05,1:05,,DAL,9,8,Sun,W 20-13,,2,10,4,41,6,51
10562,ATL,2006,2006-09-10,1:03,1:03,@,CAR,1,1,Sun,W 20-6,,2,20,8,45,10,65
10563,ATL,2006,2006-12-10,1:02,1:02,@,TAM,14,13,Sun,W 17-6,,2,10,2,10,4,20
10564,ATL,2007,2007-09-30,1:02,1:02,,HOU,4,4,Sun,W 26-16,,2,20,7,78,9,98
10565,ATL,2008,2008-10-05,1:02,12:02,@,GNB,5,5,Sun,W 27-24,,2,15,9,97,11,112
10566,ATL,2008,2008-11-09,1:03,1:03,,NOR,10,9,Sun,W 34-20,,2,25,7,45,9,70
10567,ATL,2008,2008-11-30,4:05,1:05,@,SDG,13,12,Sun,W 22-16,,2,20,9,84,11,104
10568,ATL,2010,2010-10-17,1:02,1:02,@,PHI,6,6,Sun,L 17-31,,2,30,9,78,11,108
10569,ATL,2012,2012-09-09,1:03,12:03,@,KAN,1,1,Sun,W 40-24,,2,12,2,25,4,37
10570,ATL,2012,2012-09-23,4:05,1:05,@,SDG,3,3,Sun,W 27-3,,2,15,4,17,6,32
10571,ATL,2012,2012-09-30,1:03,1:03,,CAR,4,4,Sun,W 30-28,,2,15,9,64,11,79
10572,ATL,2012,2012-10-07,1:04,1:04,@,WAS,5,5,Sun,W 24-17,,2,13,4,20,6,33
10573,ATL,2012,2012-10-14,1:01,1:01,,OAK,6,6,Sun,W 23-20,,2,25,12,110,14,135
10574,ATL,2012,2012-11-04,8:31,8:31,,DAL,9,8,Sun,W 19-13,,2,15,7,50,9,65
10575,ATL,2012,2012-11-25,1:02,1:02,@,TAM,12,11,Sun,W 24-23,,2,15,5,24,7,39
10576,ATL,2012,2012-12-30,1:02,1:02,,TAM,17,16,Sun,L 17-22,,2,15,2,15,4,30
10577,ATL,2013,2013-09-08,1:03,12:03,@,NOR,1,1,Sun,L 17-23,,2,19,6,57,8,76
10578,ATL,2018,2018-09-16,1:00,1:00,,CAR,2,2,Sun,W 31-24,,2,26,7,49,9,75
10579,ATL,2018,2018-11-18,1:00,1:00,,DAL,11,10,Sun,L 19-22,,2,15,2,20,4,35
10580,ATL,2018,2018-11-22,8:20,7:20,@,NOR,12,11,Thu,L 17-31,,2,26,3,19,5,45
10581,ATL,2021,2021-12-26,1:00,1:00,,DET,16,15,Sun,W 20-16,,2,15,6,30,8,45
10582,BUF,2000,2000-12-23,8:36,5:36,@,SEA,17,16,Sat,W 42-23,,2,10,4,45,6,55
10583,BUF,2002,2002-12-22,1:02,12:02,@,GNB,16,15,Sun,L 0-10,,2,10,3,25,5,35
10584,BUF,2004,2004-11-14,8:36,8:36,@,NWE,10,9,Sun,L 6-29,,2,48,5,44,7,92
10585,BUF,2006,2006-10-15,1:03,1:03,@,DET,6,6,Sun,L 17-20,,2,20,6,40,8,60
10586,BUF,2006,2006-12-03,1:02,1:02,,SDG,13,12,Sun,L 21-24,,2,10,3,30,5,40
10587,BUF,2006,2006-12-10,4:15,4:15,@,NYJ,14,13,Sun,W 31-13,,2,10,3,15,5,25
10588,BUF,2007,2007-11-11,1:02,1:02,@,MIA,10,9,Sun,W 13-10,,2,10,7,39,9,49
10589,BUF,2007,2007-12-16,1:03,1:03,@,CLE,15,14,Sun,L 0-8,,2,15,2,15,4,30
10590,BUF,2011,2011-12-04,1:02,1:02,,TEN,13,12,Sun,L 17-23,,2,15,3,20,5,35
10591,BUF,2012,2012-12-09,1:02,1:02,,STL,14,13,Sun,L 12-15,,2,15,2,17,4,32
10592,BUF,2017,2017-12-10,1:00,1:00,,IND,14,13,Sun,W 13-7,OT,2,10,2,20,4,30
10593,BUF,2019,2019-11-03,1:00,1:00,,WAS,9,8,Sun,W 24-9,,2,20,3,15,5,35
10594,CAR,2000,2000-11-27,9:12,9:12,,GNB,13,12,Mon,W 31-14,,2,25,6,55,8,80
10595,CAR,2002,2002-11-17,4:05,4:05,@,TAM,11,10,Sun,L 10-23,,2,10,5,34,7,44
10596,CAR,2006,2006-12-31,1:03,12:03,@,NOR,17,16,Sun,W 31-21,,2,19,4,38,6,57
10597,CAR,2008,2008-11-30,1:02,12:02,@,GNB,13,12,Sun,W 35-31,,2,12,8,49,10,61
10598,CAR,2008,2008-12-21,8:23,8:23,@,NYG,16,15,Sun,L 28-34,OT,2,14,2,10,4,24
10599,CAR,2011,2011-12-04,1:02,1:02,@,TAM,13,12,Sun,W 38-19,,2,20,9,73,11,93
10600,CAR,2013,2013-11-03,1:03,1:03,,ATL,9,8,Sun,W 34-10,,2,15,7,59,9,74
10601,CAR,2018,2018-11-18,1:00,1:00,@,DET,11,10,Sun,L 19-20,,2,15,1,5,3,20
10602,CAR,2018,2018-12-30,1:00,12:00,@,NOR,17,16,Sun,W 33-14,,2,10,6,94,8,104
10603,CAR,2019,2019-12-15,1:00,1:00,,SEA,15,14,Sun,L 24-30,,2,15,5,40,7,55
10604,CHI,2000,2000-09-17,3:16,3:16,,NYG,3,3,Sun,L 7-14,,2,30,2,15,4,45
10605,CHI,2001,2001-10-21,1:02,1:02,@,CIN,6,5,Sun,W 24-0,,2,25,2,20,4,45
10606,CHI,2001,2001-11-25,8:35,7:35,@,MIN,11,10,Sun,W 13-6,,2,15,11,75,13,90
10607,CHI,2001,2001-12-09,1:02,12:02,@,GNB,13,12,Sun,L 7-17,,2,15,4,39,6,54
10608,CHI,2001,2001-12-16,1:02,12:02,,TAM,14,13,Sun,W 27-3,,2,15,5,36,7,51
10609,CHI,2004,2004-09-19,1:02,12:02,@,GNB,2,2,Sun,W 21-10,,2,15,6,50,8,65
10610,CHI,2008,2008-12-28,1:03,12:03,@,HOU,17,16,Sun,L 24-31,,2,10,7,70,9,80
10611,CHI,2010,2010-09-19,1:05,12:05,@,DAL,2,2,Sun,W 27-20,,2,10,6,50,8,60
10612,CHI,2010,2010-10-17,1:02,12:02,,SEA,6,6,Sun,L 20-23,,2,18,5,83,7,101
10613,CHI,2012,2012-12-23,4:25,2:25,@,ARI,16,15,Sun,W 28-13,,2,12,4,25,6,37
10614,CHI,2013,2013-12-09,8:40,7:40,,DAL,14,13,Mon,W 45-28,,2,15,4,50,6,65
10615,CHI,2013,2013-12-22,8:30,8:30,@,PHI,16,15,Sun,L 11-54,,2,10,2,15,4,25
10616,CHI,2014,2014-10-19,1:00,12:00,,MIA,7,7,Sun,L 14-27,,2,15,7,84,9,99
10617,CHI,2016,2016-10-31,8:31,7:31,,MIN,8,8,Mon,W 20-10,,2,20,1,10,3,30
10618,CHI,2018,2018-10-28,1:00,12:00,,NYJ,8,7,Sun,W 24-10,,2,25,8,45,10,70
10619,CHI,2019,2019-11-17,8:20,5:20,@,LAR,11,10,Sun,L 7-17,,2,25,6,34,8,59
10620,CHI,2021,2022-01-09,1:00,11:00,@,MIN,18,17,Sun,L 17-31,,2,10,4,47,6,57
10621,CIN,2000,2000-10-08,1:00,1:00,,TEN,6,5,Sun,L 14-23,,2,10,6,50,8,60
10622,CIN,2001,2001-10-21,1:02,1:02,,CHI,6,6,Sun,L 0-24,,2,20,2,25,4,45
10623,CIN,2006,2006-11-19,1:02,12:02,@,NOR,11,10,Sun,W 31-16,,2,10,4,25,6,35
10624,CIN,2006,2006-12-18,8:40,8:40,@,IND,15,14,Mon,L 16-34,,2,10,5,35,7,45
10625,CIN,2007,2007-10-28,1:02,1:02,,PIT,8,7,Sun,L 13-24,,2,10,3,20,5,30
10626,CIN,2008,2008-11-20,8:15,8:15,@,PIT,12,11,Thu,L 10-27,,2,15,4,40,6,55
10627,CIN,2008,2008-12-21,1:03,1:03,@,CLE,16,15,Sun,W 14-0,,2,20,9,65,11,85
10628,CIN,2010,2010-09-12,1:02,1:02,@,NWE,1,1,Sun,L 24-38,,2,5,6,30,8,35
10629,CIN,2010,2010-11-25,8:30,8:30,@,NYJ,12,11,Thu,L 10-26,,2,25,8,64,10,89
10630,CIN,2012,2012-10-21,8:30,8:30,,PIT,7,7,Sun,L 17-24,,2,20,5,50,7,70
10631,CIN,2015,2015-11-05,8:25,8:25,,CLE,9,8,Thu,W 31-10,,2,20,4,28,6,48
10632,CIN,2016,2016-11-27,1:00,1:00,@,BAL,12,11,Sun,L 14-19,,2,15,8,69,10,84
10633,CIN,2016,2017-01-01,1:00,1:00,,BAL,17,16,Sun,W 27-10,,2,20,4,41,6,61
10634,CIN,2019,2019-12-01,1:00,1:00,,NYJ,13,12,Sun,W 22-6,,2,15,10,106,12,121
10635,CIN,2020,2020-12-21,8:15,8:15,,PIT,15,14,Mon,W 27-17,,2,16,4,30,6,46
10636,CIN,2021,2021-10-10,1:00,1:00,,GNB,5,5,Sun,L 22-25,OT,2,21,2,10,4,31
10637,CIN,2021,2021-12-12,1:00,1:00,,SFO,14,13,Sun,L 23-26,OT,2,19,6,40,8,59
10638,CLE,2001,2001-11-25,1:03,1:03,,CIN,11,10,Sun,W 18-0,,2,25,5,26,7,51
10639,CLE,2001,2001-12-09,1:02,1:02,@,NWE,13,12,Sun,L 16-27,,2,21,5,31,7,52
10640,CLE,2002,2002-12-01,1:04,1:04,,CAR,13,12,Sun,L 6-13,,2,10,3,25,5,35
10641,CLE,2003,2003-10-05,8:35,8:35,@,PIT,5,5,Sun,W 33-13,,2,10,10,62,12,72
10642,CLE,2006,2006-09-17,1:03,1:03,@,CIN,2,2,Sun,L 17-34,,2,27,9,49,11,76
10643,CLE,2006,2006-09-24,4:06,4:06,,BAL,3,3,Sun,L 14-15,,2,17,5,30,7,47
10644,CLE,2006,2006-10-22,4:06,4:06,,DEN,7,6,Sun,L 7-17,,2,10,3,30,5,40
10645,CLE,2007,2007-12-16,1:03,1:03,,BUF,15,14,Sun,W 8-0,,2,15,2,15,4,30
10646,CLE,2008,2008-11-17,8:40,8:40,@,BUF,11,10,Mon,W 29-27,,2,15,3,30,5,45
10647,CLE,2010,2010-12-12,1:02,1:02,@,BUF,14,13,Sun,L 6-13,,2,10,6,44,8,54
10648,CLE,2010,2010-12-26,1:02,1:02,,BAL,16,15,Sun,L 10-20,,2,20,1,5,3,25
10649,CLE,2012,2012-12-02,4:25,1:25,@,OAK,13,12,Sun,W 20-17,,2,25,9,65,11,90
10650,CLE,2013,2013-11-24,1:03,1:03,,PIT,12,11,Sun,L 11-27,,2,10,2,8,4,18
10651,CLE,2015,2015-11-30,8:30,8:30,,BAL,12,11,Mon,L 27-33,,2,15,7,50,9,65
10652,CLE,2016,2016-10-30,1:02,1:02,,NYJ,8,8,Sun,L 28-31,,2,10,5,37,7,47
10653,CLE,2020,2020-10-11,4:25,4:25,,IND,5,5,Sun,W 32-23,,2,10,5,34,7,44
10654,IND,2000,2000-12-03,4:15,4:15,@,NYJ,14,13,Sun,L 17-27,,2,20,4,54,6,74
10655,IND,2001,2001-09-09,1:03,1:03,@,NYJ,1,1,Sun,W 45-24,,2,10,3,30,5,40
10656,IND,2001,2001-12-10,9:08,9:08,@,MIA,13,12,Mon,L 6-41,,2,25,4,40,6,65
10657,IND,2001,2001-12-23,8:30,8:30,,NYJ,15,14,Sun,L 28-29,,2,10,2,15,4,25
10658,IND,2002,2002-09-08,1:04,1:04,@,JAX,1,1,Sun,W 28-25,,2,14,5,40,7,54
10659,IND,2003,2003-09-28,8:37,7:37,@,NOR,4,4,Sun,W 55-21,,2,20,5,50,7,70
10660,IND,2004,2004-09-19,1:02,12:02,@,TEN,2,2,Sun,W 31-17,,2,21,8,71,10,92
10661,IND,2004,2004-10-10,1:00,12:00,,OAK,5,5,Sun,W 35-14,,2,20,9,59,11,79
10662,IND,2006,2006-12-24,1:03,12:03,@,HOU,16,15,Sun,L 24-27,,2,15,4,25,6,40
10663,IND,2007,2007-09-30,4:15,4:15,,DEN,4,4,Sun,W 38-20,,2,10,4,32,6,42
10664,IND,2007,2007-10-07,4:05,4:05,,TAM,5,5,Sun,W 33-14,,2,15,3,21,5,36
10665,IND,2007,2007-11-18,1:02,1:02,,KAN,11,10,Sun,W 13-10,,2,10,5,33,7,43
10666,IND,2007,2007-12-02,1:02,1:02,,JAX,13,12,Sun,W 28-25,,2,15,8,64,10,79
10667,IND,2008,2008-11-30,1:02,1:02,@,CLE,13,12,Sun,W 10-6,,2,10,4,25,6,35
10668,IND,2011,2011-10-16,1:02,1:02,@,CIN,6,6,Sun,L 17-27,,2,11,11,111,13,122
10669,IND,2011,2011-11-27,1:03,1:03,,CAR,12,11,Sun,L 19-27,,2,15,6,92,8,107
10670,IND,2013,2013-11-10,1:03,1:03,,STL,10,9,Sun,L 8-38,,2,20,8,46,10,66
10671,IND,2013,2013-12-29,1:02,1:02,,JAX,17,16,Sun,W 30-10,,2,10,5,50,7,60
10672,IND,2015,2015-11-02,8:30,8:30,@,CAR,8,8,Mon,L 26-29,OT,2,15,6,55,8,70
10673,IND,2016,2016-11-24,8:30,8:30,,PIT,12,11,Thu,L 7-28,,2,10,7,67,9,77
10674,IND,2017,2017-12-10,1:00,1:00,@,BUF,14,13,Sun,L 7-13,OT,2,20,2,10,4,30
10675,IND,2017,2017-12-23,4:30,4:30,@,BAL,16,15,Sat,L 16-23,,2,19,5,25,7,44
10676,IND,2021,2021-09-12,1:00,1:00,,SEA,1,1,Sun,L 16-28,,2,16,7,53,9,69
10677,IND,2021,2021-10-17,1:00,1:00,,HOU,6,6,Sun,W 31-3,,2,10,4,25,6,35
10678,IND,2021,2021-11-04,8:20,8:20,,NYJ,9,9,Thu,W 45-30,,2,22,7,43,9,65
10679,IND,2021,2021-12-18,8:20,8:20,,NWE,15,14,Sat,W 27-17,,2,13,8,50,10,63
10680,ARI,2000,2000-09-10,8:35,5:35,,DAL,2,2,Sun,W 32-31,,2,15,5,102,7,117
10681,ARI,2002,2002-09-22,4:05,1:05,,SDG,3,3,Sun,L 15-23,,2,25,8,80,10,105
10682,ARI,2002,2002-10-20,4:15,1:15,,DAL,7,6,Sun,W 9-6,OT,2,15,6,59,8,74
10683,ARI,2009,2009-11-08,1:03,12:03,@,CHI,9,8,Sun,W 41-21,,2,15,9,89,11,104
10684,ARI,2011,2011-09-25,4:15,1:15,@,SEA,3,3,Sun,L 10-13,,2,20,8,39,10,59
10685,ARI,2011,2011-12-18,4:15,2:15,,CLE,15,14,Sun,W 20-17,OT,2,13,9,74,11,87
10686,ARI,2016,2016-11-13,4:25,2:25,,SFO,10,9,Sun,W 23-20,,2,10,9,100,11,110
10687,ARI,2017,2017-11-05,4:05,1:05,@,SFO,9,8,Sun,W 20-10,,2,25,8,53,10,78
10688,ARI,2019,2019-12-01,4:05,2:05,,LAR,13,12,Sun,L 7-34,,2,7,8,81,10,88
10689,DAL,2002,2002-09-15,1:02,12:02,,TEN,2,2,Sun,W 21-13,,2,15,6,55,8,70
10690,DAL,2003,2003-12-14,4:17,4:17,@,WAS,15,14,Sun,W 27-0,,2,10,4,35,6,45
10691,DAL,2006,2006-11-23,4:25,3:25,,TAM,12,11,Thu,W 38-10,,2,19,5,55,7,74
10692,DAL,2006,2006-12-25,5:07,4:07,,PHI,16,15,Mon,L 7-23,,2,10,6,45,8,55
10693,DAL,2007,2007-09-30,1:02,12:02,,STL,4,4,Sun,W 35-7,,2,10,7,50,9,60
10694,DAL,2007,2007-11-22,4:20,3:20,,NYJ,12,11,Thu,W 34-3,,2,10,4,30,6,40
10695,DAL,2011,2011-12-17,8:29,8:29,@,TAM,15,14,Sat,W 31-15,,2,15,6,46,8,61
10696,DAL,2012,2012-10-01,8:40,7:40,,CHI,4,4,Mon,L 18-34,,2,10,4,25,6,35
10697,DAL,2012,2012-10-28,4:25,3:25,,NYG,8,7,Sun,L 24-29,,2,10,5,45,7,55
10698,DAL,2013,2013-10-27,1:03,1:03,@,DET,8,8,Sun,L 30-31,,2,31,8,61,10,92
10699,DAL,2017,2017-11-19,8:30,7:30,,PHI,11,10,Sun,L 9-37,,2,10,3,30,5,40
10700,DAL,2018,2018-09-30,1:00,12:00,,DET,4,4,Sun,W 26-24,,2,20,8,58,10,78
10701,DAL,2018,2018-11-18,1:00,1:00,@,ATL,11,10,Sun,W 22-19,,2,20,2,15,4,35
10702,DAL,2019,2019-12-22,4:25,4:25,@,PHI,16,15,Sun,L 9-17,,2,20,4,30,6,50
10703,DEN,2000,2000-10-15,4:06,2:06,,CLE,7,7,Sun,W 44-10,,2,14,9,116,11,130
10704,DEN,2000,2000-12-10,4:05,2:05,,SEA,15,14,Sun,W 31-24,,2,15,4,38,6,53
10705,DEN,2001,2001-12-30,4:15,2:15,,OAK,16,15,Sun,W 23-17,,2,11,8,62,10,73
10706,DEN,2001,2002-01-06,1:00,1:00,@,IND,17,16,Sun,L 10-29,,2,15,3,20,5,35
10707,DEN,2002,2002-10-27,4:15,4:15,@,NWE,8,8,Sun,W 24-16,,2,51,8,83,10,134
10708,DEN,2004,2004-12-25,8:35,7:35,@,TEN,16,15,Sat,W 37-16,,2,45,3,16,5,61
10709,DEN,2004,2005-01-02,4:15,2:15,,IND,17,16,Sun,W 33-14,,2,25,4,25,6,50
10710,DEN,2006,2006-12-10,4:15,1:15,@,SDG,14,13,Sun,L 20-48,,2,10,5,38,7,48
10711,DEN,2007,2007-10-21,8:23,6:23,,PIT,7,6,Sun,W 31-28,,2,20,3,23,5,43
10712,DEN,2013,2013-09-29,4:25,2:25,,PHI,4,4,Sun,W 52-20,,2,25,8,62,10,87
10713,DEN,2020,2020-10-18,1:00,1:00,@,NWE,6,5,Sun,W 18-12,,2,20,1,4,3,24
10714,DEN,2020,2020-11-29,4:05,2:05,,NOR,12,11,Sun,L 3-31,,2,10,5,35,7,45
10715,DEN,2020,2020-12-13,1:00,1:00,@,CAR,14,13,Sun,W 32-27,,2,18,7,48,9,66
10716,DEN,2021,2021-10-21,8:20,8:20,@,CLE,7,7,Thu,L 14-17,,2,15,9,60,11,75
10717,DEN,2021,2021-12-12,4:05,2:05,,DET,14,13,Sun,W 38-10,,2,18,6,53,8,71
10718,DET,2000,2000-12-24,1:02,1:02,,CHI,17,16,Sun,L 20-23,,2,20,5,28,7,48
10719,DET,2001,2001-12-23,1:01,1:01,@,PIT,15,14,Sun,L 14-47,,2,15,6,60,8,75
10720,DET,2004,2004-10-17,1:03,1:03,,GNB,6,5,Sun,L 10-38,,2,20,3,15,5,35
10721,DET,2007,2007-11-04,1:02,1:02,,DEN,9,8,Sun,W 44-7,,2,32,12,84,14,116
10722,DET,2012,2012-12-22,8:40,8:40,,ATL,16,15,Sat,L 18-31,,2,20,3,20,5,40
10723,DET,2016,2016-10-09,1:02,1:02,,PHI,5,5,Sun,W 24-23,,2,18,14,111,16,129
10724,DET,2016,2016-12-18,1:00,1:00,@,NYG,15,14,Sun,L 6-17,,2,15,5,46,7,61
10725,DET,2017,2017-11-06,8:30,7:30,@,GNB,9,8,Mon,W 30-17,,2,19,2,20,4,39
10726,DET,2019,2019-12-15,1:00,1:00,,TAM,15,14,Sun,L 17-38,,2,10,9,70,11,80
10727,DET,2021,2022-01-09,1:00,1:00,,GNB,18,17,Sun,W 37-30,,2,15,0,0,2,15
10728,GNB,2000,2000-09-10,1:01,1:01,@,BUF,2,2,Sun,L 18-27,,2,12,5,33,7,45
10729,GNB,2000,2000-12-10,1:02,12:02,,DET,15,14,Sun,W 26-13,,2,11,3,30,5,41
10730,GNB,2002,2002-12-01,1:02,12:02,,CHI,13,12,Sun,W 30-20,,2,33,5,39,7,72
10731,GNB,2006,2006-12-10,4:06,1:06,@,SFO,14,13,Sun,W 30-19,,2,10,4,25,6,35
10732,GNB,2007,2007-12-30,1:02,12:02,,DET,17,16,Sun,W 34-13,,2,25,7,55,9,80
10733,GNB,2010,2010-09-12,4:16,4:16,@,PHI,1,1,Sun,W 27-20,,2,15,10,80,12,95
10734,GNB,2010,2010-10-24,8:30,7:30,,MIN,7,7,Sun,W 28-24,,2,20,6,40,8,60
10735,GNB,2010,2010-11-07,8:30,7:30,,DAL,9,9,Sun,W 45-7,,2,20,5,40,7,60
10736,GNB,2010,2010-12-19,8:30,8:30,@,NWE,15,14,Sun,L 27-31,,2,15,7,52,9,67
10737,GNB,2013,2013-12-08,1:02,12:02,,ATL,14,13,Sun,W 22-21,,2,10,3,15,5,25
10738,GNB,2015,2015-11-01,8:30,6:30,@,DEN,8,7,Sun,L 10-29,,2,15,11,93,13,108
10739,GNB,2017,2017-11-06,8:30,7:30,,DET,9,8,Mon,L 17-30,,2,20,2,19,4,39
10740,GNB,2018,2018-10-28,4:25,1:25,@,LAR,8,7,Sun,L 27-29,,2,10,2,15,4,25
10741,GNB,2019,2019-12-23,8:15,10:15,@,MIN,16,15,Mon,W 23-10,,2,20,3,30,5,50
10742,GNB,2020,2020-09-27,8:20,7:20,@,NOR,3,3,Sun,W 37-30,,2,10,8,83,10,93
10743,GNB,2021,2021-10-10,1:00,1:00,@,CIN,5,5,Sun,W 25-22,OT,2,10,2,21,4,31
10744,HOU,2006,2006-10-01,1:02,12:02,,MIA,4,4,Sun,W 17-15,,2,15,5,35,7,50
10745,HOU,2007,2007-09-23,1:03,12:03,,IND,3,3,Sun,L 24-30,,2,15,5,30,7,45
10746,HOU,2008,2008-09-21,1:02,12:02,@,TEN,3,2,Sun,L 12-31,,2,10,8,75,10,85
10747,HOU,2008,2008-09-28,1:02,1:02,@,JAX,4,3,Sun,L 27-30,OT,2,15,2,27,4,42
10748,HOU,2011,2011-11-06,1:03,12:03,,CLE,9,9,Sun,W 30-12,,2,15,4,35,6,50
10749,HOU,2012,2012-11-18,1:03,12:03,,JAX,11,10,Sun,W 43-37,OT,2,20,6,54,8,74
10750,HOU,2013,2013-11-24,1:02,12:02,,JAX,12,11,Sun,L 6-13,,2,22,7,63,9,85
10751,HOU,2013,2013-12-01,1:02,12:02,,NWE,13,12,Sun,L 31-34,,2,25,0,0,2,25
10752,HOU,2016,2016-10-24,8:30,6:30,@,DEN,7,7,Mon,L 9-27,,2,15,7,83,9,98
10753,HOU,2018,2018-12-30,1:00,12:00,,JAX,17,16,Sun,W 20-3,,2,15,8,68,10,83
10754,HOU,2020,2020-10-04,1:00,12:00,,MIN,4,4,Sun,L 23-31,,2,15,4,36,6,51
10755,JAX,2000,2000-12-10,1:02,1:02,,ARI,15,14,Sun,W 44-10,,2,15,4,53,6,68
10756,JAX,2006,2006-09-10,4:15,4:15,,DAL,1,1,Sun,W 24-17,,2,41,9,93,11,134
10757,JAX,2006,2006-12-17,1:03,12:03,@,TEN,15,14,Sun,L 17-24,,2,25,4,40,6,65
10758,JAX,2007,2007-10-22,8:40,8:40,,IND,7,6,Mon,L 7-29,,2,20,4,27,6,47
10759,JAX,2008,2008-09-28,1:02,1:02,,HOU,4,4,Sun,W 30-27,OT,2,27,2,15,4,42
10760,JAX,2009,2009-11-01,4:05,3:05,@,TEN,8,7,Sun,L 13-30,,2,27,4,20,6,47
10761,JAX,2009,2009-12-13,1:03,1:03,,MIA,14,13,Sun,L 10-14,,2,10,4,27,6,37
10762,JAX,2010,2010-11-21,1:03,1:03,,CLE,11,10,Sun,W 24-20,,2,10,5,45,7,55
10763,JAX,2010,2011-01-02,4:15,3:15,@,HOU,17,16,Sun,L 17-34,,2,15,5,48,7,63
10764,JAX,2011,2011-10-02,1:03,1:03,,NOR,4,4,Sun,L 10-23,,2,15,6,50,8,65
10765,JAX,2011,2011-10-09,1:02,1:02,,CIN,5,5,Sun,L 20-30,,2,15,4,33,6,48
10766,JAX,2014,2014-09-21,1:02,1:02,,IND,3,3,Sun,L 17-44,,2,15,8,46,10,61
10767,JAX,2014,2014-11-09,1:06,6:06,,DAL,10,10,Sun,L 17-31,,2,19,9,65,11,84
10768,JAX,2018,2018-10-21,1:00,1:00,,HOU,7,7,Sun,L 7-20,,2,15,6,35,8,50
10769,JAX,2019,2019-10-13,1:00,1:00,,NOR,6,6,Sun,L 6-13,,2,15,3,35,5,50
10770,JAX,2021,2021-09-30,8:20,8:20,@,CIN,4,4,Thu,L 21-24,,2,10,6,38,8,48
10771,JAX,2021,2021-12-26,1:00,1:00,@,NYJ,16,15,Sun,L 21-26,,2,10,7,81,9,91
10772,KAN,2001,2001-09-23,12:00,12:00,,NYG,2,2,Sun,L 3-13,,2,10,2,15,4,25
10773,KAN,2001,2001-10-07,2:05,2:05,@,DEN,4,4,Sun,L 6-20,,2,15,8,53,10,68
10774,KAN,2001,2001-10-14,12:00,12:00,,PIT,5,5,Sun,L 17-20,,2,10,8,67,10,77
10775,KAN,2001,2001-10-25,7:30,7:30,,IND,7,7,Thu,L 28-35,,2,10,7,54,9,64
10776,KAN,2001,2001-12-23,1:00,12:00,,SDG,15,14,Sun,W 20-17,,2,10,7,47,9,57
10777,KAN,2001,2002-01-06,4:16,1:16,@,SEA,17,16,Sun,L 18-21,,2,15,4,30,6,45
10778,KAN,2002,2002-12-08,1:00,12:00,,STL,14,13,Sun,W 49-10,,2,15,5,40,7,55
10779,KAN,2003,2003-11-23,4:15,3:15,,OAK,12,11,Sun,W 27-24,,2,20,7,65,9,85
10780,KAN,2003,2003-12-20,5:15,4:15,@,MIN,16,15,Sat,L 20-45,,2,20,6,51,8,71
10781,KAN,2008,2008-09-07,1:02,1:02,@,NWE,1,1,Sun,L 10-17,,2,15,3,30,5,45
10782,KAN,2010,2010-12-12,4:15,1:15,@,SDG,14,13,Sun,L 0-31,,2,15,6,47,8,62
10783,KAN,2012,2012-09-09,1:03,12:03,,ATL,1,1,Sun,L 24-40,,2,25,2,12,4,37
10784,KAN,2015,2015-09-13,1:02,12:02,@,HOU,1,1,Sun,W 27-20,,2,25,6,39,8,64
10785,KAN,2016,2016-10-16,4:05,1:05,@,OAK,6,5,Sun,W 26-10,,2,10,3,25,5,35
10786,MIA,2006,2006-12-17,1:02,1:02,@,BUF,15,14,Sun,L 0-21,,2,25,5,17,7,42
10787,MIA,2008,2008-11-02,4:05,2:05,@,DEN,9,8,Sun,W 26-17,,2,42,10,81,12,123
10788,MIA,2008,2008-12-21,1:00,12:00,@,KAN,16,15,Sun,W 38-31,,2,15,5,46,7,61
10789,MIA,2009,2009-12-06,1:02,1:02,,NWE,13,12,Sun,W 22-21,,2,10,6,82,8,92
10790,MIA,2010,2010-09-19,1:05,12:05,@,MIN,2,2,Sun,W 14-10,,2,15,7,44,9,59
10791,MIA,2011,2011-10-02,4:15,1:15,@,SDG,4,4,Sun,L 16-26,,2,41,8,80,10,121
10792,MIA,2011,2011-10-17,8:40,8:40,@,NYJ,6,5,Mon,L 6-24,,2,10,6,49,8,59
10793,MIA,2011,2011-10-23,1:02,1:02,,DEN,7,6,Sun,L 15-18,OT,2,20,5,30,7,50
10794,MIA,2012,2012-10-07,1:03,1:03,@,CIN,5,5,Sun,W 17-13,,2,10,5,46,7,56
10795,MIA,2012,2012-11-25,1:03,1:03,,SEA,12,11,Sun,W 24-21,,2,15,10,59,12,74
10796,MIA,2013,2013-09-22,4:05,4:05,,ATL,3,3,Sun,W 27-23,,2,13,7,59,9,72
10797,MIA,2013,2013-10-31,8:29,8:29,,CIN,9,8,Thu,W 22-20,OT,2,25,3,63,5,88
10798,MIA,2016,2016-12-24,1:00,1:00,@,BUF,16,15,Sat,W 34-31,OT,2,15,5,35,7,50
10799,MIA,2018,2018-09-16,1:00,1:00,@,NYJ,2,2,Sun,W 20-12,,2,10,7,50,9,60
10800,MIA,2020,2021-01-03,1:00,1:00,@,BUF,17,16,Sun,L 26-56,,2,20,3,16,5,36
10801,MIA,2021,2021-11-07,1:00,1:00,,HOU,9,9,Sun,W 17-9,,2,13,8,60,10,73
10802,MIN,2007,2007-10-14,1:02,12:02,@,CHI,6,5,Sun,W 34-31,,2,10,4,28,6,38
10803,MIN,2008,2008-09-14,1:05,12:05,,IND,2,2,Sun,L 15-18,,2,5,5,45,7,50
10804,MIN,2008,2008-12-28,1:05,12:05,,NYG,17,16,Sun,W 20-19,,2,20,7,49,9,69
10805,MIN,2009,2009-10-05,8:40,7:40,,GNB,4,4,Mon,W 30-23,,2,10,7,57,9,67
10806,MIN,2010,2010-11-14,1:02,12:02,@,CHI,10,9,Sun,L 13-27,,2,19,11,116,13,135
10807,MIN,2014,2014-11-16,1:02,12:02,@,CHI,11,10,Sun,L 13-21,,2,18,7,60,9,78
10808,MIN,2015,2015-12-27,8:30,7:30,,NYG,16,15,Sun,W 49-17,,2,10,7,48,9,58
10809,MIN,2016,2017-01-01,1:00,3:00,,CHI,17,16,Sun,W 38-10,,2,15,6,49,8,64
10810,MIN,2017,2017-10-01,1:00,3:00,,DET,4,4,Sun,L 7-14,,2,10,6,60,8,70
10811,MIN,2017,2017-12-10,1:00,1:00,@,CAR,14,13,Sun,L 24-31,,2,30,6,48,8,78
10812,MIN,2017,2017-12-23,8:30,7:30,@,GNB,16,15,Sat,W 16-0,,2,10,6,79,8,89
10813,MIN,2021,2021-12-26,1:00,11:00,,LAR,16,15,Sun,L 23-30,,2,20,1,5,3,25
10814,NOR,2006,2006-09-17,1:02,12:02,@,GNB,2,2,Sun,W 34-27,,2,14,5,31,7,45
10815,NOR,2006,2006-12-24,1:04,1:04,@,NYG,16,15,Sun,W 30-7,,2,15,7,67,9,82
10816,NOR,2007,2007-09-24,8:40,7:40,,TEN,3,3,Mon,L 14-31,,2,15,8,49,10,64
10817,NOR,2007,2007-11-04,1:02,12:02,,JAX,9,8,Sun,W 41-24,,2,20,4,38,6,58
10818,NOR,2007,2007-11-11,1:02,12:02,,STL,10,9,Sun,L 29-37,,2,28,5,77,7,105
10819,NOR,2008,2008-11-16,1:00,12:00,@,KAN,11,10,Sun,W 30-20,,2,8,6,40,8,48
10820,NOR,2008,2008-11-24,8:40,7:40,,GNB,12,11,Mon,W 51-29,,2,10,3,20,5,30
10821,NOR,2009,2009-12-27,1:03,12:03,,TAM,16,15,Sun,L 17-20,OT,2,14,7,42,9,56
10822,NOR,2012,2012-09-16,1:03,1:03,@,CAR,2,2,Sun,L 27-35,,2,23,4,34,6,57
10823,NOR,2013,2013-10-06,1:02,12:02,@,CHI,5,5,Sun,W 26-18,,2,10,6,43,8,53
10824,NOR,2014,2014-12-28,1:03,1:03,@,TAM,17,16,Sun,W 23-20,,2,15,4,23,6,38
10825,NOR,2016,2016-10-30,1:03,12:03,,SEA,8,7,Sun,W 25-20,,2,10,11,76,13,86
10826,NOR,2018,2018-11-04,4:25,3:25,,LAR,9,8,Sun,W 45-35,,2,20,4,32,6,52
10827,NOR,2019,2019-10-27,1:00,12:00,,ARI,8,8,Sun,W 31-9,,2,15,5,35,7,50
10828,NOR,2021,2021-09-26,1:00,1:00,@,NWE,3,3,Sun,W 28-13,,2,15,4,30,6,45
10829,NOR,2021,2021-10-31,4:25,3:25,,TAM,8,7,Sun,W 36-27,,2,10,11,99,13,109
10830,NWE,2002,2002-12-16,9:08,8:08,@,TEN,15,14,Mon,L 7-24,,2,15,9,80,11,95
10831,NWE,2003,2003-12-07,4:15,4:15,,MIA,14,13,Sun,W 12-0,,2,14,4,25,6,39
10832,NWE,2004,2004-12-12,1:02,1:02,,CIN,14,13,Sun,W 35-28,,2,13,9,75,11,88
10833,NWE,2005,2005-11-27,1:00,12:00,@,KAN,12,11,Sun,L 16-26,,2,22,5,35,7,57
10834,NWE,2006,2006-12-17,1:02,1:02,,HOU,15,14,Sun,W 40-7,,2,10,4,66,6,76
10835,NWE,2007,2007-09-23,1:02,1:02,,BUF,3,3,Sun,W 38-7,,2,20,5,30,7,50
10836,NWE,2007,2007-12-23,4:15,4:15,,MIA,16,15,Sun,W 28-7,,2,18,4,32,6,50
10837,NWE,2008,2008-09-14,4:15,4:15,@,NYJ,2,2,Sun,W 19-10,,2,10,6,60,8,70
10838,NWE,2008,2008-09-21,1:02,1:02,,MIA,3,3,Sun,L 13-38,,2,10,5,35,7,45
10839,NWE,2008,2008-11-02,8:23,8:23,@,IND,9,8,Sun,L 15-18,,2,20,1,0,3,20
10840,NWE,2008,2008-11-09,1:02,1:02,,BUF,10,9,Sun,W 20-10,,2,15,3,22,5,37
10841,NWE,2008,2008-12-28,1:02,1:02,@,BUF,17,16,Sun,W 13-0,,2,10,3,20,5,30
10842,NWE,2009,2009-09-27,1:02,1:02,,ATL,3,3,Sun,W 26-10,,2,10,7,54,9,64
10843,NWE,2009,2009-12-27,1:02,1:02,,JAX,16,15,Sun,W 35-7,,2,10,1,5,3,15
10844,NWE,2016,2016-11-27,4:25,4:25,@,NYJ,12,11,Sun,W 22-17,,2,15,6,66,8,81
10845,NWE,2017,2017-11-19,4:25,3:25,@,OAK,11,10,Sun,W 33-8,,2,10,8,66,10,76
10846,NWE,2017,2017-12-17,4:25,4:25,@,PIT,15,14,Sun,W 27-24,,2,4,6,63,8,67
10847,NWE,2017,2017-12-24,1:00,1:00,,BUF,16,15,Sun,W 37-16,,2,10,4,83,6,93
10848,NWE,2018,2018-09-16,4:25,4:25,@,JAX,2,2,Sun,L 20-31,,2,25,7,71,9,96
10849,NWE,2020,2020-09-20,8:20,5:20,@,SEA,2,2,Sun,L 30-35,,2,12,9,68,11,80
10850,NWE,2020,2020-09-27,1:00,1:00,,LVR,3,3,Sun,W 36-20,,2,33,6,40,8,73
10851,NWE,2020,2020-12-20,1:00,1:00,@,MIA,15,14,Sun,L 12-22,,2,20,7,40,9,60
10852,NYG,2000,2000-09-17,3:16,3:16,@,CHI,3,3,Sun,W 14-7,,2,15,2,30,4,45
10853,NYG,2001,2001-09-23,12:00,12:00,@,KAN,2,2,Sun,W 13-3,,2,15,2,10,4,25
10854,NYG,2001,2001-12-09,1:02,12:02,@,DAL,13,12,Sun,L 13-20,,2,15,6,45,8,60
10855,NYG,2001,2001-12-15,1:37,1:37,,ARI,14,13,Sat,W 17-13,,2,10,5,40,7,50
10856,NYG,2006,2006-12-10,1:02,1:02,@,CAR,14,13,Sun,W 27-13,,2,10,7,37,9,47
10857,NYG,2007,2007-12-02,4:15,3:15,@,CHI,13,12,Sun,W 21-16,,2,10,10,71,12,81
10858,NYG,2008,2008-12-21,8:23,8:23,,CAR,16,15,Sun,W 34-28,OT,2,10,2,14,4,24
10859,NYG,2009,2009-12-06,4:15,4:15,,DAL,13,12,Sun,W 31-24,,2,10,5,30,7,40
10860,NYG,2010,2010-10-17,1:03,1:03,,DET,6,6,Sun,W 28-20,,2,15,11,91,13,106
10861,NYG,2010,2011-01-02,4:16,4:16,@,WAS,17,16,Sun,W 17-14,,2,24,4,25,6,49
10862,NYG,2012,2012-10-14,4:23,1:23,@,SFO,6,6,Sun,W 26-3,,2,20,6,35,8,55
10863,NYG,2012,2012-12-16,1:03,1:03,@,ATL,15,14,Sun,L 0-34,,2,25,3,30,5,55
10864,NYG,2015,2016-01-03,1:03,1:03,,PHI,17,16,Sun,L 30-35,,2,10,3,11,5,21
10865,NYG,2016,2016-11-14,8:30,8:30,,CIN,10,9,Mon,W 21-20,,2,15,9,60,11,75
10866,NYG,2018,2018-12-09,1:00,1:00,@,WAS,14,13,Sun,W 40-16,,2,18,15,135,17,153
10867,NYG,2020,2020-12-13,1:00,1:00,,ARI,14,13,Sun,L 7-26,,2,10,4,22,6,32
10868,NYG,2020,2020-12-20,8:20,8:20,,CLE,15,14,Sun,L 6-20,,2,25,6,60,8,85
10869,NYG,2021,2021-11-28,1:00,1:00,,PHI,12,11,Sun,W 13-7,,2,15,4,26,6,41
10870,NYJ,2000,2000-10-29,1:01,1:01,@,BUF,9,8,Sun,L 20-23,,2,20,5,45,7,65
10871,NYJ,2000,2000-11-05,4:15,4:15,,DEN,10,9,Sun,L 23-30,,2,10,6,57,8,67
10872,NYJ,2001,2001-12-02,1:02,1:02,,NWE,12,11,Sun,L 16-17,,2,5,4,28,6,33
10873,NYJ,2001,2001-12-23,8:30,8:30,@,IND,15,14,Sun,W 29-28,,2,15,2,10,4,25
10874,NYJ,2003,2003-10-19,4:05,3:05,@,HOU,7,6,Sun,W 19-14,,2,9,8,50,10,59
10875,NYJ,2004,2004-12-19,1:02,1:02,,SEA,15,14,Sun,W 37-14,,2,15,2,20,4,35
10876,NYJ,2006,2006-10-22,1:03,1:03,,DET,7,7,Sun,W 31-24,,2,20,9,60,11,80
10877,NYJ,2007,2007-09-09,1:03,1:03,,NWE,1,1,Sun,L 14-38,,2,20,4,16,6,36
10878,NYJ,2007,2007-09-16,4:15,4:15,@,BAL,2,2,Sun,L 13-20,,2,10,11,100,13,110
10879,NYJ,2007,2007-10-28,4:05,4:05,,BUF,8,8,Sun,L 3-13,,2,25,7,50,9,75
10880,NYJ,2007,2007-12-02,1:03,1:03,@,MIA,13,12,Sun,W 40-13,,2,11,4,42,6,53
10881,NYJ,2007,2007-12-09,4:15,4:15,,CLE,14,13,Sun,L 18-24,,2,9,4,29,6,38
10882,NYJ,2008,2008-09-22,8:40,5:40,@,SDG,3,3,Mon,L 29-48,,2,5,6,37,8,42
10883,NYJ,2009,2009-10-25,4:05,1:05,@,OAK,7,7,Sun,W 38-0,,2,8,3,24,5,32
10884,NYJ,2011,2011-11-17,8:30,6:30,@,DEN,11,10,Thu,L 13-17,,2,15,6,51,8,66
10885,NYJ,2014,2014-10-12,1:02,1:02,,DEN,6,6,Sun,L 17-31,,2,9,11,101,13,110
10886,NYJ,2014,2014-12-21,1:02,1:02,,NWE,16,15,Sun,L 16-17,,2,14,5,38,7,52
10887,NYJ,2016,2017-01-01,1:00,1:00,,BUF,17,16,Sun,W 30-10,,2,15,0,0,2,15
10888,NYJ,2019,2019-12-29,1:00,1:00,@,BUF,17,16,Sun,W 13-6,,2,13,5,40,7,53
10889,NYJ,2021,2022-01-02,1:00,1:00,,TAM,17,16,Sun,L 24-28,,2,14,4,39,6,53
10890,TEN,2003,2003-11-16,1:02,12:02,,JAX,11,10,Sun,W 10-3,,2,12,3,15,5,27
10891,TEN,2005,2005-11-06,1:03,1:03,@,CLE,9,9,Sun,L 14-20,,2,15,9,63,11,78
10892,TEN,2006,2006-11-19,1:01,1:01,@,PHI,11,10,Sun,W 31-13,,2,15,8,64,10,79
10893,TEN,2008,2008-11-02,1:02,12:02,,GNB,9,8,Sun,W 19-16,OT,2,15,4,41,6,56
10894,TEN,2016,2016-09-11,1:05,12:05,,MIN,1,1,Sun,L 16-25,,2,10,3,39,5,49
10895,TEN,2016,2016-12-18,1:00,12:00,@,KAN,15,14,Sun,W 19-17,,2,25,5,40,7,65
10896,TEN,2017,2017-11-26,1:00,1:00,@,IND,12,11,Sun,W 20-16,,2,15,9,67,11,82
10897,TEN,2017,2017-12-31,4:25,12:00,,JAX,17,16,Sun,W 15-10,,2,15,6,41,8,56
10898,TEN,2018,2018-12-22,4:30,4:30,,WAS,16,15,Sat,W 25-16,,2,10,8,49,10,59
10899,TEN,2021,2021-12-12,1:00,12:00,,JAX,14,13,Sun,W 20-0,,2,15,9,79,11,94
10900,PHI,2001,2001-09-09,4:16,4:16,,STL,1,1,Sun,L 17-20,OT,2,20,7,45,9,65
10901,PHI,2001,2001-11-11,4:15,4:15,,MIN,9,8,Sun,W 48-17,,2,8,7,51,9,59
10902,PHI,2003,2003-10-12,1:03,12:03,@,DAL,6,5,Sun,L 21-23,,2,10,5,23,7,33
10903,PHI,2006,2006-12-10,1:03,1:03,@,WAS,14,13,Sun,W 21-19,,2,20,11,68,13,88
10904,PHI,2007,2007-09-17,8:40,8:40,,WAS,2,2,Mon,L 12-20,,2,15,5,25,7,40
10905,PHI,2007,2007-10-14,1:02,1:02,@,NYJ,6,5,Sun,W 16-9,,2,14,0,0,2,14
10906,PHI,2008,2008-10-12,4:15,1:15,@,SFO,6,6,Sun,W 40-26,,2,10,10,58,12,68
10907,PHI,2012,2012-12-09,1:03,1:03,@,TAM,14,13,Sun,W 23-21,,2,13,8,64,10,77
10908,PHI,2013,2013-12-22,8:30,8:30,,CHI,16,15,Sun,W 54-11,,2,15,2,10,4,25
10909,PHI,2015,2015-11-26,12:35,12:35,@,DET,12,11,Thu,L 14-45,,2,30,4,29,6,59
10910,PHI,2019,2019-11-24,1:00,1:00,,SEA,12,11,Sun,L 9-17,,2,15,12,90,14,105
10911,PHI,2021,2021-10-31,1:00,1:00,@,DET,8,8,Sun,W 44-6,,2,15,8,50,10,65
10912,PIT,2000,2000-09-03,1:02,1:02,,BAL,1,1,Sun,L 0-16,,2,15,6,42,8,57
10913,PIT,2001,2001-11-04,1:01,1:01,,BAL,8,7,Sun,L 10-13,,2,25,4,25,6,50
10914,PIT,2001,2001-11-11,1:03,1:03,@,CLE,9,8,Sun,W 15-12,OT,2,30,5,45,7,75
10915,PIT,2004,2004-12-12,4:05,4:05,,NYJ,14,13,Sun,W 17-6,,2,15,12,84,14,99
10916,PIT,2004,2004-12-18,1:37,1:37,@,NYG,15,14,Sat,W 33-30,,2,14,5,55,7,69
10917,PIT,2005,2006-01-01,1:02,1:02,,DET,17,16,Sun,W 35-21,,2,15,5,47,7,62
10918,PIT,2006,2006-09-24,1:02,1:02,,CIN,3,3,Sun,L 20-28,,2,25,5,45,7,70
10919,PIT,2006,2006-12-03,4:15,4:15,,TAM,13,12,Sun,W 20-3,,2,15,5,40,7,55
10920,PIT,2006,2006-12-17,1:02,1:02,@,CAR,15,14,Sun,W 37-3,,2,10,8,65,10,75
10921,PIT,2007,2007-09-16,1:02,1:02,,BUF,2,2,Sun,W 26-3,,2,9,5,55,7,64
10922,PIT,2007,2007-12-20,8:15,7:15,@,STL,16,15,Thu,W 41-24,,2,36,3,20,5,56
10923,PIT,2008,2008-12-07,4:16,4:16,,DAL,14,13,Sun,W 20-13,,2,10,5,24,7,34
10924,PIT,2010,2010-09-26,1:03,1:03,@,TAM,3,3,Sun,W 38-13,,2,20,4,45,6,65
10925,PIT,2012,2012-11-12,8:40,8:40,,KAN,10,9,Mon,W 16-13,OT,2,19,6,76,8,95
10926,PIT,2013,2013-11-24,1:03,1:03,@,CLE,12,11,Sun,W 27-11,,2,8,2,10,4,18
10927,PIT,2013,2013-12-29,1:02,1:02,,CLE,17,16,Sun,W 20-7,,2,15,3,30,5,45
10928,PIT,2018,2018-12-09,4:25,1:25,@,OAK,14,13,Sun,L 21-24,,2,14,13,130,15,144
10929,PIT,2020,2020-09-27,1:00,1:00,,HOU,3,3,Sun,W 28-21,,2,14,4,49,6,63
10930,PIT,2020,2021-01-03,1:00,1:00,@,CLE,17,16,Sun,L 22-24,,2,15,4,19,6,34
10931,OAK,2001,2001-11-18,4:05,1:05,,SDG,10,9,Sun,W 34-24,,2,25,5,47,7,72
10932,OAK,2007,2007-09-30,1:32,1:32,@,MIA,4,4,Sun,W 35-17,,2,15,5,34,7,49
10933,OAK,2008,2008-10-26,1:02,1:02,@,BAL,8,7,Sun,L 10-29,,2,10,8,52,10,62
10934,OAK,2008,2008-12-21,4:05,1:05,,HOU,16,15,Sun,W 27-16,,2,14,1,15,3,29
10935,OAK,2010,2010-10-03,4:05,1:05,,HOU,4,4,Sun,L 24-31,,2,23,5,26,7,49
10936,OAK,2012,2012-10-28,4:06,3:06,@,KAN,8,7,Sun,W 26-16,,2,20,5,40,7,60
10937,OAK,2013,2013-12-29,4:25,1:25,,DEN,17,16,Sun,L 14-34,,2,10,6,56,8,66
10938,OAK,2016,2016-12-18,4:25,1:25,@,SDG,15,14,Sun,W 19-16,,2,15,6,44,8,59
10939,LVR,2020,2020-11-08,4:05,1:05,@,LAC,9,8,Sun,W 31-26,,2,10,5,45,7,55
10940,STL,2000,2000-11-12,4:15,4:15,@,NYG,11,10,Sun,W 38-24,,2,10,7,49,9,59
10941,STL,2000,2000-12-18,9:00,9:00,@,TAM,16,15,Mon,L 35-38,,2,20,5,40,7,60
10942,STL,2010,2010-12-05,4:15,2:15,@,ARI,13,12,Sun,W 19-6,,2,15,6,54,8,69
10943,STL,2012,2012-12-09,1:02,1:02,@,BUF,14,13,Sun,W 15-12,,2,17,2,15,4,32
10944,STL,2014,2014-10-19,1:00,12:00,,SEA,7,6,Sun,W 28-26,,2,20,10,86,12,106
10945,LAR,2018,2018-09-27,8:20,5:20,,MIN,4,4,Thu,W 38-31,,2,15,4,35,6,50
10946,LAR,2018,2018-10-28,4:25,1:25,,GNB,8,8,Sun,W 29-27,,2,15,2,10,4,25
10947,LAR,2021,2021-09-19,1:00,1:00,@,IND,2,2,Sun,W 27-24,,2,15,3,25,5,40
10948,BAL,2001,2002-01-07,9:07,9:07,,MIN,17,16,Mon,W 19-3,,2,15,4,42,6,57
10949,BAL,2002,2002-12-15,1:02,12:02,@,HOU,15,14,Sun,W 23-19,,2,15,9,58,11,73
10950,BAL,2003,2003-12-07,1:02,1:02,,CIN,14,13,Sun,W 31-13,,2,20,9,63,11,83
10951,BAL,2007,2007-11-18,1:02,1:02,,CLE,11,10,Sun,L 30-33,OT,2,15,12,104,14,119
10952,BAL,2007,2007-12-09,8:23,8:23,,IND,14,13,Sun,L 20-44,,2,15,7,82,9,97
10953,BAL,2009,2009-11-22,1:02,1:02,,IND,11,10,Sun,L 15-17,,2,20,5,40,7,60
10954,BAL,2017,2017-12-03,1:00,1:00,,DET,13,12,Sun,W 44-20,,2,25,6,45,8,70
10955,BAL,2021,2021-10-17,1:00,1:00,,LAC,6,6,Sun,W 34-6,,2,15,4,35,6,50
10956,SDG,2002,2002-09-29,4:15,1:15,,NWE,4,4,Sun,W 21-14,,2,20,6,45,8,65
10957,SDG,2003,2003-12-21,4:05,4:05,@,PIT,16,15,Sun,L 24-40,,2,10,3,24,5,34
10958,SDG,2005,2005-11-20,4:15,1:15,,BUF,11,10,Sun,W 48-10,,2,10,9,65,11,75
10959,SDG,2006,2006-10-08,8:15,5:15,,PIT,5,4,Sun,W 23-13,,2,10,4,30,6,40
10960,SDG,2008,2008-09-07,4:15,1:15,,CAR,1,1,Sun,L 24-26,,2,12,6,29,8,41
10961,SDG,2008,2008-11-16,4:16,4:16,@,PIT,11,10,Sun,L 10-11,,2,5,13,115,15,120
10962,SDG,2009,2010-01-03,4:15,1:15,,WAS,17,16,Sun,W 23-20,,2,17,3,14,5,31
10963,LAC,2019,2019-12-22,4:05,1:05,,OAK,16,15,Sun,L 17-24,,2,15,5,47,7,62
10964,SEA,2000,2000-09-03,4:16,4:16,@,MIA,1,1,Sun,L 0-23,,2,10,6,36,8,46
10965,SEA,2001,2001-12-23,1:03,1:03,@,NYG,15,14,Sun,L 24-27,,2,10,6,61,8,71
10966,SEA,2002,2002-10-20,1:02,12:02,@,STL,7,6,Sun,L 20-37,,2,15,6,35,8,50
10967,SEA,2004,2004-10-31,4:06,1:06,,CAR,8,7,Sun,W 23-17,,2,13,10,79,12,92
10968,SEA,2004,2004-12-19,1:02,1:02,@,NYJ,15,14,Sun,L 14-37,,2,20,2,15,4,35
10969,SEA,2005,2005-12-05,9:07,9:07,@,PHI,13,12,Mon,W 42-0,,2,10,10,56,12,66
10970,SEA,2007,2007-11-18,4:16,1:16,,CHI,11,10,Sun,W 30-23,,2,20,6,40,8,60
10971,SEA,2007,2007-12-02,1:02,1:02,@,PHI,13,12,Sun,W 28-24,,2,25,0,0,2,25
10972,SEA,2008,2008-10-05,1:03,1:03,@,NYG,5,4,Sun,L 6-44,,2,29,5,56,7,85
10973,SEA,2012,2012-10-28,1:03,1:03,@,DET,8,8,Sun,L 24-28,,2,10,5,61,7,71
10974,SEA,2014,2014-12-28,4:27,1:27,,STL,17,16,Sun,W 20-6,,2,20,6,45,8,65
10975,SEA,2016,2016-11-27,4:05,4:05,@,TAM,12,11,Sun,L 5-14,,2,27,7,68,9,95
10976,SEA,2019,2019-10-20,4:25,1:25,,BAL,7,7,Sun,L 16-30,,2,18,8,75,10,93
10977,SEA,2021,2021-11-21,4:25,1:25,,ARI,11,10,Sun,L 13-23,,2,17,3,32,5,49
10978,SFO,2000,2000-12-10,4:15,1:15,,NOR,15,14,Sun,L 27-31,,2,15,1,5,3,20
10979,SFO,2001,2001-12-16,4:07,1:07,,MIA,14,13,Sun,W 21-0,,2,10,4,27,6,37
10980,SFO,2001,2001-12-30,1:03,12:03,@,DAL,16,15,Sun,L 21-27,,2,10,5,27,7,37
10981,SFO,2002,2002-12-01,4:15,1:15,,SEA,13,12,Sun,W 31-24,,2,10,6,55,8,65
10982,SFO,2005,2005-09-18,1:03,1:03,@,PHI,2,2,Sun,L 3-42,,2,15,6,50,8,65
10983,SFO,2006,2006-09-17,4:06,1:06,,STL,2,2,Sun,W 20-13,,2,20,6,40,8,60
10984,SFO,2007,2007-09-23,1:02,1:02,@,PIT,3,3,Sun,L 16-37,,2,10,3,13,5,23
10985,SFO,2008,2008-11-23,1:03,12:03,@,DAL,12,11,Sun,L 22-35,,2,10,8,65,10,75
10986,SFO,2010,2010-12-12,4:05,1:05,,SEA,14,13,Sun,W 40-21,,2,15,8,75,10,90
10987,SFO,2014,2014-10-05,4:25,1:25,,KAN,5,5,Sun,W 22-17,,2,10,4,29,6,39
10988,SFO,2014,2014-11-09,1:03,12:03,@,NOR,10,9,Sun,W 27-24,OT,2,15,6,43,8,58
10989,SFO,2016,2016-09-12,10:20,7:20,,LAR,1,1,Mon,W 28-0,,2,10,10,102,12,112
10990,SFO,2017,2017-10-22,4:05,1:05,,DAL,7,7,Sun,L 10-40,,2,22,5,36,7,58
10991,SFO,2018,2018-10-15,8:15,7:15,@,GNB,6,6,Mon,L 30-33,,2,10,6,54,8,64
10992,SFO,2018,2018-10-21,4:25,1:25,,LAR,7,7,Sun,L 10-39,,2,10,1,10,3,20
10993,SFO,2019,2019-10-20,1:00,1:00,@,WAS,7,6,Sun,W 9-0,,2,20,7,47,9,67
10994,SFO,2020,2021-01-03,4:25,2:25,,SEA,17,16,Sun,L 23-26,,2,25,4,35,6,60
10995,TAM,2005,2005-11-13,4:15,4:15,,WAS,10,9,Sun,W 36-35,,2,15,6,41,8,56
10996,TAM,2006,2006-10-22,1:02,1:02,,PHI,7,6,Sun,W 23-21,,2,15,7,65,9,80
10997,TAM,2006,2006-12-10,1:02,1:02,,ATL,14,13,Sun,L 6-17,,2,10,2,10,4,20
10998,TAM,2006,2006-12-24,1:03,1:03,@,CLE,16,15,Sun,W 22-7,,2,10,1,15,3,25
10999,TAM,2007,2007-09-16,1:03,1:03,,NOR,2,2,Sun,W 31-14,,2,10,3,35,5,45
11000,TAM,2008,2008-12-21,1:02,1:02,,SDG,16,15,Sun,L 24-41,,2,25,4,25,6,50
11001,TAM,2009,2009-11-08,1:03,1:03,,GNB,9,8,Sun,W 38-28,,2,15,5,35,7,50
11002,TAM,2010,2010-12-12,1:03,1:03,@,WAS,14,13,Sun,W 17-16,,2,14,4,25,6,39
11003,TAM,2011,2012-01-01,4:17,4:17,@,ATL,17,16,Sun,L 24-45,,2,20,3,20,5,40
11004,TAM,2012,2012-12-30,1:02,1:02,@,ATL,17,16,Sun,W 22-17,,2,15,2,15,4,30
11005,TAM,2017,2017-11-26,1:00,1:00,@,ATL,12,11,Sun,L 20-34,,2,15,4,42,6,57
11006,TAM,2017,2017-12-31,4:25,1:00,,NOR,17,16,Sun,W 31-24,,2,15,7,38,9,53
11007,TAM,2020,2020-11-23,8:15,8:15,,LAR,11,11,Mon,L 24-27,,2,7,5,65,7,72
11008,TAM,2021,2022-01-09,1:00,1:00,,CAR,18,17,Sun,W 41-17,,2,10,1,10,3,20
11009,WAS,2004,2004-10-10,8:36,8:36,,BAL,5,5,Sun,L 10-17,,2,22,5,53,7,75
11010,WAS,2005,2005-10-02,1:03,1:03,,SEA,4,3,Sun,W 20-17,OT,2,10,8,84,10,94
11011,WAS,2006,2006-12-24,1:02,12:02,@,STL,16,15,Sun,L 31-37,OT,2,58,6,30,8,88
11012,WAS,2008,2008-11-16,8:23,8:23,,DAL,11,10,Sun,L 10-14,,2,10,5,40,7,50
11013,WAS,2008,2008-11-23,4:16,1:16,@,SEA,12,11,Sun,W 20-17,,2,20,6,51,8,71
11014,WAS,2008,2008-12-28,4:15,1:15,@,SFO,17,16,Sun,L 24-27,,2,10,3,15,5,25
11015,WAS,2009,2009-11-15,1:02,1:02,,DEN,10,9,Sun,W 27-17,,2,19,4,45,6,64
11016,WAS,2009,2009-12-06,1:03,1:03,,NOR,13,12,Sun,L 30-33,OT,2,15,7,102,9,117
11017,WAS,2011,2011-12-18,1:02,1:02,@,NYG,15,14,Sun,W 23-10,,2,48,8,75,10,123
11018,WAS,2012,2012-12-30,8:31,8:31,,DAL,17,16,Sun,W 28-18,,2,20,1,6,3,26
11019,WAS,2017,2017-09-10,1:00,1:00,,PHI,1,1,Sun,L 17-30,,2,15,8,76,10,91
11020,WAS,2017,2017-11-12,1:00,1:00,,MIN,10,9,Sun,L 30-38,,2,15,3,40,5,55
11021,WAS,2018,2018-12-30,4:25,1:00,,PHI,17,16,Sun,L 0-24,,2,15,5,25,7,40
11022,WAS,2019,2019-12-29,4:25,3:25,@,DAL,17,16,Sun,L 16-47,,2,10,10,81,12,91
11023,WAS,2020,2020-10-04,1:00,1:00,,BAL,4,4,Sun,L 17-31,,2,20,5,30,7,50
11024,WAS,2021,2021-12-21,7:00,7:00,@,PHI,15,14,Tue,L 17-27,,2,25,4,48,6,73
11025,ATL,2001,2001-09-23,1:12,1:12,,CAR,2,2,Sun,W 24-16,,1,5,7,54,8,59
11026,ATL,2010,2010-11-11,8:31,8:31,,BAL,10,9,Thu,W 26-21,,1,5,6,51,7,56
11027,ATL,2010,2010-12-12,1:03,1:03,@,CAR,14,13,Sun,W 31-10,,1,10,6,50,7,60
11028,ATL,2010,2010-12-27,8:40,8:40,,NOR,16,15,Mon,L 14-17,,1,10,8,92,9,102
11029,ATL,2011,2011-11-06,1:02,1:02,@,IND,9,8,Sun,W 31-7,,1,10,6,32,7,42
11030,ATL,2013,2013-11-10,1:03,1:03,,SEA,10,9,Sun,L 10-33,,1,15,9,80,10,95
11031,ATL,2018,2018-11-11,1:00,1:00,@,CLE,10,9,Sun,L 16-28,,1,5,7,38,8,43
11032,ATL,2020,2020-12-06,1:00,1:00,,NOR,13,12,Sun,L 16-21,,1,15,10,79,11,94
11033,BUF,2003,2003-11-09,4:15,3:15,@,DAL,10,9,Sun,L 6-10,,1,15,5,53,6,68
11034,BUF,2008,2008-09-07,1:02,1:02,,SEA,1,1,Sun,W 34-10,,1,14,5,30,6,44
11035,BUF,2009,2009-12-03,8:20,8:20,,NYJ,13,12,Thu,L 13-19,,1,5,3,18,4,23
11036,BUF,2011,2011-12-11,4:15,1:15,@,SDG,14,13,Sun,L 10-37,,1,5,5,50,6,55
11037,CAR,2000,2000-12-03,1:04,1:04,,STL,14,13,Sun,W 16-3,,1,10,9,72,10,82
11038,CAR,2011,2012-01-01,1:03,12:03,@,NOR,17,16,Sun,L 17-45,,1,5,6,60,7,65
11039,CAR,2014,2014-11-16,1:03,1:03,,ATL,11,11,Sun,L 17-19,,1,15,5,58,6,73
11040,CAR,2017,2017-09-24,1:00,1:00,,NOR,3,3,Sun,L 13-34,,1,5,1,10,2,15
11041,CAR,2017,2017-10-01,1:00,1:00,@,NWE,4,4,Sun,W 33-30,,1,33,7,55,8,88
11042,CAR,2017,2017-10-12,8:25,8:25,,PHI,6,6,Thu,L 23-28,,1,1,10,126,11,127
11043,CAR,2020,2020-10-25,1:00,12:00,@,NOR,7,7,Sun,L 24-27,,1,5,6,50,7,55
11044,CAR,2020,2021-01-03,4:25,4:25,,NOR,17,16,Sun,L 7-33,,1,5,4,31,5,36
11045,CAR,2021,2022-01-02,1:00,12:00,@,NOR,17,16,Sun,L 10-18,,1,5,5,33,6,38
11046,CAR,2021,2022-01-09,1:00,1:00,@,TAM,18,17,Sun,L 17-41,,1,10,2,10,3,20
11047,CHI,2001,2001-11-11,1:02,12:02,,GNB,9,8,Sun,L 12-20,,1,15,7,50,8,65
11048,CHI,2001,2001-12-23,1:01,1:01,@,WAS,15,14,Sun,W 20-15,,1,6,6,38,7,44
11049,CHI,2005,2005-12-11,1:02,1:02,@,PIT,14,13,Sun,L 9-21,,1,5,7,55,8,60
11050,CHI,2008,2008-09-28,8:23,7:23,,PHI,4,4,Sun,W 24-20,,1,5,3,25,4,30
11051,CHI,2008,2008-12-07,1:02,12:02,,JAX,14,13,Sun,W 23-10,,1,5,4,21,5,26
11052,CHI,2009,2009-12-20,4:15,4:15,@,BAL,15,14,Sun,L 7-31,,1,9,4,26,5,35
11053,CHI,2015,2016-01-03,1:02,12:02,,DET,17,16,Sun,L 20-24,,1,15,4,21,5,36
11054,CHI,2020,2020-11-16,8:15,7:15,,MIN,10,10,Mon,L 13-19,,1,5,4,35,5,40
11055,CHI,2020,2021-01-03,4:25,3:25,,GNB,17,16,Sun,L 16-35,,1,16,4,30,5,46
11056,CIN,2007,2007-12-15,8:15,5:15,@,SFO,15,14,Sat,L 13-20,,1,15,3,15,4,30
11057,CIN,2019,2019-11-10,1:00,1:00,,BAL,10,9,Sun,L 13-49,,1,5,5,35,6,40
11058,CIN,2021,2021-10-24,1:00,1:00,@,BAL,7,7,Sun,W 41-17,,1,5,5,46,6,51
11059,CIN,2021,2021-11-21,4:05,1:05,@,LVR,11,10,Sun,W 32-13,,1,5,7,77,8,82
11060,CLE,2005,2005-10-30,1:02,12:02,@,HOU,8,7,Sun,L 16-19,,1,5,5,35,6,40
11061,CLE,2005,2005-12-18,4:05,1:05,@,OAK,15,14,Sun,W 9-7,,1,15,7,45,8,60
11062,CLE,2006,2006-12-24,1:03,1:03,,TAM,16,15,Sun,L 7-22,,1,15,2,10,3,25
11063,CLE,2008,2008-10-26,4:05,4:05,@,JAX,8,7,Sun,W 23-17,,1,15,6,40,7,55
11064,IND,2005,2005-10-02,1:02,12:02,@,TEN,4,4,Sun,W 31-10,,1,10,9,76,10,86
11065,IND,2008,2008-11-02,8:23,8:23,,NWE,9,8,Sun,W 18-15,,1,0,2,20,3,20
11066,IND,2010,2010-11-28,8:30,8:30,,SDG,12,11,Sun,L 14-36,,1,15,4,40,5,55
11067,IND,2012,2012-11-18,4:25,4:25,@,NWE,11,10,Sun,L 24-59,,1,5,4,70,5,75
11068,IND,2013,2013-09-22,4:25,1:25,@,SFO,3,3,Sun,W 27-7,,1,10,6,48,7,58
11069,IND,2020,2021-01-03,4:25,4:25,,JAX,17,16,Sun,W 28-14,,1,15,3,54,4,69
11070,ARI,2000,2000-09-03,1:04,1:04,@,NYG,1,1,Sun,L 16-21,,1,5,9,68,10,73
11071,ARI,2001,2001-11-04,4:05,2:05,,PHI,8,7,Sun,L 7-21,,1,9,11,92,12,101
11072,ARI,2001,2002-01-06,1:01,1:01,@,WAS,17,16,Sun,L 17-20,,1,5,3,20,4,25
11073,ARI,2002,2002-09-08,1:05,1:05,@,WAS,1,1,Sun,L 23-31,,1,5,7,56,8,61
11074,ARI,2002,2002-11-17,1:03,1:03,@,PHI,11,10,Sun,L 14-38,,1,5,8,88,9,93
11075,ARI,2002,2002-12-21,5:05,3:05,,SFO,16,15,Sat,L 14-17,,1,15,4,30,5,45
11076,ARI,2003,2003-12-07,4:05,1:05,@,SFO,14,13,Sun,L 14-50,,1,13,5,54,6,67
11077,ARI,2003,2003-12-28,4:05,2:05,,MIN,17,16,Sun,W 18-17,,1,5,7,71,8,76
11078,ARI,2008,2008-11-27,8:16,8:16,@,PHI,13,12,Thu,L 20-48,,1,2,8,61,9,63
11079,ARI,2014,2014-12-21,8:30,6:30,,SEA,16,15,Sun,L 6-35,,1,5,11,97,12,102
11080,ARI,2015,2015-12-20,8:31,8:31,@,PHI,15,14,Sun,W 40-17,,1,10,5,38,6,48
11081,DAL,2003,2003-10-26,1:01,1:01,@,TAM,8,7,Sun,L 0-16,,1,5,3,15,4,20
11082,DAL,2004,2004-12-26,4:15,3:15,,WAS,16,15,Sun,W 13-10,,1,13,8,69,9,82
11083,DAL,2006,2006-10-23,8:40,7:40,,NYG,7,6,Mon,L 22-36,,1,5,3,24,4,29
11084,DAL,2012,2012-12-30,8:31,8:31,@,WAS,17,16,Sun,L 18-28,,1,6,2,20,3,26
11085,DAL,2013,2013-12-29,8:30,7:30,,PHI,17,16,Sun,L 22-24,,1,5,6,50,7,55
11086,DEN,2006,2006-12-17,4:05,2:05,@,ARI,15,14,Sun,W 37-20,,1,5,6,52,7,57
11087,DEN,2008,2008-12-07,4:05,2:05,,KAN,14,13,Sun,W 24-17,,1,5,1,5,2,10
11088,DEN,2011,2011-09-25,1:02,12:02,@,TEN,3,3,Sun,L 14-17,,1,15,11,80,12,95
11089,DEN,2014,2014-12-28,4:25,2:25,,OAK,17,16,Sun,W 47-14,,1,16,9,86,10,102
11090,DEN,2016,2016-11-13,1:00,12:00,@,NOR,10,10,Sun,W 25-23,,1,10,3,25,4,35
11091,DET,2001,2002-01-06,1:03,1:03,,DAL,17,16,Sun,W 15-10,,1,5,9,99,10,104
11092,DET,2002,2002-11-10,1:02,12:02,@,GNB,10,9,Sun,L 14-40,,1,10,8,53,9,63
11093,DET,2008,2008-11-16,1:03,1:03,@,CAR,11,10,Sun,L 22-31,,1,14,7,55,8,69
11094,DET,2009,2009-12-27,4:04,1:04,@,SFO,16,15,Sun,L 6-20,,1,10,4,29,5,39
11095,DET,2017,2017-10-08,1:00,1:00,,CAR,5,5,Sun,L 24-27,,1,10,11,100,12,110
11096,DET,2018,2018-11-18,1:00,1:00,,CAR,11,10,Sun,W 20-19,,1,5,2,15,3,20
11097,GNB,2001,2001-12-23,4:15,3:15,,CLE,15,14,Sun,W 30-7,,1,5,3,35,4,40
11098,GNB,2007,2007-12-23,1:03,12:03,@,CHI,16,15,Sun,L 7-35,,1,10,6,30,7,40
11099,GNB,2010,2010-11-21,1:05,12:05,@,MIN,11,10,Sun,W 31-3,,1,5,6,50,7,55
11100,GNB,2011,2011-11-14,8:40,7:40,,MIN,10,9,Mon,W 45-7,,1,5,10,80,11,85
11101,GNB,2012,2012-11-04,1:02,12:02,,ARI,9,9,Sun,W 31-17,,1,5,8,57,9,62
11102,GNB,2012,2012-12-23,1:02,12:02,,TEN,16,15,Sun,W 55-7,,1,10,5,35,6,45
11103,GNB,2013,2013-12-29,4:25,3:25,@,CHI,17,16,Sun,W 33-28,,1,15,5,40,6,55
11104,GNB,2021,2022-01-02,8:20,7:20,,MIN,17,16,Sun,W 37-10,,1,5,3,23,4,28
11105,HOU,2002,2002-12-08,1:01,1:01,@,PIT,14,13,Sun,W 24-6,,1,18,8,57,9,75
11106,HOU,2008,2008-10-05,1:02,12:02,,IND,5,4,Sun,L 27-31,,1,5,6,31,7,36
11107,HOU,2008,2008-10-12,1:02,12:02,,MIA,6,5,Sun,W 29-28,,1,5,4,30,5,35
11108,HOU,2008,2008-12-21,4:05,1:05,@,OAK,16,15,Sun,L 16-27,,1,15,2,14,3,29
11109,HOU,2009,2009-10-04,1:02,12:02,,OAK,4,4,Sun,W 29-6,,1,5,9,60,10,65
11110,HOU,2012,2012-09-30,1:03,12:03,,TEN,4,4,Sun,W 38-14,,1,3,7,73,8,76
11111,JAX,2000,2000-09-03,1:02,1:02,@,CLE,1,1,Sun,W 27-7,,1,5,3,25,4,30
11112,JAX,2007,2007-11-25,1:03,1:03,,BUF,12,11,Sun,W 36-14,,1,5,5,29,6,34
11113,JAX,2007,2007-12-16,1:03,1:03,@,PIT,15,14,Sun,W 29-22,,1,10,4,34,5,44
11114,JAX,2009,2009-12-27,1:02,1:02,@,NWE,16,15,Sun,L 7-35,,1,5,2,10,3,15
11115,JAX,2011,2012-01-01,1:03,1:03,,IND,17,16,Sun,W 19-13,,1,10,4,40,5,50
11116,KAN,2002,2002-09-22,1:02,1:02,@,NWE,3,3,Sun,L 38-41,OT,1,5,12,100,13,105
11117,KAN,2002,2002-12-22,1:00,12:00,,SDG,16,15,Sun,W 24-22,,1,1,9,50,10,51
11118,KAN,2002,2002-12-28,5:15,2:15,@,OAK,17,16,Sat,L 0-24,,1,5,4,25,5,30
11119,KAN,2008,2008-12-07,4:05,2:05,@,DEN,14,13,Sun,L 17-24,,1,5,1,5,2,10
11120,KAN,2009,2009-11-08,1:03,1:03,@,JAX,9,8,Sun,L 21-24,,1,10,5,31,6,41
11121,KAN,2011,2011-09-11,1:06,12:06,,BUF,1,1,Sun,L 7-41,,1,3,5,30,6,33
11122,KAN,2012,2012-12-02,1:03,12:03,,CAR,13,12,Sun,W 27-21,,1,5,7,45,8,50
11123,KAN,2013,2013-12-29,4:26,1:26,@,SDG,17,16,Sun,L 24-27,OT,1,5,4,22,5,27
11124,KAN,2020,2020-09-10,8:20,7:20,,HOU,1,1,Thu,W 34-20,,1,5,5,37,6,42
11125,KAN,2020,2020-10-25,4:25,2:25,@,DEN,7,7,Sun,W 43-16,,1,15,5,34,6,49
11126,MIA,2006,2006-11-12,1:03,1:03,,KAN,10,9,Sun,W 13-10,,1,3,7,65,8,68
11127,MIA,2006,2006-12-03,4:05,4:05,,JAX,13,12,Sun,L 10-24,,1,10,7,60,8,70
11128,MIA,2008,2008-10-05,1:03,1:03,,SDG,5,4,Sun,W 17-10,,1,5,4,46,5,51
11129,MIN,2012,2012-09-23,1:05,12:05,,SFO,3,3,Sun,W 24-13,,1,10,6,60,7,70
11130,MIN,2013,2013-11-07,8:35,7:35,,WAS,10,9,Thu,W 34-27,,1,7,8,63,9,70
11131,MIN,2016,2016-10-31,8:31,7:31,@,CHI,8,7,Mon,L 10-20,,1,10,2,20,3,30
11132,MIN,2020,2020-12-20,1:00,3:00,,CHI,15,14,Sun,L 27-33,,1,5,4,36,5,41
11133,NOR,2000,2000-12-10,4:15,1:15,@,SFO,15,14,Sun,W 31-27,,1,5,2,15,3,20
11134,NOR,2011,2011-10-23,8:30,7:30,,IND,7,7,Sun,W 62-7,,1,10,7,49,8,59
11135,NOR,2017,2017-09-24,1:00,1:00,@,CAR,3,3,Sun,W 34-13,,1,10,1,5,2,15
11136,NOR,2018,2018-11-11,1:00,1:00,@,CIN,10,9,Sun,W 51-14,,1,5,4,26,5,31
11137,NWE,2006,2006-09-10,1:02,1:02,,BUF,1,1,Sun,W 19-17,,1,5,7,53,8,58
11138,NWE,2008,2008-12-07,4:06,1:06,@,SEA,14,13,Sun,W 24-21,,1,15,5,39,6,54
11139,NWE,2010,2010-11-21,4:15,4:15,,IND,11,10,Sun,W 31-28,,1,15,6,48,7,63
11140,NWE,2010,2010-12-06,8:40,8:40,,NYJ,13,12,Mon,W 45-3,,1,10,4,56,5,66
11141,NWE,2012,2012-09-30,1:02,1:02,@,BUF,4,4,Sun,W 52-28,,1,10,3,17,4,27
11142,NWE,2013,2013-12-15,1:02,1:02,@,MIA,15,14,Sun,L 20-24,,1,2,4,21,5,23
11143,NWE,2015,2015-12-27,1:02,1:02,@,NYJ,16,15,Sun,L 20-26,OT,1,7,6,39,7,46
11144,NWE,2017,2017-11-12,8:30,6:30,@,DEN,10,9,Sun,W 41-16,,1,5,5,28,6,33
11145,NWE,2020,2020-10-18,1:00,1:00,,DEN,6,5,Sun,L 12-18,,1,4,2,20,3,24
11146,NYG,2000,2000-12-23,12:37,12:37,,JAX,17,16,Sat,W 28-25,,1,10,3,25,4,35
11147,NYG,2012,2012-11-11,1:03,1:03,@,CIN,10,10,Sun,L 13-31,,1,5,5,40,6,45
11148,NYG,2012,2012-12-30,1:04,1:04,,PHI,17,16,Sun,W 42-7,,1,5,6,52,7,57
11149,NYG,2013,2013-11-10,1:03,1:03,,OAK,10,9,Sun,W 24-20,,1,5,8,65,9,70
11150,NYG,2013,2013-12-01,8:31,8:31,@,WAS,13,12,Sun,W 24-17,,1,1,8,55,9,56
11151,NYG,2017,2017-10-01,4:05,4:05,@,TAM,4,4,Sun,L 23-25,,1,0,4,19,5,19
11152,NYG,2017,2017-12-03,4:25,1:25,@,OAK,13,12,Sun,L 17-24,,1,5,6,42,7,47
11153,NYJ,2001,2001-10-01,9:10,9:10,,SFO,3,3,Mon,L 17-19,,1,5,7,48,8,53
11154,NYJ,2001,2001-11-18,1:02,1:02,@,MIA,10,10,Sun,W 24-0,,1,10,4,21,5,31
11155,NYJ,2002,2002-11-24,1:02,1:02,,BUF,12,11,Sun,W 31-13,,1,5,5,34,6,39
11156,NYJ,2002,2002-12-08,4:16,4:16,,DEN,14,13,Sun,W 19-13,,1,15,5,55,6,70
11157,NYJ,2003,2003-09-04,9:09,9:09,@,WAS,1,1,Thu,L 13-16,,1,5,6,55,7,60
11158,NYJ,2004,2004-09-12,1:07,1:07,,CIN,1,1,Sun,W 31-24,,1,7,6,49,7,56
11159,NYJ,2006,2006-10-29,4:16,4:16,@,CLE,8,8,Sun,L 13-20,,1,5,3,42,4,47
11160,NYJ,2006,2006-11-26,1:02,1:02,,HOU,12,11,Sun,W 26-11,,1,5,7,77,8,82
11161,NYJ,2006,2006-12-25,8:43,8:43,@,MIA,16,15,Mon,W 13-10,,1,12,7,78,8,90
11162,NYJ,2012,2012-12-09,1:02,1:02,@,JAX,14,13,Sun,W 17-10,,1,15,7,54,8,69
11163,NYJ,2015,2015-10-18,1:02,1:02,,WAS,6,5,Sun,W 34-20,,1,5,3,15,4,20
11164,NYJ,2018,2018-11-11,1:00,1:00,,BUF,10,10,Sun,L 10-41,,1,10,4,30,5,40
11165,TEN,2000,2000-12-03,1:03,1:03,@,PHI,14,13,Sun,W 15-13,,1,5,6,34,7,39
11166,TEN,2013,2013-12-22,1:02,1:02,@,JAX,16,15,Sun,W 20-16,,1,4,4,15,5,19
11167,TEN,2014,2014-11-17,8:30,7:30,,PIT,11,10,Mon,L 24-27,,1,10,4,39,5,49
11168,PHI,2003,2003-10-26,4:13,4:13,,NYJ,8,7,Sun,W 24-17,,1,10,5,35,6,45
11169,PHI,2008,2008-11-02,4:16,1:16,@,SEA,9,8,Sun,W 26-7,,1,15,4,20,5,35
11170,PHI,2008,2008-12-15,8:40,8:40,,CLE,15,14,Mon,W 30-10,,1,5,3,20,4,25
11171,PHI,2012,2012-12-02,8:20,7:20,@,DAL,13,12,Sun,L 33-38,,1,5,7,60,8,65
11172,PHI,2013,2013-12-08,1:02,1:02,,DET,14,13,Sun,W 34-20,,1,5,9,48,10,53
11173,PHI,2016,2016-12-22,8:25,8:25,,NYG,16,15,Thu,W 24-19,,1,5,5,50,6,55
11174,PIT,2000,2000-12-24,4:05,1:05,@,SDG,17,16,Sun,W 34-21,,1,10,8,82,9,92
11175,PIT,2001,2001-10-21,1:01,1:01,@,TAM,6,5,Sun,W 17-10,,1,5,1,10,2,15
11176,PIT,2002,2002-12-15,1:01,1:01,,CAR,15,14,Sun,W 30-14,,1,5,4,35,5,40
11177,PIT,2006,2006-09-07,8:37,8:37,,MIA,1,1,Thu,W 28-17,,1,10,6,63,7,73
11178,PIT,2014,2014-12-28,8:30,8:30,,CIN,17,16,Sun,W 27-17,,1,10,5,45,6,55
11179,PIT,2015,2015-10-25,1:03,12:03,@,KAN,7,7,Sun,L 13-23,,1,5,6,66,7,71
11180,PIT,2016,2016-10-09,1:02,1:02,,NYJ,5,5,Sun,W 31-13,,1,10,4,18,5,28
11181,PIT,2017,2017-10-22,4:25,1:00,,CIN,7,7,Sun,W 29-14,,1,5,5,54,6,59
11182,PIT,2018,2018-11-08,8:20,8:20,,CAR,10,9,Thu,W 52-21,,1,24,5,42,6,66
11183,STL,2001,2002-01-06,4:05,3:05,,ATL,17,16,Sun,W 31-13,,1,10,6,35,7,45
11184,STL,2008,2008-12-07,4:15,2:15,@,ARI,14,13,Sun,L 10-34,,1,5,5,30,6,35
11185,LAR,2018,2018-10-21,4:25,1:25,@,SFO,7,7,Sun,W 39-10,,1,10,2,10,3,20
11186,LAR,2020,2020-10-04,4:05,1:05,,NYG,4,4,Sun,W 17-9,,1,5,4,20,5,25
11187,LAR,2021,2021-09-26,4:25,1:25,,TAM,3,3,Sun,W 34-24,,1,4,7,41,8,45
11188,LAR,2021,2021-12-26,1:00,11:00,@,MIN,16,15,Sun,W 30-23,,1,5,2,20,3,25
11189,BAL,2002,2002-11-10,1:02,1:02,,CIN,10,9,Sun,W 38-27,,1,5,5,36,6,41
11190,BAL,2007,2007-12-16,1:03,1:03,@,MIA,15,14,Sun,L 16-22,OT,1,5,4,25,5,30
11191,BAL,2010,2010-12-26,1:02,1:02,@,CLE,16,15,Sun,W 20-10,,1,5,2,20,3,25
11192,BAL,2017,2017-10-08,4:05,1:05,@,OAK,5,5,Sun,W 30-17,,1,5,3,24,4,29
11193,BAL,2021,2022-01-09,1:00,1:00,,PIT,18,17,Sun,L 13-16,OT,1,5,6,43,7,48
11194,SDG,2002,2002-12-01,4:05,1:05,,DEN,13,12,Sun,W 30-27,OT,1,5,9,57,10,62
11195,SDG,2004,2004-12-19,1:03,1:03,@,CLE,15,14,Sun,W 21-0,,1,8,7,55,8,63
11196,SDG,2005,2005-12-04,8:35,5:35,,OAK,13,12,Sun,W 34-10,,1,15,0,0,1,15
11197,SDG,2006,2006-12-31,4:15,1:15,,ARI,17,16,Sun,W 27-20,,1,15,9,93,10,108
11198,SDG,2009,2009-11-22,4:15,2:15,@,DEN,11,10,Sun,W 32-3,,1,15,9,65,10,80
11199,SDG,2009,2009-12-06,4:05,4:05,@,CLE,13,12,Sun,W 30-23,,1,5,4,30,5,35
11200,SDG,2010,2010-12-26,4:05,4:05,@,CIN,16,15,Sun,L 20-34,,1,5,6,57,7,62
11201,SDG,2011,2011-12-24,4:05,4:05,@,DET,16,15,Sat,L 10-38,,1,10,3,8,4,18
11202,SDG,2012,2012-11-11,1:03,1:03,@,TAM,10,9,Sun,L 24-34,,1,5,1,5,2,10
11203,LAC,2017,2017-11-19,4:05,1:05,,BUF,11,10,Sun,W 54-24,,1,13,6,48,7,61
11204,LAC,2020,2020-10-12,8:15,7:15,@,NOR,5,5,Mon,L 27-30,OT,1,10,5,60,6,70
11205,SEA,2000,2000-09-10,4:15,1:15,,STL,2,2,Sun,L 34-37,,1,10,4,16,5,26
11206,SEA,2001,2001-09-09,1:02,1:02,@,CLE,1,1,Sun,W 9-6,,1,5,4,43,5,48
11207,SEA,2001,2001-11-04,4:15,4:15,@,WAS,8,7,Sun,L 14-27,,1,16,6,45,7,61
11208,SEA,2004,2005-01-02,4:06,1:06,,ATL,17,16,Sun,W 28-26,,1,5,8,53,9,58
11209,SEA,2008,2008-10-19,8:23,8:23,@,TAM,7,6,Sun,L 10-20,,1,6,4,26,5,32
11210,SEA,2008,2008-11-16,4:06,1:06,,ARI,11,10,Sun,L 20-26,,1,15,8,52,9,67
11211,SEA,2009,2009-10-11,4:16,1:16,,JAX,5,5,Sun,W 41-0,,1,10,9,73,10,83
11212,SEA,2010,2010-12-26,4:16,4:16,@,TAM,16,15,Sun,L 15-38,,1,10,3,22,4,32
11213,SEA,2018,2018-12-30,4:25,1:25,,ARI,17,16,Sun,W 27-24,,1,10,3,20,4,30
11214,SEA,2019,2019-12-02,8:15,5:15,,MIN,13,12,Mon,W 37-30,,1,30,3,30,4,60
11215,SFO,2001,2001-12-02,8:36,5:36,,BUF,12,11,Sun,W 35-0,,1,10,7,47,8,57
11216,SFO,2009,2009-11-29,4:05,1:05,,JAX,12,11,Sun,W 20-3,,1,5,6,60,7,65
11217,SFO,2021,2021-11-21,1:00,1:00,@,JAX,11,10,Sun,W 30-10,,1,12,8,56,9,68
11218,TAM,2000,2000-11-19,1:04,12:04,@,CHI,12,11,Sun,L 10-13,,1,8,4,25,5,33
11219,TAM,2001,2001-10-21,1:01,1:01,,PIT,6,5,Sun,L 10-17,,1,10,1,5,2,15
11220,TAM,2001,2002-01-06,8:30,8:30,,PHI,17,16,Sun,L 13-17,,1,10,11,95,12,105
11221,TAM,2004,2004-09-19,4:05,4:05,,SEA,2,2,Sun,L 6-10,,1,5,7,59,8,64
11222,TAM,2007,2007-09-30,4:06,4:06,@,CAR,4,4,Sun,W 20-7,,1,5,7,65,8,70
11223,TAM,2008,2008-11-30,1:02,1:02,,NOR,13,12,Sun,W 23-20,,1,5,5,45,6,50
11224,TAM,2012,2012-11-11,1:03,1:03,,SDG,10,9,Sun,W 34-24,,1,5,1,5,2,10
11225,TAM,2012,2012-12-23,1:03,1:03,,STL,16,15,Sun,L 13-28,,1,5,9,64,10,69
11226,TAM,2020,2020-12-20,1:00,1:00,@,ATL,15,14,Sun,W 31-27,,1,10,3,28,4,38
11227,TAM,2021,2021-10-24,4:25,4:25,,CHI,7,7,Sun,W 38-3,,1,10,4,32,5,42
11228,WAS,2013,2013-10-27,4:25,2:25,@,DEN,8,7,Sun,L 21-45,,1,5,6,57,7,62
11229,WAS,2021,2021-12-26,8:20,7:20,@,DAL,16,15,Sun,L 14-56,,1,13,3,15,4,28
11230,WAS,2021,2022-01-02,1:00,1:00,,PHI,17,16,Sun,L 16-20,,1,4,6,42,7,46
11231,BUF,2016,2017-01-01,1:00,1:00,@,NYJ,17,16,Sun,L 10-30,,0,0,2,15,2,15
11232,CHI,2015,2015-11-22,1:02,12:02,,DEN,11,10,Sun,L 15-17,,0,0,8,118,8,118
11233,CLE,2017,2017-11-19,1:00,1:00,,JAX,11,10,Sun,L 7-19,,0,0,6,40,6,40
11234,IND,2019,2019-12-22,1:00,1:00,,CAR,16,15,Sun,W 38-6,,0,0,6,46,6,46
11235,DAL,2005,2005-10-30,1:02,12:02,,ARI,8,8,Sun,W 34-13,,0,0,8,56,8,56
11236,DEN,2006,2006-09-17,4:16,2:16,,KAN,2,2,Sun,W 9-6,OT,0,0,4,26,4,26
11237,GNB,2011,2011-12-25,8:30,7:30,,CHI,16,15,Sun,W 35-21,,0,0,6,28,6,28
11238,GNB,2013,2013-11-04,8:40,7:40,,CHI,9,8,Mon,L 20-27,,0,0,4,45,4,45
11239,GNB,2020,2020-12-27,8:20,7:20,,TEN,16,15,Sun,W 40-14,,0,0,3,15,3,15
11240,GNB,2021,2022-01-09,1:00,1:00,@,DET,18,17,Sun,L 30-37,,0,0,2,15,2,15
11241,JAX,2002,2002-12-01,1:05,1:05,,PIT,13,12,Sun,L 23-25,,0,0,4,25,4,25
11242,KAN,2019,2019-12-01,4:25,3:25,,OAK,13,12,Sun,W 40-9,,0,0,12,99,12,99
11243,MIA,2013,2013-09-15,1:02,1:02,@,IND,2,2,Sun,W 24-20,,0,0,3,13,3,13
11244,NWE,2008,2008-10-26,1:02,1:02,,STL,8,7,Sun,W 23-16,,0,0,9,63,9,63
11245,NWE,2009,2009-11-30,8:40,7:40,@,NOR,12,11,Mon,L 17-38,,0,0,4,36,4,36
11246,NWE,2013,2013-10-06,1:02,1:02,@,CIN,5,5,Sun,L 6-13,,0,0,7,59,7,59
11247,NWE,2013,2013-12-01,1:02,12:02,@,HOU,13,12,Sun,W 34-31,,0,0,2,25,2,25
11248,NWE,2018,2018-10-14,8:20,8:20,,KAN,6,6,Sun,W 43-40,,0,0,5,58,5,58
11249,NYJ,2001,2001-11-11,1:02,1:02,,KAN,9,9,Sun,W 27-7,,0,0,3,25,3,25
11250,NYJ,2007,2007-10-14,1:02,1:02,,PHI,6,6,Sun,L 9-16,,0,0,2,14,2,14
11251,NYJ,2011,2011-09-11,8:33,8:33,,DAL,1,1,Sun,W 27-24,,0,0,7,40,7,40
11252,TEN,2011,2011-12-24,1:02,12:02,,JAX,16,15,Sat,W 23-17,,0,0,6,28,6,28
11253,PHI,2007,2007-12-02,1:02,1:02,,SEA,13,12,Sun,L 24-28,,0,0,2,25,2,25
11254,PHI,2008,2008-12-28,4:15,4:15,,DAL,17,16,Sun,W 44-6,,0,0,5,46,5,46
11255,PHI,2018,2018-11-11,8:20,8:20,,DAL,10,9,Sun,L 20-27,,0,0,5,37,5,37
11256,PIT,2012,2012-12-16,4:25,3:25,@,DAL,15,14,Sun,L 24-27,OT,0,0,8,61,8,61
11257,OAK,2005,2005-12-04,8:35,5:35,@,SDG,13,12,Sun,L 10-34,,0,0,1,15,1,15
11258,SDG,2011,2011-10-09,4:16,2:16,@,DEN,5,5,Sun,W 29-24,,0,0,4,53,4,53
11259,SEA,2001,2001-12-16,4:17,1:17,,DAL,14,13,Sun,W 29-3,,0,0,6,70,6,70
11260,SEA,2007,2007-12-23,4:16,1:16,,BAL,16,15,Sun,W 27-6,,0,0,6,69,6,69
11261,SEA,2020,2020-10-04,1:00,1:00,@,MIA,4,4,Sun,W 31-23,,0,0,3,20,3,20
11262,SFO,2001,2002-01-06,12:03,12:03,@,NOR,17,16,Sun,W 38-0,,0,0,3,23,3,23
11263,TAM,2020,2020-10-18,4:25,4:25,,GNB,6,6,Sun,W 38-10,,0,0,6,76,6,76
11264,WAS,2003,2003-11-16,1:03,1:03,@,CAR,11,10,Sun,L 17-20,,0,0,4,69,4,69